FECHA EVENTO,ESTADO,MUNICIPIO,CORTA,LARGA,TOTAL,CARGS,GDAS,CARTS,
02/01/2013,D.F.,"IZTAPALAPA, D.F.",86,22,108,0,6,600,
02/01/2013,D.F.,"IZTAPALAPA, D.F.",43,12,55,0,6,300,
03/01/2013,D.F.,"IZTAPALAPA, D.F.",103,22,125,0,23,300,
04/01/2013,D.F.,"IZTAPALAPA, D.F.",123,37,160,0,11,400,
05/01/2013,D.F.,"IZTAPALAPA, D.F.",30,22,52,0,7,160,
08/01/2013,D.F.,"GUSTAVO A. MADERO, D.F.",76,19,95,0,14,500,
08/01/2013,D.F.,"IZTAPALAPA, D.F.",66,26,92,0,1,320,
09/01/2013,D.F.,"GUSTAVO A. MADERO, D.F.",129,35,164,0,12,1000,
10/01/2013,D.F.,"GUSTAVO A. MADERO, D.F.",104,24,128,0,14,750,
11/01/2013,D.F.,"GUSTAVO A. MADERO, D.F.",137,49,186,0,19,700,
12/01/2013,VER.,"COATZACOALCOS, VER.",1,0,1,0,0,14,
14/01/2013,D.F.,"GUSTAVO A. MADERO, D.F.",107,33,140,0,10,300,
15/01/2013,D.F.,"GUSTAVO A. MADERO, D.F.",64,25,89,0,10,250,
16/01/2013,D.F.,"GUSTAVO A. MADERO, D.F.",99,37,136,0,10,400,
16/01/2013,D.F.,"IZTAPALAPA, D.F.",6,4,10,0,0,30,
17/01/2013,D.F.,"GUSTAVO A. MADERO, D.F.",101,31,132,0,8,300,
17/01/2013,TAMPS.,"REYNOSA, TAMPS.",11,3,14,13,0,791,
17/01/2013,D.F.,"IZTAPALAPA, D.F.",6,3,9,0,1,12,
18/01/2013,D.F.,"IZTAPALAPA, D.F.",17,1,18,0,1,100,
21/01/2013,D.F.,"TLAHUAC, D.F.",28,9,37,0,9,50,
22/01/2013,D.F.,"TLAHUAC, D.F.",62,26,88,0,5,200,
23/01/2013,D.F.,"TLAHUAC, D.F.",76,27,103,0,6,100,
23/01/2013,D.F.,"IZTAPALAPA, D.F.",7,2,9,0,0,30,
24/01/2013,D.F.,"IZTAPALAPA, D.F.",38,15,53,0,3,70,
25/01/2013,D.F.,"TLAHUAC, D.F.",38,30,68,0,4,80,
25/01/2013,D.F.,"IZTAPALAPA, D.F.",4,1,5,0,0,50,
26/01/2013,QRO.,"QUERETARO, QRO.",15,10,25,0,0,0,
26/01/2013,D.F.,"IZTAPALAPA, D.F.",2,1,3,0,0,0,
26/01/2013,CHIH.,"CUAUHTÉMOC, CHIH.",0,1,1,0,0,0,
28/01/2013,D.F.,"TLAHUAC, D.F.",41,28,69,0,2,50,
29/01/2013,D.F.,"TLAHUAC, D.F.",14,10,24,0,0,20,
30/01/2013,D.F.,"TLAHUAC, D.F.",19,5,24,0,2,10,
30/01/2013,TAMPS.,"GUSTAVO DIAZ ORDAZ, TAMPS.",5,6,11,0,0,0,
31/01/2013,B.C.,"TIJUANA, B.C.",4,27,31,0,0,0,
31/01/2013,D.F.,"TLAHUAC, D.F.",11,5,16,0,0,0,
31/01/2013,B.C.,"TECATE, B.C.",1,9,10,0,0,0,
31/01/2013,B.C.,"ENSENADA, B.C.",2,4,6,0,0,0,
01/02/2013,B.C.,"TIJUANA, B.C.",7,2,9,0,0,0,
01/02/2013,B.C.,"ENSENADA, B.C.",0,3,3,0,0,0,
02/02/2013,TAMPS.,"TAMPICO, TAMPS.",5,2,7,1,0,210,
03/02/2013,TAMPS.,"TAMPICO, TAMPS.",8,0,8,0,0,0,
03/02/2013,CAMP.,"CAMP., CAMP.",4,2,6,0,0,0,
03/02/2013,TAMPS.,"ALTAMIRA, TAMPS.",2,0,2,0,0,0,
03/02/2013,JAL.,"PIHUAMO, JAL.",1,0,1,0,0,0,
04/02/2013,B.C.,"TIJUANA, B.C.",4,7,11,0,0,0,
04/02/2013,JAL.,"ATOTONILCO EL ALTO, JAL.",2,0,2,1,0,2,
05/02/2013,D.F.,"MIGUEL HGO., D.F.",29,8,37,0,3,0,
05/02/2013,D.F.,"IZTAPALAPA, D.F.",3,4,7,0,0,10,
05/02/2013,CHIH.,"CHIH., CHIH.",4,2,6,0,1,24,
05/02/2013,CHIH.,"ROSALES, CHIH.",1,1,2,1,0,92,
05/02/2013,B.C.,"TIJUANA, B.C.",1,1,2,0,0,0,
05/02/2013,JAL.,"ATOTONILCO EL ALTO, JAL.",1,0,1,0,0,0,
05/02/2013,B.C.,"ENSENADA, B.C.",0,1,1,0,0,0,
06/02/2013,D.F.,"MIGUEL HGO., D.F.",47,14,61,0,2,1800,
06/02/2013,CAMP.,"CAMP., CAMP.",10,2,12,0,0,0,
06/02/2013,D.F.,"IZTAPALAPA, D.F.",7,3,10,0,1,0,
06/02/2013,CHIH.,"CHIH., CHIH.",6,3,9,1,0,328,
06/02/2013,TAMPS.,"VICTORIA, TAMPS.",8,1,9,0,0,0,
06/02/2013,VER.,"COATZACOALCOS, VER.",7,1,8,0,0,0,
06/02/2013,B.C.,"TIJUANA, B.C.",2,2,4,0,0,0,
06/02/2013,JAL.,"ATOTONILCO EL ALTO, JAL.",1,1,2,0,0,0,
06/02/2013,B.C.,"ENSENADA, B.C.",1,1,2,0,0,0,
06/02/2013,JAL.,"AYOTLAN, JAL.",1,0,1,0,0,0,
07/02/2013,D.F.,"MIGUEL HGO., D.F.",53,13,66,0,7,0,
07/02/2013,TAMPS.,"VICTORIA, TAMPS.",13,6,19,2,1,105,
07/02/2013,CHIH.,"CHIH., CHIH.",6,3,9,0,0,0,
07/02/2013,D.F.,"IZTAPALAPA, D.F.",3,2,5,0,0,0,
07/02/2013,B.C.,"TIJUANA, B.C.",3,2,5,0,0,0,
07/02/2013,B.C.,"ENSENADA, B.C.",1,1,2,0,0,0,
08/02/2013,D.F.,"MIGUEL HGO., D.F.",53,11,64,0,7,1050,
08/02/2013,CHIH.,"CHIH., CHIH.",11,2,13,0,0,655,
08/02/2013,CAMP.,"CAMP., CAMP.",8,2,10,0,1,0,
08/02/2013,D.F.,"IZTAPALAPA, D.F.",3,4,7,0,0,120,
08/02/2013,TAMPS.,"TAMPICO, TAMPS.",5,2,7,11,2,595,
08/02/2013,TAMPS.,"VICTORIA, TAMPS.",5,1,6,0,8,0,
08/02/2013,TAMPS.,"NUEVO LAREDO, TAMPS.",0,3,3,2,0,50,
08/02/2013,B.C.,"TIJUANA, B.C.",1,2,3,0,0,0,
08/02/2013,TAMPS.,"GUSTAVO DIAZ ORDAZ, TAMPS.",0,2,2,0,0,0,
08/02/2013,JAL.,"ATOTONILCO EL ALTO, JAL.",0,2,2,0,0,0,
08/02/2013,CAMP.,"CALAKMUL, CAMP.",1,0,1,0,0,0,
08/02/2013,CHIH.,"JANOS, CHIH.",0,1,1,0,0,0,
08/02/2013,B.C.,"ENSENADA, B.C.",0,1,1,0,0,0,
09/02/2013,D.F.,"MIGUEL HGO., D.F.",57,12,69,0,6,200,
09/02/2013,TAMPS.,"MATAMOROS, TAMPS.",7,4,11,0,0,41,
09/02/2013,TAMPS.,"CIUDAD MADERO, TAMPS.",7,1,8,0,0,0,
09/02/2013,TAMPS.,"VICTORIA, TAMPS.",2,3,5,0,3,0,
09/02/2013,TAMPS.,"NUEVO LAREDO, TAMPS.",0,5,5,3,0,0,
09/02/2013,B.C.,"TIJUANA, B.C.",1,2,3,0,0,0,
09/02/2013,TAMPS.,"TAMPICO, TAMPS.",1,2,3,3,0,701,
09/02/2013,TAMPS.,"GUSTAVO DIAZ ORDAZ, TAMPS.",1,0,1,0,0,0,
10/02/2013,TAMPS.,"CIUDAD MADERO, TAMPS.",4,0,4,31,0,1270,
11/02/2013,MEX.,"NEZAHUALCOYOTL, MEX.",66,8,74,35,3,1007,
11/02/2013,MEX.,"ECATEPEC DE MOR., MEX.",22,5,27,0,3,82,
11/02/2013,MEX.,"TOLUCA, MEX.",15,4,19,10,0,367,
11/02/2013,TAMPS.,"MATAMOROS, TAMPS.",10,6,16,0,0,0,
11/02/2013,TAMPS.,"VICTORIA, TAMPS.",8,6,14,0,0,100,
11/02/2013,CHIH.,"CHIH., CHIH.",8,1,9,1,0,440,
11/02/2013,MEX.,"NAUCALPAN DE JUAREZ, MEX.",4,3,7,0,4,400,
11/02/2013,B.C.,"TIJUANA, B.C.",3,0,3,0,0,0,
11/02/2013,CHIH.,"JUÁREZ, CHIH.",0,2,2,0,0,0,
11/02/2013,CHIH.,"OJINAGA, CHIH.",2,0,2,0,0,0,
11/02/2013,JAL.,"DEGOLLADO, JAL.",2,0,2,0,0,0,
12/02/2013,MEX.,"NEZAHUALCOYOTL, MEX.",89,20,109,22,4,1166,
12/02/2013,MEX.,"ECATEPEC DE MOR., MEX.",36,11,47,0,0,361,
12/02/2013,MEX.,"TOLUCA, MEX.",25,5,30,5,0,37,
12/02/2013,D.F.,"MIGUEL HGO., D.F.",17,7,24,0,0,120,
12/02/2013,MEX.,"NAUCALPAN DE JUAREZ, MEX.",17,6,23,0,4,0,
12/02/2013,B.C.,"MEXICALI, B.C.",12,5,17,0,0,0,
12/02/2013,TAMPS.,"MATAMOROS, TAMPS.",9,7,16,0,0,0,
12/02/2013,CHIH.,"CHIH., CHIH.",6,1,7,0,2,248,
12/02/2013,CHIH.,"OJINAGA, CHIH.",2,5,7,0,0,0,
12/02/2013,CHIH.,"NUEVO CASAS GRANDES, CHIH.",6,0,6,0,0,0,
12/02/2013,VER.,"COATZACOALCOS, VER.",4,1,5,0,0,15,
12/02/2013,JAL.,"ARANDAS, JAL.",2,0,2,3,0,18,
12/02/2013,TAMPS.,"VICTORIA, TAMPS.",1,0,1,0,0,30,
12/02/2013,JAL.,"DEGOLLADO, JAL.",1,0,1,0,0,6,
13/02/2013,MEX.,"NEZAHUALCOYOTL, MEX.",117,19,136,25,7,1799,
13/02/2013,MEX.,"ECATEPEC DE MOR., MEX.",67,20,87,0,6,600,
13/02/2013,DGO.,"DGO., DGO.",48,14,62,10,3,0,
13/02/2013,MEX.,"TOLUCA, MEX.",40,10,50,19,0,475,
13/02/2013,MEX.,"NAUCALPAN DE JUAREZ, MEX.",29,14,43,0,8,263,
13/02/2013,TAMPS.,"MATAMOROS, TAMPS.",10,12,22,0,1,0,
13/02/2013,B.C.,"MEXICALI, B.C.",12,4,16,0,0,0,
13/02/2013,D.F.,"MIGUEL HGO., D.F.",7,3,10,0,0,50,
13/02/2013,CHIH.,"OJINAGA, CHIH.",5,4,9,0,0,0,
13/02/2013,CAMP.,"CAMP., CAMP.",6,2,8,0,0,0,
13/02/2013,CHIH.,"NUEVO CASAS GRANDES, CHIH.",6,0,6,0,0,0,
13/02/2013,CHIH.,"CHIH., CHIH.",4,1,5,0,0,603,
13/02/2013,B.C.,"TIJUANA, B.C.",5,0,5,0,0,0,
13/02/2013,VER.,"COATZACOALCOS, VER.",4,0,4,0,0,0,
13/02/2013,TAMPS.,"VICTORIA, TAMPS.",3,1,4,2,0,145,
13/02/2013,JAL.,"GUADALAJARA, JAL.",3,0,3,0,0,0,
13/02/2013,CAMP.,"CALAKMUL, CAMP.",0,1,1,0,0,0,
13/02/2013,JAL.,"ARANDAS, JAL.",1,0,1,0,0,0,
14/02/2013,MEX.,"NEZAHUALCOYOTL, MEX.",85,9,94,31,6,1887,
14/02/2013,MEX.,"ECATEPEC DE MOR., MEX.",57,12,69,1,6,112,
14/02/2013,MEX.,"NAUCALPAN DE JUAREZ, MEX.",51,9,60,0,4,873,
14/02/2013,MEX.,"TOLUCA, MEX.",34,4,38,15,0,121,
14/02/2013,D.F.,"MIGUEL HGO., D.F.",16,1,17,0,0,0,
14/02/2013,TAMPS.,"MATAMOROS, TAMPS.",4,6,10,0,0,0,
14/02/2013,CHIH.,"CHIH., CHIH.",5,2,7,0,0,131,
14/02/2013,TAMPS.,"NUEVO LAREDO, TAMPS.",0,4,4,0,0,0,
14/02/2013,B.C.,"MEXICALI, B.C.",4,0,4,0,0,0,
14/02/2013,TAMPS.,"REYNOSA, TAMPS.",0,2,2,0,0,0,
14/02/2013,B.C.,"TIJUANA, B.C.",1,1,2,0,0,0,
14/02/2013,TAMPS.,"VICTORIA, TAMPS.",0,1,1,0,0,0,
14/02/2013,JAL.,"DEGOLLADO, JAL.",1,0,1,0,0,0,
15/02/2013,MEX.,"NEZAHUALCOYOTL, MEX.",100,6,106,27,11,1466,
15/02/2013,MEX.,"ECATEPEC DE MOR., MEX.",47,10,57,0,6,773,
15/02/2013,MEX.,"NAUCALPAN DE JUAREZ, MEX.",51,3,54,0,1,180,
15/02/2013,MEX.,"TOLUCA, MEX.",37,11,48,10,1,453,
15/02/2013,D.F.,"MIGUEL HGO., D.F.",9,3,12,0,2,0,
15/02/2013,TAMPS.,"CIUDAD MADERO, TAMPS.",10,0,10,0,0,0,
15/02/2013,TAMPS.,"TAMPICO, TAMPS.",5,2,7,0,0,0,
15/02/2013,CHIH.,"NUEVO CASAS GRANDES, CHIH.",3,3,6,0,0,11,
15/02/2013,CHIH.,"CHIH., CHIH.",4,1,5,14,5,460,
15/02/2013,TAMPS.,"REYNOSA, TAMPS.",1,3,4,0,0,0,
15/02/2013,TAMPS.,"MATAMOROS, TAMPS.",0,4,4,0,0,0,
15/02/2013,CAMP.,"CAMP., CAMP.",3,0,3,0,0,0,
15/02/2013,TAMPS.,"VICTORIA, TAMPS.",3,0,3,0,0,0,
15/02/2013,TAMPS.,"NUEVO LAREDO, TAMPS.",2,0,2,0,0,0,
15/02/2013,CHIH.,"JUÁREZ, CHIH.",1,0,1,0,0,0,
15/02/2013,JAL.,"TECALITLAN, JAL.",1,0,1,0,0,0,
15/02/2013,GRO.,"TLACOACHISTLAHUACA, GRO.",0,1,1,0,0,0,
16/02/2013,MEX.,"NEZAHUALCOYOTL, MEX.",79,13,92,28,11,616,
16/02/2013,MEX.,"TOLUCA, MEX.",39,7,46,8,3,553,
16/02/2013,MEX.,"NAUCALPAN DE JUAREZ, MEX.",30,4,34,0,5,500,
16/02/2013,MEX.,"ECATEPEC DE MOR., MEX.",26,7,33,0,0,0,
16/02/2013,TAMPS.,"REYNOSA, TAMPS.",4,2,6,0,0,0,
16/02/2013,TAMPS.,"CIUDAD MADERO, TAMPS.",6,0,6,10,0,0,
16/02/2013,JAL.,"GUADALAJARA, JAL.",5,0,5,0,0,0,
16/02/2013,B.C.,"TIJUANA, B.C.",0,4,4,0,0,0,
16/02/2013,TAMPS.,"VICTORIA, TAMPS.",1,2,3,0,0,0,
16/02/2013,TAMPS.,"NUEVO LAREDO, TAMPS.",1,0,1,11,0,128,
16/02/2013,TAMPS.,"TAMPICO, TAMPS.",1,0,1,6,0,686,
16/02/2013,B.C.,"MEXICALI, B.C.",0,0,0,0,3,0,
17/02/2013,MEX.,"NEZAHUALCOYOTL, MEX.",80,15,95,25,6,793,
17/02/2013,MEX.,"ECATEPEC DE MOR., MEX.",39,9,48,40,6,0,
17/02/2013,MEX.,"NAUCALPAN DE JUAREZ, MEX.",30,8,38,0,1,16,
17/02/2013,MEX.,"TOLUCA, MEX.",20,8,28,8,0,191,
17/02/2013,GRO.,"ACAPULCO DE JUAREZ, GRO.",2,11,13,0,0,0,
17/02/2013,TAMPS.,"CIUDAD MADERO, TAMPS.",4,0,4,12,0,1452,
17/02/2013,TAMPS.,"TAMPICO, TAMPS.",3,0,3,3,2,1148,
17/02/2013,GRO.,"ACAPULCO DE JUAREZ, GRO.",1,1,2,0,4,39,
17/02/2013,JAL.,"GUADALAJARA, JAL.",1,0,1,0,0,0,
18/02/2013,MEX.,"TLALNEPANTLA DE BAZ, MEX.",46,5,51,0,2,341,
18/02/2013,MEX.,"CUAUTITLAN IZCALLI, MEX.",27,3,30,4,1,677,
18/02/2013,MEX.,"ATIZAPAN DE ZARAGOZA, MEX.",16,4,20,0,2,330,
18/02/2013,MEX.,"TULTITLAN, MEX.",10,3,13,0,0,163,
18/02/2013,D.F.,"VENUSTIANO CARRANZA, D.F.",3,2,5,0,1,0,
18/02/2013,JAL.,"GUADALAJARA, JAL.",2,1,3,0,0,0,
18/02/2013,GRO.,"ATOYAC DE ALVAREZ, GRO.",2,0,2,1,0,0,
18/02/2013,CAMP.,"CAMP., CAMP.",0,2,2,0,0,0,
18/02/2013,GRO.,"ACAPULCO DE JUAREZ, GRO.",1,0,1,0,5,0,
18/02/2013,CHIH.,"CHIH., CHIH.",1,0,1,0,0,32,
18/02/2013,TAMPS.,"MATAMOROS, TAMPS.",1,0,1,0,0,0,
18/02/2013,TAMPS.,"VICTORIA, TAMPS.",0,1,1,0,0,0,
19/02/2013,MEX.,"TLALNEPANTLA DE BAZ, MEX.",43,9,52,0,6,500,
19/02/2013,D.F.,"VENUSTIANO CARRANZA, D.F.",32,9,41,0,3,800,
19/02/2013,MEX.,"CUAUTITLAN IZCALLI, MEX.",34,5,39,0,1,869,
19/02/2013,MEX.,"TULTITLAN, MEX.",17,4,21,6,1,41,
19/02/2013,MEX.,"ATIZAPAN DE ZARAGOZA, MEX.",17,3,20,0,3,40,
19/02/2013,GRO.,"ACAPULCO DE JUAREZ, GRO.",2,1,3,0,1,97,
19/02/2013,CHIH.,"CHIH., CHIH.",2,0,2,0,0,336,
19/02/2013,CHIH.,"CHIH., CHIH.",1,0,1,0,0,128,
19/02/2013,CHIH.,"NUEVO CASAS GRANDES, CHIH.",0,1,1,0,0,0,
19/02/2013,CHIH.,"NUEVO CASAS GRANDES, CHIH.",1,0,1,0,0,0,
20/02/2013,MEX.,"TLALNEPANTLA DE BAZ, MEX.",64,9,73,0,7,3170,
20/02/2013,D.F.,"VENUSTIANO CARRANZA, D.F.",44,12,56,0,0,800,
20/02/2013,MEX.,"ATIZAPAN DE ZARAGOZA, MEX.",24,6,30,0,3,150,
20/02/2013,MEX.,"TULTITLAN, MEX.",23,3,26,1,1,385,
20/02/2013,MEX.,"CUAUTITLAN IZCALLI, MEX.",17,4,21,4,0,257,
20/02/2013,TAMPS.,"MATAMOROS, TAMPS.",2,7,9,0,0,0,
20/02/2013,CAMP.,"CAMP., CAMP.",3,1,4,0,0,0,
20/02/2013,GRO.,"ACAPULCO DE JUAREZ, GRO.",0,0,0,0,3,0,
21/02/2013,MEX.,"TLALNEPANTLA DE BAZ, MEX.",64,15,79,0,3,250,
21/02/2013,D.F.,"VENUSTIANO CARRANZA, D.F.",44,9,53,0,0,200,
21/02/2013,MEX.,"CUAUTITLAN IZCALLI, MEX.",29,1,30,0,6,721,
21/02/2013,MEX.,"ATIZAPAN DE ZARAGOZA, MEX.",18,4,22,0,2,40,
21/02/2013,MEX.,"TULTITLAN, MEX.",7,3,10,2,1,124,
21/02/2013,GRO.,"ACAPULCO DE JUAREZ, GRO.",3,7,10,0,0,0,
21/02/2013,HGO.,"TULANCINGO DE BRAVO, HGO.",8,1,9,0,0,0,
21/02/2013,TAMPS.,"MATAMOROS, TAMPS.",4,5,9,0,0,0,
21/02/2013,HGO.,"PACHUCA DE SOTO, HGO.",6,2,8,0,2,215,
21/02/2013,HGO.,"TULA DE ALLENDE, HGO.",3,2,5,0,4,300,
21/02/2013,HGO.,"HUEJUTLA DE REYES, HGO.",4,0,4,0,0,0,
21/02/2013,TAMPS.,"NUEVO LAREDO, TAMPS.",3,0,3,9,0,210,
21/02/2013,CHIH.,"NUEVO CASAS GRANDES, CHIH.",0,1,1,0,0,0,
21/02/2013,GRO.,"BENITO JUAREZ, GRO.",1,0,1,0,0,0,
21/02/2013,CHIH.,"CHIH., CHIH.",0,0,0,0,0,60,
22/02/2013,MEX.,"TLALNEPANTLA DE BAZ, MEX.",67,14,81,0,8,150,
22/02/2013,MEX.,"ATIZAPAN DE ZARAGOZA, MEX.",47,12,59,0,3,351,
22/02/2013,D.F.,"VENUSTIANO CARRANZA, D.F.",30,7,37,0,0,250,
22/02/2013,MEX.,"CUAUTITLAN IZCALLI, MEX.",22,7,29,0,1,306,
22/02/2013,MEX.,"TULTITLAN, MEX.",21,7,28,4,3,292,
22/02/2013,HGO.,"TULANCINGO DE BRAVO, HGO.",9,3,12,0,0,0,
22/02/2013,HGO.,"TULA DE ALLENDE, HGO.",7,1,8,0,0,200,
22/02/2013,TAMPS.,"CIUDAD MADERO, TAMPS.",8,0,8,6,1,455,
22/02/2013,GRO.,"ACAPULCO DE JUAREZ, GRO.",6,1,7,2,2,361,
22/02/2013,TAMPS.,"MATAMOROS, TAMPS.",1,5,6,0,0,0,
22/02/2013,HGO.,"PACHUCA DE SOTO, HGO.",4,1,5,0,0,144,
22/02/2013,CHIH.,"CHIH., CHIH.",3,2,5,0,0,310,
22/02/2013,HGO.,"HUEJUTLA DE REYES, HGO.",3,1,4,0,0,0,
22/02/2013,TAMPS.,"TAMPICO, TAMPS.",3,1,4,25,0,1098,
22/02/2013,CAMP.,"CAMP., CAMP.",3,0,3,0,0,0,
22/02/2013,TAMPS.,"NUEVO LAREDO, TAMPS.",1,2,3,3,3,101,
22/02/2013,TAMPS.,"RIO BRAVO, TAMPS.",1,2,3,0,0,0,
22/02/2013,CHIH.,"NUEVO CASAS GRANDES, CHIH.",1,0,1,0,0,0,
22/02/2013,GRO.,"BENITO JUAREZ, GRO.",1,0,1,1,0,0,
23/02/2013,MEX.,"TLALNEPANTLA DE BAZ, MEX.",40,23,63,0,2,0,
23/02/2013,MEX.,"ATIZAPAN DE ZARAGOZA, MEX.",35,4,39,0,0,981,
23/02/2013,MEX.,"TULTITLAN, MEX.",18,7,25,2,2,379,
23/02/2013,MEX.,"CUAUTITLAN IZCALLI, MEX.",22,0,22,10,3,784,
23/02/2013,GRO.,"BENITO JUAREZ, GRO.",4,2,6,1,5,89,
23/02/2013,HGO.,"PACHUCA DE SOTO, HGO.",4,1,5,0,1,28,
23/02/2013,TAMPS.,"CIUDAD MADERO, TAMPS.",3,0,3,19,0,872,
23/02/2013,HGO.,"TULA DE ALLENDE, HGO.",2,1,3,0,2,0,
23/02/2013,TAMPS.,"VICTORIA, TAMPS.",2,0,2,13,4,165,
23/02/2013,JAL.,"DEGOLLADO, JAL.",2,0,2,1,0,0,
23/02/2013,TAMPS.,"ALTAMIRA, TAMPS.",1,0,1,0,0,91,
23/02/2013,HGO.,"HUEJUTLA DE REYES, HGO.",1,0,1,0,0,0,
23/02/2013,TAMPS.,"TAMPICO, TAMPS.",0,0,0,13,1,689,
23/02/2013,HGO.,"TULANCINGO DE BRAVO, HGO.",0,0,0,0,0,200,
24/02/2013,MEX.,"TLALNEPANTLA DE BAZ, MEX.",74,15,89,0,0,150,
24/02/2013,MEX.,"CUAUTITLAN IZCALLI, MEX.",23,5,28,0,2,256,
24/02/2013,MEX.,"ATIZAPAN DE ZARAGOZA, MEX.",19,5,24,0,0,400,
24/02/2013,MEX.,"TULTITLAN, MEX.",6,3,9,4,0,58,
24/02/2013,GRO.,"ACAPULCO DE JUAREZ, GRO.",2,1,3,2,4,48,
24/02/2013,TAMPS.,"CIUDAD MADERO, TAMPS.",2,0,2,5,0,784,
24/02/2013,TAMPS.,"TAMPICO, TAMPS.",0,1,1,20,1,1127,
24/02/2013,TAMPS.,"ALTAMIRA, TAMPS.",0,1,1,0,0,114,
25/02/2013,MEX.,"TECAMAC, MEX.",30,13,43,0,5,770,
25/02/2013,MEX.,"CHALCO, MEX.",21,4,25,5,3,344,
25/02/2013,MEX.,"COACALCO DE BERRIOZABAL, MEX.",15,7,22,4,0,108,
25/02/2013,MEX.,"IXTAPALUCA, MEX.",13,2,15,7,1,50,
25/02/2013,CHIS.,"SAN CRISTOBAL DE LAS CASAS, CHIS.",3,9,12,2,0,106,
25/02/2013,HGO.,"PACHUCA DE SOTO, HGO.",6,1,7,0,0,87,
25/02/2013,HGO.,"TULANCINGO DE BRAVO, HGO.",4,1,5,0,0,0,
25/02/2013,TAMPS.,"MATAMOROS, TAMPS.",2,3,5,0,0,0,
25/02/2013,CHIS.,"SAN CRISTOBAL DE LAS CASAS, CHIS.",2,2,4,1,0,1450,
25/02/2013,HGO.,"TULA DE ALLENDE, HGO.",3,0,3,0,0,0,
25/02/2013,HGO.,"HUEJUTLA DE REYES, HGO.",2,1,3,0,0,0,
25/02/2013,CHIH.,"CHIH., CHIH.",1,2,3,0,0,153,
25/02/2013,CAMP.,"CAMP., CAMP.",2,0,2,0,0,0,
25/02/2013,CAMP.,"CALAKMUL, CAMP.",1,0,1,0,0,0,
26/02/2013,MEX.,"TECAMAC, MEX.",61,31,92,0,4,208,
26/02/2013,MEX.,"CHALCO, MEX.",29,10,39,5,5,209,
26/02/2013,MEX.,"IXTAPALUCA, MEX.",18,3,21,3,0,55,
26/02/2013,MEX.,"COACALCO DE BERRIOZABAL, MEX.",9,3,12,2,4,229,
26/02/2013,HGO.,"PACHUCA DE SOTO, HGO.",5,1,6,0,0,293,
26/02/2013,HGO.,"TULA DE ALLENDE, HGO.",4,0,4,0,0,0,
26/02/2013,HGO.,"TULANCINGO DE BRAVO, HGO.",2,1,3,0,0,200,
26/02/2013,JAL.,"ZAPOTLAN EL GRANDE, JAL.",1,2,3,0,0,0,
26/02/2013,CHIH.,"CHIH., CHIH.",2,0,2,2,0,86,
26/02/2013,CHIH.,"JUÁREZ, CHIH.",2,0,2,0,0,0,
26/02/2013,HGO.,"HUEJUTLA DE REYES, HGO.",2,0,2,0,0,0,
26/02/2013,CHIH.,"ALDAMA, CHIH.",1,0,1,0,0,0,
26/02/2013,TAMPS.,"VICTORIA, TAMPS.",1,0,1,0,1,206,
26/02/2013,JAL.,"GUADALAJARA, JAL.",1,0,1,0,0,0,
26/02/2013,JAL.,"ARANDAS, JAL.",1,0,1,0,0,0,
26/02/2013,B.C.,"MEXICALI, B.C.",0,1,1,0,0,0,
27/02/2013,MEX.,"TECAMAC, MEX.",38,25,63,0,6,205,
27/02/2013,MEX.,"CHALCO, MEX.",34,11,45,0,0,268,
27/02/2013,MEX.,"IXTAPALUCA, MEX.",23,6,29,3,2,169,
27/02/2013,CHIS.,"SAN CRISTOBAL DE LAS CASAS, CHIS.",7,2,9,0,0,63,
27/02/2013,TAMPS.,"MATAMOROS, TAMPS.",4,2,6,0,1,0,
27/02/2013,TAMPS.,"MATAMOROS, TAMPS.",4,2,6,0,0,0,
27/02/2013,TAMPS.,"VICTORIA, TAMPS.",3,1,4,0,0,0,
27/02/2013,CHIH.,"ALDAMA, CHIH.",1,1,2,0,0,0,
27/02/2013,JAL.,"ZAPOTLAN EL GRANDE, JAL.",2,0,2,1,0,12,
27/02/2013,JAL.,"DEGOLLADO, JAL.",2,0,2,0,0,0,
27/02/2013,CAMP.,"CAMP., CAMP.",1,0,1,0,0,0,
27/02/2013,CHIH.,"CHIH., CHIH.",1,0,1,16,0,404,
27/02/2013,MEX.,"COACALCO DE BERRIOZABAL, MEX.",0,0,0,4,5,426,
28/02/2013,COAH.,"SAN PEDRO, COAH.",34,14,48,0,0,0,
28/02/2013,MEX.,"CHALCO, MEX.",28,9,37,3,1,302,
28/02/2013,COAH.,"FRANCISCO I. MADERO, COAH.",28,6,34,0,0,0,
28/02/2013,MEX.,"IXTAPALUCA, MEX.",17,7,24,5,1,0,
28/02/2013,CHIS.,"SAN CRISTOBAL DE LAS CASAS, CHIS.",2,5,7,0,0,381,
28/02/2013,CHIH.,"CHIH., CHIH.",3,0,3,0,0,541,
01/03/2013,MEX.,"TECAMAC, MEX.",55,14,69,0,9,243,
01/03/2013,D.F.,"IZTACALCO, D.F.",37,11,48,0,2,850,
01/03/2013,N.L.,"MONTERREY, N.L.",21,21,42,0,0,0,
01/03/2013,MEX.,"CHALCO, MEX.",22,3,25,1,2,48,
01/03/2013,N.L.,"SAN NICOLAS DE LOS GARZA, N.L.",10,12,22,3,0,361,
01/03/2013,MEX.,"IXTAPALUCA, MEX.",18,3,21,3,0,116,
01/03/2013,N.L.,"GUADALUPE, N.L.",7,10,17,5,0,1445,
01/03/2013,MEX.,"COACALCO DE BERRIOZABAL, MEX.",14,1,15,6,0,20,
01/03/2013,DGO.,"DGO., DGO.",13,2,15,5,0,541,
01/03/2013,CHIS.,"SAN CRISTOBAL DE LAS CASAS, CHIS.",6,2,8,0,0,184,
01/03/2013,N.L.,"GARCIA, N.L.",5,2,7,1,0,113,
01/03/2013,N.L.,"SANTA CATARINA, N.L.",2,4,6,0,0,2238,
01/03/2013,N.L.,"SAN PEDRO GARZA GARCIA, N.L.",3,3,6,0,1,6002,
01/03/2013,TAMPS.,"CIUDAD MADERO, TAMPS.",5,0,5,0,0,0,
01/03/2013,CHIH.,"CHIH., CHIH.",3,1,4,3,0,534,
01/03/2013,N.L.,"GRAL. ESCOBEDO, N.L.",2,2,4,3,0,100,
01/03/2013,TAMPS.,"TAMPICO, TAMPS.",2,1,3,0,2,0,
01/03/2013,B.C.,"MEXICALI, B.C.",0,3,3,0,0,0,
01/03/2013,N.L.,"APODACA, N.L.",2,0,2,0,0,251,
01/03/2013,TAMPS.,"VICTORIA, TAMPS.",2,0,2,0,5,0,
01/03/2013,CHIH.,"ALDAMA, CHIH.",0,1,1,0,0,0,
01/03/2013,CHIH.,"GALEANA, CHIH.",0,0,0,0,0,56,
01/03/2013,Q. ROO,"COZUMEL, Q. ROO",0,0,0,0,0,55,
02/03/2013,N.L.,"MONTERREY, N.L.",61,30,91,8,1,4499,
02/03/2013,MEX.,"TECAMAC, MEX.",42,17,59,0,18,190,
02/03/2013,MEX.,"COACALCO DE BERRIOZABAL, MEX.",35,14,49,12,1,396,
02/03/2013,MEX.,"CHALCO, MEX.",31,5,36,1,0,114,
02/03/2013,N.L.,"GUADALUPE, N.L.",8,21,29,5,0,1381,
02/03/2013,MEX.,"IXTAPALUCA, MEX.",14,1,15,2,1,20,
02/03/2013,N.L.,"SAN NICOLAS DE LOS GARZA, N.L.",5,8,13,0,0,190,
02/03/2013,N.L.,"SAN PEDRO GARZA GARCIA, N.L.",9,1,10,0,0,591,
02/03/2013,N.L.,"APODACA, N.L.",2,7,9,0,1,559,
02/03/2013,N.L.,"JUAREZ, N.L.",6,2,8,0,0,100,
02/03/2013,N.L.,"SANTA CATARINA, N.L.",4,4,8,1,0,583,
02/03/2013,HGO.,"TULANCINGO DE BRAVO, HGO.",2,4,6,0,0,0,
02/03/2013,N.L.,"GRAL. ESCOBEDO, N.L.",6,0,6,5,1,706,
02/03/2013,N.L.,"GARCIA, N.L.",2,2,4,0,0,432,
02/03/2013,HGO.,"TULA DE ALLENDE, HGO.",2,0,2,0,0,0,
02/03/2013,HGO.,"PACHUCA DE SOTO, HGO.",1,0,1,0,1,113,
03/03/2013,MEX.,"TECAMAC, MEX.",67,29,96,0,8,910,
03/03/2013,MEX.,"CHALCO, MEX.",24,4,28,1,0,137,
03/03/2013,MEX.,"COACALCO DE BERRIOZABAL, MEX.",16,8,24,6,2,654,
03/03/2013,N.L.,"GUADALUPE, N.L.",8,13,21,5,0,1227,
03/03/2013,MICH.,"LAZARO CARDENAS, MICH.",11,3,14,9,1,165,
03/03/2013,MEX.,"IXTAPALUCA, MEX.",9,3,12,4,0,28,
03/03/2013,N.L.,"GRAL. ESCOBEDO, N.L.",6,5,11,4,1,198,
03/03/2013,B.C.,"TECATE, B.C.",1,9,10,0,0,0,
03/03/2013,N.L.,"SAN PEDRO GARZA GARCIA, N.L.",8,0,8,0,0,499,
03/03/2013,N.L.,"MONTERREY, N.L.",3,2,5,4,1,437,
03/03/2013,N.L.,"APODACA, N.L.",1,4,5,0,1,6,
03/03/2013,N.L.,"GARCIA, N.L.",2,3,5,0,0,15,
03/03/2013,N.L.,"SANTA CATARINA, N.L.",3,1,4,10,0,496,
03/03/2013,TAMPS.,"CIUDAD MADERO, TAMPS.",3,0,3,3,0,183,
03/03/2013,CHIS.,"SAN CRISTOBAL DE LAS CASAS, CHIS.",2,1,3,0,0,110,
03/03/2013,N.L.,"JUAREZ, N.L.",0,3,3,0,0,100,
03/03/2013,JAL.,"TOMATLAN, JAL.",3,0,3,0,0,0,
03/03/2013,TAMPS.,"TAMPICO, TAMPS.",2,0,2,35,0,1807,
03/03/2013,N.L.,"SAN NICOLAS DE LOS GARZA, N.L.",2,0,2,0,0,510,
03/03/2013,TAMPS.,"TAMPICO, TAMPS.",2,0,2,0,0,106,
03/03/2013,TAMPS.,"CIUDAD MADERO, TAMPS.",2,0,2,29,3,713,
03/03/2013,TAMPS.,"NUEVO LAREDO, TAMPS.",1,0,1,0,0,0,
04/03/2013,D.F.,"IZTACALCO, D.F.",63,10,73,0,2,960,
04/03/2013,MEX.,"CHIMALHUACAN, MEX.",20,8,28,2,6,465,
04/03/2013,DGO.,"DGO., DGO.",18,7,25,9,1,0,
04/03/2013,GRO.,"ACAPULCO DE JUAREZ, GRO.",14,7,21,0,10,25,
04/03/2013,MEX.,"VALLE DE CHALCO SOLIDARIDAD, MEX.",14,1,15,0,4,128,
04/03/2013,N.L.,"APODACA, N.L.",5,5,10,2,1,256,
04/03/2013,CHIH.,"CHIH., CHIH.",7,2,9,7,0,226,
04/03/2013,MEX.,"TEXCOCO, MEX.",6,2,8,0,0,55,
04/03/2013,HGO.,"PACHUCA DE SOTO, HGO.",4,4,8,0,0,0,
04/03/2013,HGO.,"TULANCINGO DE BRAVO, HGO.",8,0,8,0,0,0,
04/03/2013,N.L.,"GARCIA, N.L.",3,3,6,0,0,327,
04/03/2013,HGO.,"TULA DE ALLENDE, HGO.",5,1,6,0,0,0,
04/03/2013,MEX.,"METEPEC, MEX.",5,0,5,3,1,262,
04/03/2013,N.L.,"MONTERREY, N.L.",3,1,4,13,0,1208,
04/03/2013,N.L.,"JUAREZ, N.L.",2,2,4,0,0,300,
04/03/2013,N.L.,"SAN NICOLAS DE LOS GARZA, N.L.",2,1,3,0,0,314,
04/03/2013,N.L.,"GUADALUPE, N.L.",1,1,2,1,0,35,
04/03/2013,N.L.,"SANTA CATARINA, N.L.",1,1,2,0,0,56,
04/03/2013,N.L.,"SAN PEDRO GARZA GARCIA, N.L.",2,0,2,2,1,1683,
04/03/2013,Q. ROO,"COZUMEL, Q. ROO",0,1,1,0,0,337,
04/03/2013,Q. ROO,"TULUM, Q. ROO",1,0,1,1,0,0,
04/03/2013,Q. ROO,"BACALAR, Q. ROO",1,0,1,0,0,0,
04/03/2013,TAMPS.,"VICTORIA, TAMPS.",0,0,0,0,4,0,
05/03/2013,D.F.,"IZTACALCO, D.F.",45,11,56,0,5,620,
05/03/2013,DGO.,"DGO., DGO.",33,10,43,11,2,0,
05/03/2013,MEX.,"CHIMALHUACAN, MEX.",29,5,34,0,2,459,
05/03/2013,MEX.,"METEPEC, MEX.",19,7,26,7,0,286,
05/03/2013,MEX.,"TEXCOCO, MEX.",18,6,24,5,0,690,
05/03/2013,MEX.,"VALLE DE CHALCO SOLIDARIDAD, MEX.",17,3,20,4,1,92,
05/03/2013,N.L.,"SAN NICOLAS DE LOS GARZA, N.L.",5,7,12,4,0,2250,
05/03/2013,N.L.,"MONTERREY, N.L.",7,3,10,19,0,719,
05/03/2013,N.L.,"SANTA CATARINA, N.L.",9,1,10,0,0,3521,
05/03/2013,N.L.,"GUADALUPE, N.L.",5,1,6,0,0,1988,
05/03/2013,N.L.,"GRAL. ESCOBEDO, N.L.",4,1,5,0,0,1026,
05/03/2013,HGO.,"TULANCINGO DE BRAVO, HGO.",3,1,4,0,0,0,
05/03/2013,N.L.,"APODACA, N.L.",2,2,4,10,0,806,
05/03/2013,N.L.,"GARCIA, N.L.",1,3,4,0,0,50,
05/03/2013,TAMPS.,"VICTORIA, TAMPS.",3,0,3,0,4,0,
05/03/2013,HGO.,"PACHUCA DE SOTO, HGO.",2,0,2,0,6,104,
05/03/2013,CHIH.,"CHIH., CHIH.",2,0,2,4,0,273,
05/03/2013,N.L.,"JUAREZ, N.L.",1,1,2,0,0,100,
05/03/2013,N.L.,"SAN PEDRO GARZA GARCIA, N.L.",2,0,2,7,0,1525,
05/03/2013,HGO.,"HUEJUTLA DE REYES, HGO.",0,1,1,0,0,0,
05/03/2013,CHIS.,"SAN CRISTOBAL DE LAS CASAS, CHIS.",0,1,1,0,0,97,
05/03/2013,CHIH.,"ROSALES, CHIH.",0,0,0,0,0,11,
05/03/2013,Q. ROO,"TULUM, Q. ROO",0,0,0,0,0,18,
06/03/2013,DGO.,"DGO., DGO.",30,15,45,5,1,0,
06/03/2013,D.F.,"IZTACALCO, D.F.",35,7,42,0,7,1545,
06/03/2013,MEX.,"CHIMALHUACAN, MEX.",18,10,28,0,0,191,
06/03/2013,MEX.,"TEXCOCO, MEX.",21,4,25,0,1,705,
06/03/2013,MEX.,"VALLE DE CHALCO SOLIDARIDAD, MEX.",19,2,21,3,5,105,
06/03/2013,AGS.,"AGS., AGS.",12,2,14,5,0,121,
06/03/2013,MEX.,"METEPEC, MEX.",13,1,14,3,1,123,
06/03/2013,N.L.,"GUADALUPE, N.L.",5,1,6,0,0,1968,
06/03/2013,N.L.,"SANTA CATARINA, N.L.",2,4,6,5,0,9903,
06/03/2013,N.L.,"SAN PEDRO GARZA GARCIA, N.L.",2,4,6,0,0,500,
06/03/2013,HGO.,"TULANCINGO DE BRAVO, HGO.",5,0,5,0,0,200,
06/03/2013,N.L.,"APODACA, N.L.",3,1,4,0,0,1455,
06/03/2013,N.L.,"SAN NICOLAS DE LOS GARZA, N.L.",2,2,4,0,0,1768,
06/03/2013,N.L.,"JUAREZ, N.L.",2,2,4,4,0,100,
06/03/2013,TAMPS.,"VICTORIA, TAMPS.",2,2,4,0,0,25,
06/03/2013,N.L.,"GARCIA, N.L.",2,1,3,0,0,135,
06/03/2013,HGO.,"TULA DE ALLENDE, HGO.",0,2,2,0,0,0,
06/03/2013,HGO.,"HUEJUTLA DE REYES, HGO.",1,1,2,0,0,0,
06/03/2013,HGO.,"PACHUCA DE SOTO, HGO.",2,0,2,0,2,55,
06/03/2013,N.L.,"MONTERREY, N.L.",1,0,1,11,0,1229,
06/03/2013,N.L.,"GRAL. ESCOBEDO, N.L.",0,0,0,0,0,674,
06/03/2013,CHIH.,"CHIH., CHIH.",0,0,0,6,0,58,
07/03/2013,MEX.,"CHIMALHUACAN, MEX.",41,4,45,0,2,50,
07/03/2013,D.F.,"IZTACALCO, D.F.",33,10,43,0,4,650,
07/03/2013,DGO.,"DGO., DGO.",26,17,43,8,2,0,
07/03/2013,AGS.,"AGS., AGS.",30,8,38,12,0,852,
07/03/2013,MEX.,"TEXCOCO, MEX.",17,10,27,0,0,203,
07/03/2013,MEX.,"VALLE DE CHALCO SOLIDARIDAD, MEX.",21,6,27,0,1,65,
07/03/2013,N.L.,"MONTERREY, N.L.",7,10,17,21,0,6371,
07/03/2013,HGO.,"TULANCINGO DE BRAVO, HGO.",4,3,7,0,0,634,
07/03/2013,HGO.,"PACHUCA DE SOTO, HGO.",3,3,6,0,2,244,
07/03/2013,N.L.,"SANTA CATARINA, N.L.",4,1,5,0,0,5348,
07/03/2013,N.L.,"SAN NICOLAS DE LOS GARZA, N.L.",2,2,4,0,0,2945,
07/03/2013,N.L.,"GUADALUPE, N.L.",1,2,3,0,0,3905,
07/03/2013,HGO.,"TULA DE ALLENDE, HGO.",2,0,2,0,0,0,
07/03/2013,N.L.,"GRAL. ESCOBEDO, N.L.",1,1,2,0,0,1300,
07/03/2013,CAMP.,"HOPELCHÉN, CAMP.",2,0,2,0,0,0,
07/03/2013,CHIH.,"CHIH., CHIH.",1,1,2,4,0,33,
07/03/2013,TAMPS.,"VICTORIA, TAMPS.",0,2,2,0,0,91,
07/03/2013,N.L.,"APODACA, N.L.",0,1,1,0,0,107,
07/03/2013,N.L.,"JUAREZ, N.L.",1,0,1,0,1,200,
07/03/2013,N.L.,"GARCIA, N.L.",0,1,1,0,1,1046,
07/03/2013,N.L.,"SAN PEDRO GARZA GARCIA, N.L.",0,1,1,0,0,0,
07/03/2013,HGO.,"HUEJUTLA DE REYES, HGO.",1,0,1,0,0,0,
07/03/2013,Q. ROO,"BACALAR, Q. ROO",1,0,1,0,0,0,
07/03/2013,Q. ROO,"COZUMEL, Q. ROO",0,0,0,0,0,21,
08/03/2013,COAH.,"SALTILLO, COAH.",230,125,355,21,12,25316,
08/03/2013,COAH.,"MATAMOROS, COAH.",66,21,87,1,7,0,
08/03/2013,DGO.,"DGO., DGO.",46,27,73,43,1,0,
08/03/2013,COAH.,"TORREÓN, COAH.",50,10,60,1,2,53,
08/03/2013,D.F.,"IZTACALCO, D.F.",30,12,42,0,2,690,
08/03/2013,MEX.,"TEXCOCO, MEX.",32,9,41,0,0,486,
08/03/2013,HGO.,"PACHUCA DE SOTO, HGO.",28,4,32,0,10,788,
08/03/2013,MEX.,"VALLE DE CHALCO SOLIDARIDAD, MEX.",26,6,32,0,1,200,
08/03/2013,AGS.,"AGS., AGS.",25,6,31,11,0,855,
08/03/2013,MEX.,"CHIMALHUACAN, MEX.",27,4,31,0,5,22,
08/03/2013,COAH.,"MÚZQUIZ, COAH.",17,14,31,4,0,152,
08/03/2013,COAH.,"VIESCA, COAH.",13,5,18,21,2,0,
08/03/2013,MEX.,"METEPEC, MEX.",14,0,14,4,1,280,
08/03/2013,N.L.,"SANTA CATARINA, N.L.",2,9,11,0,0,1923,
08/03/2013,HGO.,"TULANCINGO DE BRAVO, HGO.",4,2,6,0,0,938,
08/03/2013,N.L.,"SAN NICOLAS DE LOS GARZA, N.L.",3,3,6,0,0,120,
08/03/2013,N.L.,"MONTERREY, N.L.",3,2,5,17,0,705,
08/03/2013,N.L.,"APODACA, N.L.",2,3,5,0,0,755,
08/03/2013,CHIH.,"IGNACIO ZARAGOZA, CHIH.",2,2,4,0,0,0,
08/03/2013,TAMPS.,"TAMPICO, TAMPS.",2,2,4,1,0,575,
08/03/2013,HGO.,"TULA DE ALLENDE, HGO.",2,1,3,0,0,400,
08/03/2013,N.L.,"GUADALUPE, N.L.",3,0,3,1,0,5082,
08/03/2013,MICH.,"LAZARO CARDENAS, MICH.",3,0,3,3,0,44,
08/03/2013,TAMPS.,"CIUDAD MADERO, TAMPS.",3,0,3,21,0,569,
08/03/2013,TAMPS.,"NUEVO LAREDO, TAMPS.",0,2,2,0,0,108,
08/03/2013,TAMPS.,"GUSTAVO DIAZ ORDAZ, TAMPS.",1,1,2,0,0,0,
08/03/2013,HGO.,"HUEJUTLA DE REYES, HGO.",1,0,1,0,0,0,
08/03/2013,N.L.,"SAN PEDRO GARZA GARCIA, N.L.",1,0,1,1,0,301,
08/03/2013,CHIH.,"CHIH., CHIH.",0,1,1,1,0,480,
08/03/2013,N.L.,"GARCIA, N.L.",0,0,0,1,0,16176,
08/03/2013,Q. ROO,"COZUMEL, Q. ROO",0,0,0,0,1,336,
08/03/2013,TAMPS.,"VICTORIA, TAMPS.",0,0,0,2,0,156,
09/03/2013,MEX.,"TEXCOCO, MEX.",46,16,62,0,6,253,
09/03/2013,VER.,"XALAPA, VER.",37,10,47,4,4,1168,
09/03/2013,MEX.,"CHIMALHUACAN, MEX.",32,2,34,0,1,193,
09/03/2013,MEX.,"VALLE DE CHALCO SOLIDARIDAD, MEX.",15,9,24,0,0,97,
09/03/2013,N.L.,"MONTERREY, N.L.",19,3,22,13,0,7653,
09/03/2013,MEX.,"METEPEC, MEX.",11,4,15,7,1,173,
09/03/2013,N.L.,"SAN NICOLAS DE LOS GARZA, N.L.",1,6,7,1,0,2026,
09/03/2013,TAMPS.,"CIUDAD MADERO, TAMPS.",5,0,5,0,0,0,
09/03/2013,TAMPS.,"VICTORIA, TAMPS.",4,0,4,7,0,112,
09/03/2013,MICH.,"LAZARO CARDENAS, MICH.",4,0,4,3,0,44,
09/03/2013,N.L.,"SAN PEDRO GARZA GARCIA, N.L.",2,1,3,2,1,850,
09/03/2013,TAMPS.,"NUEVO LAREDO, TAMPS.",1,2,3,0,1,25,
09/03/2013,JAL.,"PUERTO VALLARTA, JAL.",1,1,2,0,0,0,
09/03/2013,N.L.,"GRAL. ESCOBEDO, N.L.",2,0,2,0,0,1100,
09/03/2013,TAMPS.,"TAMPICO, TAMPS.",2,0,2,0,0,0,
09/03/2013,N.L.,"APODACA, N.L.",0,1,1,0,0,101,
09/03/2013,N.L.,"GUADALUPE, N.L.",1,0,1,0,0,8241,
09/03/2013,N.L.,"GARCIA, N.L.",1,0,1,0,0,6708,
09/03/2013,TAMPS.,"ALTAMIRA, TAMPS.",1,0,1,0,0,0,
09/03/2013,N.L.,"JUAREZ, N.L.",0,0,0,1,0,200,
09/03/2013,N.L.,"SANTA CATARINA, N.L.",0,0,0,0,0,8074,
10/03/2013,N.L.,"MONTERREY, N.L.",35,21,56,34,1,14162,
10/03/2013,MEX.,"CHIMALHUACAN, MEX.",41,1,42,0,8,156,
10/03/2013,MEX.,"TEXCOCO, MEX.",23,2,25,0,0,6,
10/03/2013,MEX.,"VALLE DE CHALCO SOLIDARIDAD, MEX.",17,3,20,0,1,65,
10/03/2013,MEX.,"METEPEC, MEX.",13,3,16,9,0,330,
10/03/2013,N.L.,"GUADALUPE, N.L.",12,2,14,2,1,8243,
10/03/2013,N.L.,"SAN NICOLAS DE LOS GARZA, N.L.",6,0,6,1,0,2857,
10/03/2013,N.L.,"SANTA CATARINA, N.L.",5,0,5,11,0,4131,
10/03/2013,N.L.,"GARCIA, N.L.",1,2,3,0,0,16778,
10/03/2013,TAMPS.,"CIUDAD MADERO, TAMPS.",3,0,3,1,0,5,
10/03/2013,N.L.,"GRAL. ESCOBEDO, N.L.",1,0,1,0,0,1300,
10/03/2013,N.L.,"JUAREZ, N.L.",1,0,1,3,0,0,
10/03/2013,Q. ROO,"TULUM, Q. ROO",0,1,1,0,0,0,
10/03/2013,TAMPS.,"TAMPICO, TAMPS.",1,0,1,3,0,606,
10/03/2013,N.L.,"APODACA, N.L.",0,0,0,1,0,81,
10/03/2013,N.L.,"SAN PEDRO GARZA GARCIA, N.L.",0,0,0,0,0,1000,
10/03/2013,TAMPS.,"ALTAMIRA, TAMPS.",0,0,0,0,0,60,
11/03/2013,DGO.,"DGO., DGO.",23,11,34,25,4,0,
11/03/2013,MEX.,"LA PAZ, MEX.",20,3,23,0,2,0,
11/03/2013,MEX.,"CUAUTITLAN, MEX.",14,2,16,1,0,126,
11/03/2013,MEX.,"HUIXQUILUCAN, MEX.",14,1,15,0,0,689,
11/03/2013,GRO.,"ACAPULCO DE JUAREZ, GRO.",10,4,14,4,8,69,
11/03/2013,D.F.,"CUAJIMALPA DE MOR., D.F.",6,3,9,0,0,360,
11/03/2013,MEX.,"NICOLAS ROMERO, MEX.",8,0,8,9,0,781,
11/03/2013,VER.,"TUXPAM, VER.",3,4,7,0,0,31,
11/03/2013,VER.,"TUXPAM, VER.",4,3,7,0,0,972,
11/03/2013,AGS.,"AGS., AGS.",5,0,5,0,0,5,
11/03/2013,HGO.,"ACTOPAN, HGO.",4,1,5,0,1,0,
11/03/2013,HGO.,"TEPEAPULCO, HGO.",3,2,5,0,2,20,
11/03/2013,TAMPS.,"VICTORIA, TAMPS.",3,0,3,0,0,10,
11/03/2013,COAH.,"TORREÓN, COAH.",3,0,3,0,0,0,
11/03/2013,HGO.,"TIZAYUCA, HGO.",2,0,2,0,1,100,
11/03/2013,CHIH.,"CHIH., CHIH.",0,1,1,1,0,81,
11/03/2013,HGO.,"ACTOPAN, HGO.",1,0,1,0,0,0,
11/03/2013,SON.,"CAJEME, SON.",1,0,1,0,0,0,
12/03/2013,DGO.,"DGO., DGO.",39,15,54,17,1,0,
12/03/2013,MEX.,"LA PAZ, MEX.",27,4,31,0,2,100,
12/03/2013,D.F.,"CUAJIMALPA DE MOR., D.F.",25,3,28,0,1,176,
12/03/2013,MEX.,"NICOLAS ROMERO, MEX.",11,5,16,5,0,466,
12/03/2013,MEX.,"CUAUTITLAN, MEX.",7,3,10,0,0,389,
12/03/2013,AGS.,"AGS., AGS.",8,0,8,0,0,9,
12/03/2013,MEX.,"HUIXQUILUCAN, MEX.",5,2,7,1,2,526,
12/03/2013,HGO.,"TIZAYUCA, HGO.",2,2,4,0,0,34,
12/03/2013,HGO.,"IXMIQUILPAN, HGO.",2,0,2,0,0,0,
12/03/2013,HGO.,"TEPEAPULCO, HGO.",1,1,2,0,1,0,
12/03/2013,VER.,"TUXPAM, VER.",2,0,2,0,0,0,
12/03/2013,CHIH.,"CHIH., CHIH.",1,1,2,4,0,101,
12/03/2013,TAMPS.,"VICTORIA, TAMPS.",0,0,0,0,0,240,
13/03/2013,D.F.,"CUAJIMALPA DE MOR., D.F.",21,12,33,0,1,125,
13/03/2013,MEX.,"HUIXQUILUCAN, MEX.",21,1,22,11,0,234,
13/03/2013,MEX.,"LA PAZ, MEX.",16,5,21,0,0,89,
13/03/2013,MEX.,"NICOLAS ROMERO, MEX.",7,10,17,1,0,104,
13/03/2013,MEX.,"CUAUTITLAN, MEX.",13,3,16,0,0,92,
13/03/2013,CHIH.,"CUAUHTÉMOC, CHIH.",5,2,7,1,0,138,
13/03/2013,VER.,"VER., VER.",4,1,5,2,0,79,
13/03/2013,S.L.P.,"CIUDAD VALLES, S.L.P.",4,0,4,0,2,0,
13/03/2013,AGS.,"AGS., AGS.",3,0,3,1,0,18,
13/03/2013,HGO.,"TIZAYUCA, HGO.",3,0,3,0,2,0,
13/03/2013,CHIH.,"CHIH., CHIH.",3,0,3,0,0,0,
13/03/2013,HGO.,"ACTOPAN, HGO.",2,0,2,0,0,0,
13/03/2013,HGO.,"IXMIQUILPAN, HGO.",1,1,2,0,0,0,
13/03/2013,HGO.,"TEPEAPULCO, HGO.",0,1,1,0,1,115,
13/03/2013,VER.,"TUXPAM, VER.",0,0,0,0,0,0,
13/03/2013,TAMPS.,"VICTORIA, TAMPS.",0,0,0,0,2,75,
14/03/2013,DGO.,"DGO., DGO.",46,12,58,10,0,0,
14/03/2013,D.F.,"CUAJIMALPA DE MOR., D.F.",18,10,28,0,2,150,
14/03/2013,MEX.,"LA PAZ, MEX.",17,2,19,0,0,300,
14/03/2013,MEX.,"CUAUTITLAN, MEX.",14,2,16,0,0,75,
14/03/2013,CHIH.,"DELICIAS, CHIH.",13,1,14,0,0,0,
14/03/2013,S.L.P.,"CIUDAD VALLES, S.L.P.",5,6,11,2,0,46,
14/03/2013,MEX.,"NICOLAS ROMERO, MEX.",9,0,9,4,0,38,
14/03/2013,COAH.,"NUEVA ROSITA, COAH.",2,6,8,1,1,26,
14/03/2013,MEX.,"HUIXQUILUCAN, MEX.",6,2,8,2,3,67,
14/03/2013,HGO.,"TIZAYUCA, HGO.",2,4,6,0,3,0,
14/03/2013,HGO.,"IXMIQUILPAN, HGO.",1,3,4,0,0,0,
14/03/2013,CAMP.,"HOPELCHÉN, CAMP.",1,1,2,0,0,0,
14/03/2013,AGS.,"AGS., AGS.",2,0,2,0,0,0,
14/03/2013,HGO.,"TEPEAPULCO, HGO.",1,1,2,0,0,74,
14/03/2013,CHIH.,"CHIH., CHIH.",1,0,1,0,0,52,
14/03/2013,VER.,"COSAMALOAPAN DE CARPIO, VER.",1,0,1,0,0,0,
14/03/2013,VER.,"TUXPAM, VER.",0,0,0,0,0,0,
15/03/2013,DGO.,"DGO., DGO.",39,16,55,57,5,0,
15/03/2013,D.F.,"CUAJIMALPA DE MOR., D.F.",13,6,19,0,0,235,
15/03/2013,MEX.,"LA PAZ, MEX.",11,4,15,0,0,0,
15/03/2013,MEX.,"CUAUTITLAN, MEX.",1,11,12,2,0,46,
15/03/2013,MEX.,"NICOLAS ROMERO, MEX.",7,2,9,5,0,213,
15/03/2013,S.L.P.,"CIUDAD VALLES, S.L.P.",8,0,8,3,0,0,
15/03/2013,MEX.,"HUIXQUILUCAN, MEX.",4,1,5,4,0,52,
15/03/2013,HGO.,"TIZAYUCA, HGO.",3,1,4,0,1,0,
15/03/2013,HGO.,"TEPEAPULCO, HGO.",3,0,3,0,0,26,
15/03/2013,CAMP.,"CARMEN, CAMP.",2,1,3,0,0,0,
15/03/2013,TAMPS.,"CIUDAD MADERO, TAMPS.",3,0,3,0,0,19,
15/03/2013,CHIH.,"CUAUHTÉMOC, CHIH.",2,1,3,0,0,0,
15/03/2013,HGO.,"ACTOPAN, HGO.",2,0,2,0,0,0,
15/03/2013,VER.,"OTEAPAN, VER.",0,2,2,0,0,0,
15/03/2013,VER.,"VER., VER.",2,0,2,1,0,465,
15/03/2013,TAMPS.,"TAMPICO, TAMPS.",2,0,2,21,2,532,
15/03/2013,S.L.P.,"AHUALULCO, S.L.P.",2,0,2,0,0,0,
15/03/2013,CHIH.,"CHIH., CHIH.",0,1,1,0,0,0,
15/03/2013,HGO.,"IXMIQUILPAN, HGO.",0,1,1,0,1,0,
15/03/2013,VER.,"COSAMALOAPAN DE CARPIO, VER.",0,1,1,0,0,0,
15/03/2013,VER.,"TUXPAM, VER.",1,0,1,0,0,0,
15/03/2013,TAMPS.,"NUEVO LAREDO, TAMPS.",0,1,1,0,0,0,
15/03/2013,Q. ROO,"COZUMEL, Q. ROO",0,0,0,0,0,33,
16/03/2013,MEX.,"CUAUTITLAN, MEX.",23,0,23,2,1,307,
16/03/2013,MEX.,"LA PAZ, MEX.",19,4,23,0,1,0,
16/03/2013,MEX.,"NICOLAS ROMERO, MEX.",12,1,13,6,0,142,
16/03/2013,MEX.,"HUIXQUILUCAN, MEX.",7,3,10,0,4,56,
16/03/2013,HGO.,"TEPEAPULCO, HGO.",7,2,9,0,0,20,
16/03/2013,HGO.,"TIZAYUCA, HGO.",3,2,5,0,2,50,
16/03/2013,TAMPS.,"CIUDAD MADERO, TAMPS.",2,3,5,12,2,130,
16/03/2013,HGO.,"IXMIQUILPAN, HGO.",2,0,2,0,0,0,
16/03/2013,VER.,"VER., VER.",2,0,2,0,0,0,
16/03/2013,VER.,"VER., VER.",0,1,1,0,0,0,
16/03/2013,TAMPS.,"NUEVO LAREDO, TAMPS.",0,1,1,0,0,100,
16/03/2013,TAMPS.,"TAMPICO, TAMPS.",1,0,1,30,0,727,
16/03/2013,JAL.,"TOMATLAN, JAL.",1,0,1,0,0,0,
16/03/2013,HGO.,"ACTOPAN, HGO.",0,0,0,0,1,300,
16/03/2013,Q. ROO,"COZUMEL, Q. ROO",0,0,0,0,0,73,
17/03/2013,MEX.,"LA PAZ, MEX.",31,7,38,0,7,0,
17/03/2013,MEX.,"CUAUTITLAN, MEX.",18,3,21,0,0,1005,
17/03/2013,MEX.,"HUIXQUILUCAN, MEX.",14,1,15,0,5,0,
17/03/2013,MEX.,"NICOLAS ROMERO, MEX.",5,0,5,2,0,413,
17/03/2013,TAMPS.,"CIUDAD MADERO, TAMPS.",1,2,3,0,0,474,
17/03/2013,TAMPS.,"TAMPICO, TAMPS.",1,0,1,7,0,427,
17/03/2013,VER.,"VER., VER.",0,1,1,0,0,0,
18/03/2013,DGO.,"DGO., DGO.",27,13,40,7,1,0,
18/03/2013,HGO.,"TIZAYUCA, HGO.",5,0,5,0,0,1200,
18/03/2013,TAMPS.,"VICTORIA, TAMPS.",2,3,5,0,0,0,
18/03/2013,N.L.,"CADEREYTA JIMENEZ, N.L.",1,1,2,0,0,21,
18/03/2013,HGO.,"IXMIQUILPAN, HGO.",2,0,2,0,1,0,
18/03/2013,HGO.,"ACTOPAN, HGO.",1,0,1,0,0,0,
18/03/2013,HGO.,"TEPEAPULCO, HGO.",0,1,1,0,0,0,
18/03/2013,TAMPS.,"XICOTENCATL, TAMPS.",1,0,1,1,0,0,
18/03/2013,N.L.,"SABINAS HGO., N.L.",0,0,0,0,0,0,
19/03/2013,DGO.,"DGO., DGO.",30,11,41,22,3,0,
19/03/2013,D.F.,"XOCHIMILCO, D.F.",20,6,26,0,0,136,
19/03/2013,MEX.,"CHICOLOAPAN, MEX.",14,1,15,0,0,0,
19/03/2013,MEX.,"ZUMPANGO, MEX.",8,1,9,3,0,37,
19/03/2013,S.L.P.,"SOLEDAD DE GRACIANO SANCHEZ, S.L.P.",7,0,7,2,0,23,
19/03/2013,AGS.,"AGS., AGS.",4,2,6,2,0,92,
19/03/2013,MEX.,"TULTEPEC, MEX.",4,2,6,0,2,35,
19/03/2013,N.L.,"CADEREYTA JIMENEZ, N.L.",2,3,5,1,0,119,
19/03/2013,HGO.,"ACTOPAN, HGO.",4,0,4,0,0,0,
19/03/2013,HGO.,"IXMIQUILPAN, HGO.",3,0,3,0,0,419,
19/03/2013,HGO.,"TEPEAPULCO, HGO.",1,1,2,0,0,105,
19/03/2013,HGO.,"TIZAYUCA, HGO.",0,2,2,0,0,100,
19/03/2013,CHIH.,"CUAUHTÉMOC, CHIH.",1,1,2,0,0,0,
19/03/2013,TAMPS.,"VICTORIA, TAMPS.",2,0,2,0,0,50,
19/03/2013,Q. ROO,"SOLIDARIDAD, Q. ROO",1,0,1,0,0,5,
19/03/2013,VER.,"VER., VER.",1,0,1,0,0,60,
19/03/2013,CHIH.,"CHIH., CHIH.",1,0,1,0,0,40,
19/03/2013,N.L.,"SABINAS HGO., N.L.",0,1,1,0,0,0,
20/03/2013,D.F.,"XOCHIMILCO, D.F.",35,13,48,0,2,420,
20/03/2013,DGO.,"DGO., DGO.",29,19,48,11,4,0,
20/03/2013,MEX.,"CHICOLOAPAN, MEX.",28,7,35,0,1,0,
20/03/2013,MEX.,"TULTEPEC, MEX.",19,6,25,0,2,209,
20/03/2013,MEX.,"ZUMPANGO, MEX.",14,9,23,1,1,729,
20/03/2013,N.L.,"CADEREYTA JIMENEZ, N.L.",7,2,9,2,0,0,
20/03/2013,HGO.,"TIZAYUCA, HGO.",7,1,8,0,0,328,
20/03/2013,AGS.,"AGS., AGS.",6,0,6,3,0,294,
20/03/2013,CHIH.,"ASCENSIÓN, CHIH.",0,6,6,1,0,206,
20/03/2013,CAMP.,"CARMEN, CAMP.",4,0,4,0,0,0,
20/03/2013,S.L.P.,"SOLEDAD DE GRACIANO SANCHEZ, S.L.P.",1,2,3,0,0,7,
20/03/2013,HGO.,"TEPEAPULCO, HGO.",3,0,3,0,0,444,
20/03/2013,HGO.,"IXMIQUILPAN, HGO.",2,0,2,0,0,0,
20/03/2013,N.L.,"SABINAS HGO., N.L.",1,0,1,7,0,50,
20/03/2013,CHIH.,"CUAUHTÉMOC, CHIH.",1,0,1,0,0,0,
20/03/2013,TAMPS.,"VICTORIA, TAMPS.",0,0,0,20,0,28,
21/03/2013,DGO.,"DGO., DGO.",39,20,59,33,0,0,
21/03/2013,D.F.,"XOCHIMILCO, D.F.",35,9,44,0,0,498,
21/03/2013,MEX.,"ZUMPANGO, MEX.",18,4,22,2,16,59,
21/03/2013,MEX.,"CHICOLOAPAN, MEX.",16,5,21,0,0,0,
21/03/2013,MEX.,"TULTEPEC, MEX.",9,6,15,3,6,102,
21/03/2013,N.L.,"SABINAS HGO., N.L.",0,8,8,0,0,130,
21/03/2013,N.L.,"CADEREYTA JIMENEZ, N.L.",5,2,7,3,0,0,
21/03/2013,AGS.,"AGS., AGS.",4,2,6,6,0,277,
21/03/2013,CHIH.,"ASCENSIÓN, CHIH.",3,2,5,16,0,80,
21/03/2013,HGO.,"TIZAYUCA, HGO.",4,0,4,0,0,60,
21/03/2013,S.L.P.,"CIUDAD VALLES, S.L.P.",4,0,4,0,0,0,
21/03/2013,HGO.,"TEPEAPULCO, HGO.",2,0,2,0,0,0,
21/03/2013,S.L.P.,"SOLEDAD DE GRACIANO SANCHEZ, S.L.P.",2,0,2,0,0,0,
21/03/2013,HGO.,"IXMIQUILPAN, HGO.",1,0,1,0,2,0,
21/03/2013,VER.,"VER., VER.",1,0,1,0,0,63,
21/03/2013,TAMPS.,"VICTORIA, TAMPS.",1,0,1,0,0,200,
21/03/2013,Q. ROO,"COZUMEL, Q. ROO",0,0,0,0,0,25,
22/03/2013,DGO.,"DGO., DGO.",51,22,73,24,0,0,
22/03/2013,D.F.,"XOCHIMILCO, D.F.",35,9,44,0,1,587,
22/03/2013,MEX.,"CHICOLOAPAN, MEX.",21,3,24,0,2,0,
22/03/2013,MEX.,"TULTEPEC, MEX.",10,4,14,3,4,14,
22/03/2013,MEX.,"ZUMPANGO, MEX.",7,3,10,2,2,34,
22/03/2013,N.L.,"CADEREYTA JIMENEZ, N.L.",5,4,9,3,0,110,
22/03/2013,CHIH.,"CHIH., CHIH.",5,0,5,7,0,155,
22/03/2013,HGO.,"TIZAYUCA, HGO.",3,2,5,0,2,211,
22/03/2013,TAMPS.,"CIUDAD MADERO, TAMPS.",5,0,5,1,0,106,
22/03/2013,S.L.P.,"SOLEDAD DE GRACIANO SANCHEZ, S.L.P.",3,1,4,0,1,0,
22/03/2013,S.L.P.,"CIUDAD VALLES, S.L.P.",3,1,4,0,0,0,
22/03/2013,VER.,"VER., VER.",4,0,4,0,0,0,
22/03/2013,CHIH.,"ASCENSIÓN, CHIH.",1,2,3,0,0,0,
22/03/2013,CHIH.,"MANUEL BENAVIDES, CHIH.",0,2,2,0,0,0,
22/03/2013,CHIH.,"CUAUHTÉMOC, CHIH.",2,0,2,0,0,0,
22/03/2013,HGO.,"TEPEAPULCO, HGO.",2,0,2,0,0,0,
22/03/2013,CHIH.,"MADERA, CHIH.",1,0,1,0,0,0,
22/03/2013,VER.,"VER., VER.",0,1,1,0,0,0,
22/03/2013,HGO.,"IXMIQUILPAN, HGO.",1,0,1,0,0,0,
22/03/2013,TAMPS.,"TAMPICO, TAMPS.",1,0,1,0,2,507,
22/03/2013,TAMPS.,"REYNOSA, TAMPS.",0,1,1,0,0,0,
22/03/2013,Q. ROO,"SOLIDARIDAD, Q. ROO",0,0,0,0,0,12,
22/03/2013,TAMPS.,"VICTORIA, TAMPS.",0,0,0,1,0,37,
22/03/2013,TAMPS.,"ALTAMIRA, TAMPS.",0,0,0,1,0,62,
22/03/2013,Q. ROO,"COZUMEL, Q. ROO",0,0,0,0,0,51,
23/03/2013,MEX.,"CHICOLOAPAN, MEX.",12,5,17,0,2,0,
23/03/2013,HGO.,"TIZAYUCA, HGO.",7,2,9,0,0,70,
23/03/2013,N.L.,"VILLALDAMA, N.L.",3,3,6,0,0,80,
23/03/2013,TAMPS.,"CIUDAD MADERO, TAMPS.",6,0,6,0,0,623,
23/03/2013,S.L.P.,"CIUDAD VALLES, S.L.P.",3,2,5,3,0,0,
23/03/2013,S.L.P.,"SOLEDAD DE GRACIANO SANCHEZ, S.L.P.",2,2,4,0,0,45,
23/03/2013,HGO.,"TEPEAPULCO, HGO.",1,2,3,0,5,0,
23/03/2013,TAMPS.,"TAMPICO, TAMPS.",2,0,2,15,0,150,
23/03/2013,HGO.,"ACTOPAN, HGO.",1,0,1,0,0,0,
23/03/2013,HGO.,"IXMIQUILPAN, HGO.",1,0,1,0,0,0,
23/03/2013,N.L.,"SANTIAGO, N.L.",1,0,1,0,0,0,
23/03/2013,TAMPS.,"VICTORIA, TAMPS.",0,1,1,0,1,0,
24/03/2013,N.L.,"VILLALDAMA, N.L.",1,2,3,0,0,0,
24/03/2013,TAMPS.,"CIUDAD MADERO, TAMPS.",2,1,3,0,0,0,
24/03/2013,TAMPS.,"TAMPICO, TAMPS.",0,2,2,20,1,91,
24/03/2013,TAMPS.,"ALTAMIRA, TAMPS.",1,0,1,0,0,150,
25/03/2013,DGO.,"DGO., DGO.",48,8,56,43,7,0,
25/03/2013,D.F.,"XOCHIMILCO, D.F.",21,1,22,0,0,251,
25/03/2013,AGS.,"AGS., AGS.",6,4,10,1,0,84,
25/03/2013,S.L.P.,"CIUDAD VALLES, S.L.P.",3,2,5,1,2,0,
25/03/2013,CHIH.,"ASCENSIÓN, CHIH.",2,3,5,0,0,0,
25/03/2013,HGO.,"TEPEAPULCO, HGO.",0,2,2,0,3,0,
25/03/2013,HGO.,"TIZAYUCA, HGO.",1,1,2,0,0,93,
25/03/2013,CHIH.,"CUAUHTÉMOC, CHIH.",2,0,2,0,0,0,
25/03/2013,HGO.,"ACTOPAN, HGO.",1,0,1,0,0,0,
25/03/2013,S.L.P.,"SOLEDAD DE GRACIANO SANCHEZ, S.L.P.",1,0,1,0,0,0,
25/03/2013,N.L.,"SANTIAGO, N.L.",0,1,1,2,0,5177,
25/03/2013,CHIH.,"CHIH., CHIH.",0,0,0,0,0,231,
25/03/2013,TAMPS.,"VICTORIA, TAMPS.",0,0,0,0,1,0,
26/03/2013,DGO.,"DGO., DGO.",34,17,51,42,1,0,
26/03/2013,D.F.,"XOCHIMILCO, D.F.",15,2,17,0,0,53,
26/03/2013,AGS.,"AGS., AGS.",5,1,6,0,0,158,
26/03/2013,HGO.,"TEPEAPULCO, HGO.",2,2,4,0,0,0,
26/03/2013,S.L.P.,"CIUDAD VALLES, S.L.P.",3,1,4,0,1,0,
26/03/2013,TAMPS.,"VICTORIA, TAMPS.",4,0,4,0,0,50,
26/03/2013,HGO.,"TIZAYUCA, HGO.",3,0,3,0,0,91,
26/03/2013,VER.,"CARLOS A. CARRILLO, VER.",2,0,2,0,0,0,
26/03/2013,S.L.P.,"SOLEDAD DE GRACIANO SANCHEZ, S.L.P.",2,0,2,0,1,54,
26/03/2013,VER.,"VER., VER.",1,1,2,0,0,5,
26/03/2013,CHIH.,"CUAUHTÉMOC, CHIH.",2,0,2,0,0,0,
26/03/2013,HGO.,"ACTOPAN, HGO.",1,0,1,0,0,0,
26/03/2013,HGO.,"IXMIQUILPAN, HGO.",1,0,1,0,0,0,
26/03/2013,N.L.,"SANTIAGO, N.L.",0,0,0,9,0,6000,
27/03/2013,DGO.,"DGO., DGO.",34,22,56,18,6,0,
27/03/2013,HGO.,"TEPEAPULCO, HGO.",3,4,7,0,3,0,
27/03/2013,HGO.,"TIZAYUCA, HGO.",4,2,6,0,2,554,
27/03/2013,N.L.,"BUSTAMANTE, N.L.",4,1,5,0,0,350,
27/03/2013,AGS.,"AGS., AGS.",3,0,3,2,0,106,
27/03/2013,YUC.,"VALLADOLID, YUC.",1,2,3,0,0,0,
27/03/2013,CAMP.,"CARMEN, CAMP.",1,0,1,0,0,0,
27/03/2013,VER.,"VER., VER.",1,0,1,0,0,0,
27/03/2013,CHIH.,"CHIH., CHIH.",0,0,0,2,0,337,
28/03/2013,DGO.,"DGO., DGO.",41,19,60,48,1,0,
28/03/2013,CHIH.,"ASCENSIÓN, CHIH.",3,5,8,0,0,0,
28/03/2013,N.L.,"BUSTAMANTE, N.L.",2,1,3,0,0,5200,
28/03/2013,YUC.,"VALLADOLID, YUC.",2,0,2,0,0,171,
28/03/2013,N.L.,"SANTIAGO, N.L.",0,0,0,0,0,2817,
29/03/2013,DGO.,"DGO., DGO.",22,5,27,25,6,0,
29/03/2013,N.L.,"SANTIAGO, N.L.",3,3,6,0,0,2771,
29/03/2013,CHIH.,"ASCENSIÓN, CHIH.",3,3,6,0,0,0,
29/03/2013,N.L.,"BUSTAMANTE, N.L.",3,0,3,10,0,300,
29/03/2013,YUC.,"VALLADOLID, YUC.",2,0,2,0,0,0,
29/03/2013,Q. ROO,"BENITO JUAREZ, Q. ROO",1,0,1,0,0,0,
29/03/2013,VER.,"VER., VER.",0,0,0,0,0,29,
30/03/2013,N.L.,"CERRALVO, N.L.",2,1,3,3,0,0,
30/03/2013,N.L.,"ALLENDE, N.L.",0,2,2,0,0,0,
30/03/2013,Q. ROO,"OTHON P. BLANCO, Q. ROO",0,0,0,0,0,280,
31/03/2013,GRO.,"AJUCHITLAN DEL PROGRESO, GRO.",6,12,18,0,0,97,
31/03/2013,GRO.,"ACAPULCO DE JUAREZ, GRO.",2,1,3,0,10,0,
31/03/2013,Q. ROO,"OTHON P. BLANCO, Q. ROO",1,1,2,0,0,25,
31/03/2013,Q. ROO,"BENITO JUAREZ, Q. ROO",2,0,2,0,0,166,
31/03/2013,YUC.,"VALLADOLID, YUC.",1,0,1,0,0,106,
31/03/2013,S.L.P.,"SAN LUIS POTOSI, S.L.P.",1,0,1,0,0,0,
31/03/2013,N.L.,"ALLENDE, N.L.",0,1,1,0,0,1562,
31/03/2013,N.L.,"CERRALVO, N.L.",0,1,1,0,0,50,
01/04/2013,MEX.,"ACOLMAN, MEX.",21,4,25,4,4,34,
01/04/2013,MICH.,"MORELIA, MICH.",9,3,12,0,0,0,
01/04/2013,MEX.,"HUEHUETOCA, MEX.",10,2,12,0,0,0,
01/04/2013,MEX.,"ZINACANTEPEC, MEX.",8,3,11,0,0,24,
01/04/2013,MEX.,"VALLE DE BRAVO, MEX.",3,3,6,2,0,19,
01/04/2013,SIN.,"AHOME, SIN.",4,2,6,0,0,0,
01/04/2013,N.L.,"CERRALVO, N.L.",2,2,4,0,0,0,
01/04/2013,MEX.,"IXTLAHUACA, MEX.",3,0,3,2,0,77,
01/04/2013,MICH.,"SALVADOR ESCALANTE, MICH.",1,1,2,0,0,0,
01/04/2013,TAMPS.,"XICOTENCATL, TAMPS.",1,1,2,0,0,0,
01/04/2013,TAMPS.,"XICOTENCATL, TAMPS.",1,1,2,0,0,337,
01/04/2013,CHIH.,"CUAUHTÉMOC, CHIH.",0,1,1,0,0,0,
01/04/2013,N.L.,"ALLENDE, N.L.",1,0,1,0,0,44,
01/04/2013,Q. ROO,"OTHON P. BLANCO, Q. ROO",1,0,1,0,5,0,
01/04/2013,TAMPS.,"VICTORIA, TAMPS.",0,0,0,0,6,0,
01/04/2013,COL.,"MANZANILLO, COL.",0,0,0,0,1,0,
02/04/2013,MICH.,"MORELIA, MICH.",11,25,36,0,0,0,
02/04/2013,MEX.,"ACOLMAN, MEX.",31,3,34,5,1,113,
02/04/2013,MEX.,"ZINACANTEPEC, MEX.",18,3,21,0,0,100,
02/04/2013,MEX.,"HUEHUETOCA, MEX.",8,6,14,1,1,0,
02/04/2013,SIN.,"AHOME, SIN.",12,1,13,0,10,0,
02/04/2013,MEX.,"VALLE DE BRAVO, MEX.",8,2,10,0,0,2,
02/04/2013,MEX.,"IXTLAHUACA, MEX.",9,0,9,5,0,55,
02/04/2013,N.L.,"MELCHOR OCAMPO, N.L.",0,6,6,0,0,50,
02/04/2013,MICH.,"ZAMORA, MICH.",2,2,4,0,0,0,
02/04/2013,MICH.,"SALVADOR ESCALANTE, MICH.",2,2,4,0,0,0,
02/04/2013,MICH.,"LA HUACANA, MICH.",3,1,4,0,0,0,
02/04/2013,AGS.,"AGS., AGS.",1,0,1,0,0,15,
02/04/2013,CHIH.,"CUAUHTÉMOC, CHIH.",1,0,1,0,0,0,
02/04/2013,N.L.,"ALLENDE, N.L.",1,0,1,0,0,99,
03/04/2013,MICH.,"MORELIA, MICH.",26,7,33,0,1,0,
03/04/2013,SIN.,"AHOME, SIN.",19,10,29,0,0,0,
03/04/2013,MEX.,"ACOLMAN, MEX.",11,9,20,0,1,336,
03/04/2013,MEX.,"ZINACANTEPEC, MEX.",13,1,14,0,0,11,
03/04/2013,MEX.,"HUEHUETOCA, MEX.",10,1,11,0,0,0,
03/04/2013,MICH.,"ZAMORA, MICH.",10,1,11,0,0,0,
03/04/2013,MEX.,"IXTLAHUACA, MEX.",7,1,8,5,0,135,
03/04/2013,N.L.,"MELCHOR OCAMPO, N.L.",4,3,7,0,0,0,
03/04/2013,Q. ROO,"BENITO JUAREZ, Q. ROO",2,2,4,0,0,133,
03/04/2013,N.L.,"ALLENDE, N.L.",3,0,3,0,0,320,
03/04/2013,COL.,"COL., COL.",2,1,3,0,0,0,
03/04/2013,MICH.,"SALVADOR ESCALANTE, MICH.",2,1,3,0,1,0,
03/04/2013,VER.,"VER., VER.",0,1,1,0,0,0,
03/04/2013,VER.,"COATZACOALCOS, VER.",1,0,1,0,0,0,
03/04/2013,MEX.,"VALLE DE BRAVO, MEX.",1,0,1,0,2,0,
03/04/2013,S.L.P.,"SAN LUIS POTOSI, S.L.P.",0,1,1,0,0,0,
03/04/2013,Q. ROO,"OTHON P. BLANCO, Q. ROO",0,1,1,0,0,0,
03/04/2013,MICH.,"LA HUACANA, MICH.",0,1,1,0,0,0,
04/04/2013,MICH.,"MORELIA, MICH.",9,26,35,0,2,0,
04/04/2013,MEX.,"ZINACANTEPEC, MEX.",15,17,32,0,1,2459,
04/04/2013,SIN.,"AHOME, SIN.",18,4,22,0,7,1,
04/04/2013,MEX.,"HUEHUETOCA, MEX.",14,7,21,7,1,3,
04/04/2013,MEX.,"ACOLMAN, MEX.",18,3,21,3,1,69,
04/04/2013,MICH.,"ZAMORA, MICH.",4,5,9,0,0,0,
04/04/2013,MICH.,"SALVADOR ESCALANTE, MICH.",4,1,5,0,0,0,
04/04/2013,MEX.,"VALLE DE BRAVO, MEX.",5,0,5,1,0,0,
04/04/2013,MEX.,"IXTLAHUACA, MEX.",1,3,4,1,0,92,
04/04/2013,N.L.,"LOS ALDAMAS, N.L.",0,3,3,3,0,0,
04/04/2013,Q. ROO,"BENITO JUAREZ, Q. ROO",1,2,3,0,0,219,
04/04/2013,COL.,"COL., COL.",2,0,2,0,0,24,
04/04/2013,MICH.,"LA HUACANA, MICH.",2,0,2,0,0,0,
04/04/2013,TAMPS.,"VICTORIA, TAMPS.",1,0,1,0,2,0,
04/04/2013,N.L.,"MONTEMOR., N.L.",1,0,1,0,0,0,
04/04/2013,Q. ROO,"OTHON P. BLANCO, Q. ROO",0,1,1,0,0,0,
04/04/2013,CHIH.,"JANOS, CHIH.",0,1,1,0,0,0,
04/04/2013,VER.,"VER., VER.",0,1,1,0,0,0,
05/04/2013,MICH.,"ZAMORA, MICH.",24,12,36,0,0,0,
05/04/2013,SIN.,"AHOME, SIN.",19,4,23,0,2,0,
05/04/2013,MEX.,"HUEHUETOCA, MEX.",17,4,21,3,0,210,
05/04/2013,MEX.,"HUEHUETOCA, MEX.",21,0,21,2,0,413,
05/04/2013,MICH.,"MORELIA, MICH.",11,5,16,0,0,0,
05/04/2013,MEX.,"ACOLMAN, MEX.",11,5,16,2,6,69,
05/04/2013,MICH.,"SALVADOR ESCALANTE, MICH.",6,3,9,0,0,0,
05/04/2013,MEX.,"ACOLMAN, MEX.",6,3,9,0,0,254,
05/04/2013,MEX.,"IXTLAHUACA, MEX.",6,0,6,4,0,15,
05/04/2013,MEX.,"ZINACANTEPEC, MEX.",6,0,6,0,0,23,
05/04/2013,MEX.,"VALLE DE BRAVO, MEX.",3,3,6,0,5,1,
05/04/2013,COL.,"COL., COL.",4,0,4,0,0,150,
05/04/2013,Q. ROO,"OTHON P. BLANCO, Q. ROO",3,1,4,0,0,39,
05/04/2013,AGS.,"COSÍO, AGS.",2,1,3,0,0,0,
05/04/2013,TAMPS.,"CIUDAD MADERO, TAMPS.",2,1,3,0,1,0,
05/04/2013,MICH.,"LA HUACANA, MICH.",1,1,2,0,0,0,
05/04/2013,S.L.P.,"SOLEDAD DE GRACIANO SANCHEZ, S.L.P.",1,0,1,0,0,0,
05/04/2013,Q. ROO,"BENITO JUAREZ, Q. ROO",0,0,0,0,0,66,
06/04/2013,MICH.,"MORELIA, MICH.",25,12,37,0,2,0,
06/04/2013,N.L.,"LOS ALDAMAS, N.L.",5,20,25,41,0,150,
06/04/2013,COAH.,"ACUÑA, COAH.",6,18,24,7,0,326,
06/04/2013,MICH.,"ZAMORA, MICH.",13,4,17,0,2,0,
06/04/2013,MEX.,"IXTLAHUACA, MEX.",13,2,15,3,0,12,
06/04/2013,MEX.,"ZINACANTEPEC, MEX.",5,2,7,0,1,0,
06/04/2013,MICH.,"SALVADOR ESCALANTE, MICH.",4,3,7,0,0,0,
06/04/2013,N.L.,"MONTEMOR., N.L.",4,1,5,2,0,350,
06/04/2013,MEX.,"VALLE DE BRAVO, MEX.",3,1,4,0,0,0,
06/04/2013,JAL.,"CABO CORRIENTES, JAL.",2,0,2,0,0,0,
06/04/2013,TAMPS.,"GONZALEZ, TAMPS.",2,0,2,1,0,12,
06/04/2013,COL.,"COL., COL.",2,0,2,0,0,26,
06/04/2013,B.C.,"TIJUANA, B.C.",1,1,2,0,3,0,
06/04/2013,Q. ROO,"BENITO JUAREZ, Q. ROO",2,0,2,0,0,273,
06/04/2013,COAH.,"MONCLOVA, COAH.",1,1,2,0,2,62,
06/04/2013,TAMPS.,"CIUDAD MADERO, TAMPS.",1,0,1,0,0,37,
06/04/2013,MICH.,"LA HUACANA, MICH.",1,0,1,0,0,0,
06/04/2013,Q. ROO,"OTHON P. BLANCO, Q. ROO",0,0,0,0,6,25,
07/04/2013,MICH.,"MORELIA, MICH.",8,5,13,0,0,0,
07/04/2013,MEX.,"ZINACANTEPEC, MEX.",6,5,11,0,0,198,
07/04/2013,MICH.,"ZAMORA, MICH.",6,2,8,0,0,0,
07/04/2013,MEX.,"IXTLAHUACA, MEX.",6,1,7,0,0,0,
07/04/2013,MEX.,"VALLE DE BRAVO, MEX.",3,3,6,0,0,0,
07/04/2013,MICH.,"SALVADOR ESCALANTE, MICH.",3,0,3,0,0,0,
07/04/2013,TAMPS.,"GONZALEZ, TAMPS.",1,0,1,0,0,20,
08/04/2013,D.F.,"AZCAPOTZALCO, D.F.",43,16,59,0,1,260,
08/04/2013,OAX.,"SANTA MARIA ATZOMPA, OAX.",13,10,23,0,0,180,
08/04/2013,SIN.,"AHOME, SIN.",14,4,18,0,3,0,
08/04/2013,MEX.,"TEOTIHUACAN, MEX.",11,4,15,2,7,401,
08/04/2013,MEX.,"TEJUPILCO, MEX.",8,3,11,3,0,0,
08/04/2013,MICH.,"MORELIA, MICH.",7,2,9,2,1,0,
08/04/2013,MEX.,"ATLACOMULCO, MEX.",5,3,8,0,1,0,
08/04/2013,OAX.,"SANTA MARIA ATZOMPA, OAX.",4,2,6,0,0,29,
08/04/2013,N.L.,"MONTEMOR., N.L.",4,1,5,5,0,200,
08/04/2013,B.C.,"TIJUANA, B.C.",4,1,5,0,0,0,
08/04/2013,B.C.,"TIJUANA, B.C.",4,1,5,0,0,0,
08/04/2013,OAX.,"SAN JUAN BAUTISTA TUXTEPEC, OAX.",3,2,5,0,0,0,
08/04/2013,OAX.,"SANTIAGO PINOTEPA NACIONAL, OAX.",0,4,4,0,0,0,
08/04/2013,AGS.,"COSÍO, AGS.",4,0,4,0,0,0,
08/04/2013,MEX.,"ALMOLOYA DE JUAREZ, MEX.",3,1,4,1,0,95,
08/04/2013,MEX.,"MALINALCO, MEX.",4,0,4,1,0,0,
08/04/2013,N.L.,"LOS HERRERAS, N.L.",1,1,2,2,0,750,
08/04/2013,MICH.,"SALVADOR ESCALANTE, MICH.",1,1,2,1,0,0,
08/04/2013,MEX.,"IXTAPAN DE LA SAL, MEX.",0,2,2,0,0,0,
08/04/2013,VER.,"COATEPEC, VER.",1,0,1,0,0,0,
08/04/2013,HGO.,"TIZAYUCA, HGO.",1,0,1,0,0,220,
08/04/2013,Q. ROO,"OTHON P. BLANCO, Q. ROO",0,1,1,0,0,0,
08/04/2013,OAX.,"SANTIAGO TEXTITLAN, OAX.",0,1,1,0,0,0,
08/04/2013,MICH.,"LA HUACANA, MICH.",0,1,1,0,0,0,
09/04/2013,D.F.,"AZCAPOTZALCO, D.F.",45,17,62,0,3,270,
09/04/2013,OAX.,"SAN JUAN BAUTISTA TUXTEPEC, OAX.",16,7,23,5,0,0,
09/04/2013,MEX.,"TEOTIHUACAN, MEX.",18,0,18,0,0,306,
09/04/2013,MICH.,"MORELIA, MICH.",14,3,17,0,0,0,
09/04/2013,N.L.,"LOS HERRERAS, N.L.",0,16,16,21,0,250,
09/04/2013,SIN.,"AHOME, SIN.",9,6,15,0,5,0,
09/04/2013,MEX.,"TEJUPILCO, MEX.",12,1,13,10,0,0,
09/04/2013,MEX.,"ATLACOMULCO, MEX.",12,0,12,0,0,9,
09/04/2013,MICH.,"ZAMORA, MICH.",7,4,11,0,0,0,
09/04/2013,MICH.,"SALVADOR ESCALANTE, MICH.",7,3,10,3,0,0,
09/04/2013,MEX.,"ALMOLOYA DE JUAREZ, MEX.",4,4,8,1,0,0,
09/04/2013,OAX.,"JUCHITAN DE ZARAGOZA, OAX.",5,0,5,2,0,0,
09/04/2013,MEX.,"MALINALCO, MEX.",1,3,4,2,0,0,
09/04/2013,OAX.,"SANTA MARIA ATZOMPA, OAX.",2,1,3,1,1,0,
09/04/2013,NAY.,"TEPIC, NAY.",1,1,2,0,0,0,
09/04/2013,MEX.,"IXTAPAN DE LA SAL, MEX.",2,0,2,1,0,6,
09/04/2013,OAX.,"SANTIAGO PINOTEPA NACIONAL, OAX.",2,0,2,0,0,0,
09/04/2013,CHIH.,"CUAUHTÉMOC, CHIH.",2,0,2,0,0,0,
09/04/2013,N.L.,"MONTEMOR., N.L.",1,0,1,0,0,50,
09/04/2013,AGS.,"COSÍO, AGS.",1,0,1,0,0,0,
09/04/2013,MICH.,"LA HUACANA, MICH.",0,1,1,0,0,0,
10/04/2013,D.F.,"AZCAPOTZALCO, D.F.",74,14,88,0,1,300,
10/04/2013,MICH.,"MORELIA, MICH.",3,16,19,0,0,0,
10/04/2013,MICH.,"ZAMORA, MICH.",6,11,17,0,0,0,
10/04/2013,SIN.,"AHOME, SIN.",11,4,15,0,5,0,
10/04/2013,MEX.,"TEOTIHUACAN, MEX.",10,3,13,3,2,136,
10/04/2013,N.L.,"LOS HERRERAS, N.L.",2,9,11,10,0,50,
10/04/2013,NAY.,"TEPIC, NAY.",4,1,5,0,0,0,
10/04/2013,MEX.,"IXTAPAN DE LA SAL, MEX.",2,3,5,0,0,0,
10/04/2013,B.C.,"TIJUANA, B.C.",2,1,3,0,0,0,
10/04/2013,MICH.,"SALVADOR ESCALANTE, MICH.",0,2,2,0,0,0,
10/04/2013,N.L.,"GALEANA, N.L.",0,2,2,0,0,0,
10/04/2013,TAMPS.,"VICTORIA, TAMPS.",2,0,2,0,2,0,
10/04/2013,HGO.,"TIZAYUCA, HGO.",1,0,1,0,0,0,
10/04/2013,AGS.,"COSÍO, AGS.",0,1,1,0,0,0,
10/04/2013,Q. ROO,"OTHON P. BLANCO, Q. ROO",0,0,0,0,5,0,
10/04/2013,VER.,"COATEPEC, VER.",0,0,0,0,0,28,
10/04/2013,MEX.,"TEJUPILCO, MEX.",0,0,0,4,0,0,
10/04/2013,MEX.,"MALINALCO, MEX.",0,0,0,0,0,0,
10/04/2013,MEX.,"TEJUPILCO, MEX.",0,0,0,0,0,0,
11/04/2013,D.F.,"AZCAPOTZALCO, D.F.",47,14,61,0,0,350,
11/04/2013,SIN.,"AHOME, SIN.",14,11,25,0,8,0,
11/04/2013,MICH.,"MORELIA, MICH.",14,5,19,0,2,0,
11/04/2013,MEX.,"TEJUPILCO, MEX.",11,5,16,6,0,90,
11/04/2013,MEX.,"ATLACOMULCO, MEX.",13,2,15,0,0,0,
11/04/2013,B.C.,"MEXICALI, B.C.",7,7,14,0,0,0,
11/04/2013,MEX.,"TEOTIHUACAN, MEX.",6,5,11,3,2,183,
11/04/2013,MEX.,"TEOTIHUACAN, MEX.",6,5,11,3,2,183,
11/04/2013,OAX.,"CIUDAD IXTEPEC, OAX.",4,6,10,0,0,0,
11/04/2013,MEX.,"IXTAPAN DE LA SAL, MEX.",5,1,6,0,0,2,
11/04/2013,MEX.,"MALINALCO, MEX.",5,1,6,1,0,2,
11/04/2013,MICH.,"SALVADOR ESCALANTE, MICH.",5,1,6,0,0,0,
11/04/2013,N.L.,"GALEANA, N.L.",2,3,5,4,0,0,
11/04/2013,OAX.,"SAN MIGUEL SOYALTEPEC, OAX.",5,0,5,1,0,0,
11/04/2013,NAY.,"TEPIC, NAY.",3,1,4,1,0,0,
11/04/2013,B.C.,"TIJUANA, B.C.",3,1,4,0,0,0,
11/04/2013,MEX.,"ALMOLOYA DE JUAREZ, MEX.",2,1,3,0,0,0,
11/04/2013,HGO.,"TIZAYUCA, HGO.",3,0,3,0,0,0,
11/04/2013,OAX.,"SANTIAGO JAMILTEPEC, OAX.",1,2,3,0,0,0,
11/04/2013,OAX.,"SANTIAGO JAMILTEPEC, OAX.",1,2,3,0,0,0,
11/04/2013,N.L.,"MINA, N.L.",1,1,2,6,0,150,
11/04/2013,OAX.,"SAN AGUSTIN ETLA, OAX.",0,2,2,0,0,520,
11/04/2013,VER.,"COATEPEC, VER.",1,0,1,0,0,62,
11/04/2013,AGS.,"COSÍO, AGS.",0,0,0,0,0,6,
11/04/2013,Q. ROO,"BENITO JUAREZ, Q. ROO",0,0,0,0,0,109,
11/04/2013,Q. ROO,"OTHON P. BLANCO, Q. ROO",0,0,0,0,0,32,
11/04/2013,Q. ROO,"BENITO JUAREZ, Q. ROO",0,0,0,0,0,81,
12/04/2013,D.F.,"AZCAPOTZALCO, D.F.",52,15,67,0,4,4300,
12/04/2013,SIN.,"AHOME, SIN.",29,9,38,0,12,0,
12/04/2013,MICH.,"ZAMORA, MICH.",23,9,32,0,0,0,
12/04/2013,MICH.,"MORELIA, MICH.",18,4,22,0,0,0,
12/04/2013,MEX.,"TEJUPILCO, MEX.",16,4,20,13,0,0,
12/04/2013,QRO.,"QUERETARO, QRO.",8,4,12,0,0,0,
12/04/2013,MEX.,"ATLACOMULCO, MEX.",8,4,12,0,0,0,
12/04/2013,MEX.,"MALINALCO, MEX.",5,6,11,2,0,0,
12/04/2013,MICH.,"SALVADOR ESCALANTE, MICH.",9,1,10,0,0,0,
12/04/2013,MEX.,"ALMOLOYA DE JUAREZ, MEX.",7,2,9,6,0,0,
12/04/2013,OAX.,"CIUDAD IXTEPEC, OAX.",6,1,7,0,0,0,
12/04/2013,MEX.,"TEOTIHUACAN, MEX.",5,1,6,1,0,154,
12/04/2013,NAY.,"TEPIC, NAY.",5,1,6,1,0,0,
12/04/2013,QRO.,"AMEALCO DE BONFIL, QRO.",0,4,4,0,0,0,
12/04/2013,N.L.,"MINA, N.L.",2,1,3,1,0,300,
12/04/2013,MEX.,"IXTAPAN DE LA SAL, MEX.",3,0,3,2,0,0,
12/04/2013,CHIH.,"JANOS, CHIH.",1,1,2,0,0,0,
12/04/2013,NAY.,"ACAPONETA, NAY.",0,2,2,0,0,0,
12/04/2013,HGO.,"TIZAYUCA, HGO.",2,0,2,0,0,110,
12/04/2013,MICH.,"LA HUACANA, MICH.",2,0,2,0,0,0,
12/04/2013,N.L.,"GALEANA, N.L.",1,0,1,0,0,0,
12/04/2013,VER.,"COATEPEC, VER.",1,0,1,0,0,35,
12/04/2013,AGS.,"COSÍO, AGS.",1,0,1,0,0,120,
12/04/2013,COL.,"COL., COL.",1,0,1,0,0,0,
13/04/2013,MICH.,"MORELIA, MICH.",27,7,34,0,2,0,
13/04/2013,QRO.,"QUERETARO, QRO.",12,18,30,0,2,0,
13/04/2013,MEX.,"TEOTIHUACAN, MEX.",12,10,22,1,2,260,
13/04/2013,MEX.,"TEJUPILCO, MEX.",13,4,17,3,0,0,
13/04/2013,QRO.,"AMEALCO DE BONFIL, QRO.",5,12,17,0,0,0,
13/04/2013,MEX.,"ATLACOMULCO, MEX.",12,3,15,0,0,0,
13/04/2013,QRO.,"QUERETARO, QRO.",9,4,13,0,2,0,
13/04/2013,B.C.,"MEXICALI, B.C.",2,7,9,0,0,0,
13/04/2013,QRO.,"AMEALCO DE BONFIL, QRO.",5,2,7,0,0,0,
13/04/2013,MEX.,"MALINALCO, MEX.",4,3,7,0,0,0,
13/04/2013,CHIS.,"OCOSINGO, CHIS.",3,3,6,0,0,0,
13/04/2013,N.L.,"MINA, N.L.",3,3,6,1,0,650,
13/04/2013,MICH.,"ZAMORA, MICH.",5,1,6,0,0,0,
13/04/2013,MEX.,"ALMOLOYA DE JUAREZ, MEX.",3,1,4,0,0,0,
13/04/2013,MEX.,"IXTAPAN DE LA SAL, MEX.",3,1,4,1,0,0,
13/04/2013,HGO.,"TIZAYUCA, HGO.",3,1,4,0,0,829,
13/04/2013,B.C.,"TIJUANA, B.C.",1,3,4,0,0,0,
13/04/2013,COL.,"COL., COL.",3,0,3,0,0,94,
13/04/2013,JAL.,"CABO CORRIENTES, JAL.",1,2,3,0,0,0,
13/04/2013,OAX.,"PINOTEPA DE DON LUIS, OAX.",2,0,2,0,0,0,
13/04/2013,MICH.,"SALVADOR ESCALANTE, MICH.",2,0,2,0,0,0,
13/04/2013,MICH.,"LA HUACANA, MICH.",2,0,2,0,0,0,
13/04/2013,N.L.,"GALEANA, N.L.",1,0,1,0,0,0,
13/04/2013,OAX.,"CIUDAD IXTEPEC, OAX.",1,0,1,0,0,0,
13/04/2013,TAMPS.,"CIUDAD MADERO, TAMPS.",1,0,1,0,1,0,
13/04/2013,Q. ROO,"BENITO JUAREZ, Q. ROO",1,0,1,1,0,140,
13/04/2013,TAMPS.,"VICTORIA, TAMPS.",1,0,1,0,0,0,
13/04/2013,Q. ROO,"OTHON P. BLANCO, Q. ROO",0,0,0,0,0,28,
13/04/2013,Q. ROO,"BENITO JUAREZ, Q. ROO",0,0,0,0,0,311,
14/04/2013,QRO.,"QUERETARO, QRO.",20,8,28,0,2,0,
14/04/2013,MEX.,"TEJUPILCO, MEX.",15,6,21,7,0,14,
14/04/2013,MICH.,"ZAMORA, MICH.",12,1,13,0,0,0,
14/04/2013,MICH.,"MORELIA, MICH.",5,5,10,0,0,0,
14/04/2013,MEX.,"ATLACOMULCO, MEX.",7,1,8,1,0,0,
14/04/2013,MICH.,"SALVADOR ESCALANTE, MICH.",4,3,7,0,1,0,
14/04/2013,MEX.,"TEOTIHUACAN, MEX.",6,1,7,0,4,0,
14/04/2013,MEX.,"IXTAPAN DE LA SAL, MEX.",6,1,7,1,0,341,
14/04/2013,OAX.,"SAN PEDRO IXCATLAN, OAX.",1,4,5,1,0,0,
14/04/2013,MEX.,"ALMOLOYA DE JUAREZ, MEX.",3,2,5,3,0,219,
14/04/2013,MEX.,"MALINALCO, MEX.",4,0,4,2,0,1,
14/04/2013,OAX.,"MATIAS ROMERO AVENDAÑO, OAX.",1,1,2,0,0,0,
14/04/2013,N.L.,"GALEANA, N.L.",2,0,2,0,0,0,
14/04/2013,TAMPS.,"TAMPICO, TAMPS.",2,0,2,2,0,20,
14/04/2013,TAMPS.,"GONZALEZ, TAMPS.",1,1,2,1,0,189,
14/04/2013,N.L.,"HGO., N.L.",0,1,1,6,0,100,
14/04/2013,MICH.,"LA HUACANA, MICH.",0,1,1,0,0,0,
14/04/2013,VER.,"ACULA, VER.",0,0,0,0,1,0,
14/04/2013,VER.,"COATEPEC, VER.",0,0,0,0,0,25,
14/04/2013,TAMPS.,"CIUDAD MADERO, TAMPS.",0,0,0,0,0,37,
14/04/2013,TAMPS.,"ALTAMIRA, TAMPS.",0,0,0,0,0,86,
15/04/2013,QRO.,"QUERETARO, QRO.",186,130,316,0,0,0,
15/04/2013,D.F.,"LA MAGDALENA CONTRERAS, D.F.",21,10,31,0,1,150,
15/04/2013,MICH.,"APATZINGAN, MICH.",9,3,12,0,0,0,
15/04/2013,MEX.,"AMECAMECA, MEX.",7,3,10,0,8,0,
15/04/2013,MICH.,"MARAVATIO, MICH.",3,5,8,0,0,0,
15/04/2013,NAY.,"TEPIC, NAY.",3,4,7,0,0,0,
15/04/2013,SIN.,"GUASAVE, SIN.",3,4,7,0,1,0,
15/04/2013,B.C.,"TECATE, B.C.",2,5,7,0,0,0,
15/04/2013,MEX.,"ATIZAPAN, MEX.",1,5,6,0,0,159,
15/04/2013,MEX.,"TENANGO DEL VALLE, MEX.",5,1,6,0,0,0,
15/04/2013,N.L.,"HGO., N.L.",2,3,5,0,0,100,
15/04/2013,S.L.P.,"MATEHUALA, S.L.P.",1,2,3,0,0,0,
15/04/2013,OAX.,"MATIAS ROMERO AVENDAÑO, OAX.",2,1,3,11,0,0,
15/04/2013,MICH.,"LA PIEDAD, MICH.",2,1,3,0,0,0,
15/04/2013,MICH.,"TACAMBARO, MICH.",1,2,3,0,0,0,
15/04/2013,CAMP.,"CALAKMUL, CAMP.",0,3,3,0,0,0,
15/04/2013,HGO.,"HUAUTLA, HGO.",1,0,1,0,0,0,
15/04/2013,NAY.,"ACAPONETA, NAY.",0,1,1,0,0,0,
15/04/2013,CHIH.,"DELICIAS, CHIH.",1,0,1,0,0,0,
15/04/2013,Q. ROO,"OTHON P. BLANCO, Q. ROO",0,0,0,0,0,117,
16/04/2013,QRO.,"QUERETARO, QRO.",27,8,35,0,0,0,
16/04/2013,D.F.,"LA MAGDALENA CONTRERAS, D.F.",20,7,27,0,1,126,
16/04/2013,MEX.,"TENANGO DEL VALLE, MEX.",19,3,22,1,0,0,
16/04/2013,OAX.,"SANTA CRUZ XOXOCOTLAN, OAX.",10,7,17,0,0,0,
16/04/2013,MEX.,"AMECAMECA, MEX.",9,2,11,3,0,105,
16/04/2013,MICH.,"APATZINGAN, MICH.",9,2,11,0,0,0,
16/04/2013,QRO.,"TEQUISQUIAPAN, QRO.",6,3,9,0,0,0,
16/04/2013,MICH.,"MARAVATIO, MICH.",6,3,9,0,0,0,
16/04/2013,MICH.,"LA PIEDAD, MICH.",5,4,9,0,0,0,
16/04/2013,MEX.,"ATIZAPAN, MEX.",7,1,8,3,0,95,
16/04/2013,OAX.,"SAN JUAN BAUTISTA TLACOATZINTEPEC, OAX.",4,2,6,0,0,0,
16/04/2013,N.L.,"ARAMBERRI, N.L.",2,3,5,2,0,0,
16/04/2013,TAMPS.,"VICTORIA, TAMPS.",5,0,5,0,0,0,
16/04/2013,NAY.,"TEPIC, NAY.",0,3,3,0,0,0,
16/04/2013,NAY.,"ACAPONETA, NAY.",0,3,3,0,0,0,
16/04/2013,MICH.,"TACAMBARO, MICH.",3,0,3,0,0,0,
16/04/2013,S.L.P.,"MATEHUALA, S.L.P.",2,0,2,0,0,0,
16/04/2013,HGO.,"HUAUTLA, HGO.",1,0,1,0,0,0,
16/04/2013,CHIH.,"CUAUHTÉMOC, CHIH.",1,0,1,0,0,0,
16/04/2013,N.L.,"HGO., N.L.",0,1,1,0,0,0,
16/04/2013,OAX.,"SAN JUAN BAUTISTA LO DE SOTO, OAX.",1,0,1,0,0,0,
17/04/2013,QRO.,"QUERETARO, QRO.",19,5,24,0,1,0,
17/04/2013,D.F.,"LA MAGDALENA CONTRERAS, D.F.",18,4,22,0,1,40,
17/04/2013,MICH.,"LA PIEDAD, MICH.",12,8,20,0,0,0,
17/04/2013,MEX.,"AMECAMECA, MEX.",15,2,17,5,3,0,
17/04/2013,MEX.,"TENANGO DEL VALLE, MEX.",9,2,11,2,0,0,
17/04/2013,QRO.,"COLON, QRO.",6,1,7,0,0,0,
17/04/2013,SIN.,"GUASAVE, SIN.",4,3,7,0,8,0,
17/04/2013,MEX.,"ATIZAPAN, MEX.",2,4,6,0,1,0,
17/04/2013,TAMPS.,"BURGOS, TAMPS.",1,3,4,0,0,0,
17/04/2013,MICH.,"APATZINGAN, MICH.",3,1,4,0,0,0,
17/04/2013,S.L.P.,"MATEHUALA, S.L.P.",2,1,3,0,0,0,
17/04/2013,MICH.,"MARAVATIO, MICH.",1,2,3,0,0,0,
17/04/2013,TAMPS.,"MATAMOROS, TAMPS.",0,3,3,0,0,0,
17/04/2013,MICH.,"TACAMBARO, MICH.",0,2,2,0,0,0,
17/04/2013,S.L.P.,"RIOVERDE, S.L.P.",1,0,1,0,0,0,
17/04/2013,B.C.,"ENSENADA, B.C.",0,1,1,0,0,0,
17/04/2013,N.L.,"HGO., N.L.",1,0,1,4,0,200,
17/04/2013,TAMPS.,"VICTORIA, TAMPS.",0,0,0,0,0,150,
18/04/2013,D.F.,"LA MAGDALENA CONTRERAS, D.F.",18,11,29,0,8,100,
18/04/2013,QRO.,"QUERETARO, QRO.",13,5,18,0,3,0,
18/04/2013,MEX.,"AMECAMECA, MEX.",12,2,14,0,10,0,
18/04/2013,MICH.,"LA PIEDAD, MICH.",10,0,10,0,0,0,
18/04/2013,MEX.,"TENANGO DEL VALLE, MEX.",6,2,8,1,0,25,
18/04/2013,OAX.,"TRINIDAD ZAACHILA, OAX.",3,5,8,1,0,0,
18/04/2013,B.C.,"TIJUANA, B.C.",3,3,6,0,0,0,
18/04/2013,SIN.,"GUASAVE, SIN.",3,3,6,0,5,0,
18/04/2013,QRO.,"COLON, QRO.",6,0,6,0,0,0,
18/04/2013,MICH.,"TACAMBARO, MICH.",2,2,4,0,0,0,
18/04/2013,S.L.P.,"MATEHUALA, S.L.P.",3,1,4,0,0,0,
18/04/2013,TAMPS.,"MATAMOROS, TAMPS.",3,1,4,0,0,0,
18/04/2013,B.C.,"TIJUANA, B.C.",3,1,4,0,0,0,
18/04/2013,MEX.,"ATIZAPAN, MEX.",1,2,3,1,0,0,
18/04/2013,OAX.,"SAN LUCAS OJITLAN, OAX.",0,3,3,0,0,0,
18/04/2013,NAY.,"TEPIC, NAY.",3,0,3,0,0,0,
18/04/2013,VER.,"MEDELLIN, VER.",2,0,2,0,0,9,
18/04/2013,NAY.,"ACAPONETA, NAY.",1,1,2,0,0,0,
18/04/2013,S.L.P.,"RIOVERDE, S.L.P.",2,0,2,0,0,0,
18/04/2013,TAMPS.,"REYNOSA, TAMPS.",1,1,2,0,0,0,
18/04/2013,VER.,"COATZACOALCOS, VER.",1,0,1,0,0,0,
18/04/2013,AGS.,"SAN FRANCISCO DE LOS ROMO, AGS.",1,0,1,0,0,110,
18/04/2013,CAMP.,"CARMEN, CAMP.",1,0,1,0,0,0,
18/04/2013,N.L.,"ARAMBERRI, N.L.",0,1,1,5,0,0,
19/04/2013,D.F.,"LA MAGDALENA CONTRERAS, D.F.",29,15,44,0,2,700,
19/04/2013,MEX.,"TENANGO DEL VALLE, MEX.",12,13,25,1,1,0,
19/04/2013,QRO.,"QUERETARO, QRO.",18,5,23,0,3,0,
19/04/2013,SIN.,"GUASAVE, SIN.",12,6,18,0,1,0,
19/04/2013,MEX.,"AMECAMECA, MEX.",12,4,16,0,7,0,
19/04/2013,QRO.,"EZEQUIEL MONTES, QRO.",3,4,7,0,2,0,
19/04/2013,MEX.,"ATIZAPAN, MEX.",6,0,6,2,0,196,
19/04/2013,TAMPS.,"MATAMOROS, TAMPS.",2,4,6,0,0,0,
19/04/2013,B.C.,"TIJUANA, B.C.",3,2,5,0,0,0,
19/04/2013,S.L.P.,"MATEHUALA, S.L.P.",3,1,4,0,0,0,
19/04/2013,NAY.,"ACAPONETA, NAY.",2,2,4,0,0,0,
19/04/2013,MICH.,"MARAVATIO, MICH.",4,0,4,0,0,0,
19/04/2013,MICH.,"LA PIEDAD, MICH.",4,0,4,0,0,0,
19/04/2013,AGS.,"SAN FRANCISCO DE LOS ROMO, AGS.",2,1,3,1,0,110,
19/04/2013,OAX.,"ZIMATLAN DE ALVAREZ, OAX.",2,1,3,0,0,0,
19/04/2013,N.L.,"ARAMBERRI, N.L.",2,1,3,1,0,250,
19/04/2013,CHIH.,"NUEVO CASAS GRANDES, CHIH.",2,1,3,0,0,0,
19/04/2013,MICH.,"TACAMBARO, MICH.",1,2,3,0,0,0,
19/04/2013,OAX.,"JUCHITAN DE ZARAGOZA, OAX.",2,0,2,16,0,0,
19/04/2013,TAMPS.,"CIUDAD MADERO, TAMPS.",2,0,2,0,0,179,
19/04/2013,TAMPS.,"NUEVO LAREDO, TAMPS.",0,1,1,0,1,0,
19/04/2013,TAMPS.,"REYNOSA, TAMPS.",0,1,1,0,0,0,
19/04/2013,TAMPS.,"BURGOS, TAMPS.",1,0,1,0,0,0,
20/04/2013,MEX.,"AMECAMECA, MEX.",19,2,21,0,0,0,
20/04/2013,MEX.,"TENANGO DEL VALLE, MEX.",15,3,18,3,0,69,
20/04/2013,QRO.,"SAN JUAN DEL RIO, QRO.",8,5,13,0,2,0,
20/04/2013,QRO.,"EZEQUIEL MONTES, QRO.",8,3,11,0,1,0,
20/04/2013,NAY.,"ACAPONETA, NAY.",5,0,5,0,0,0,
20/04/2013,JAL.,"CABO CORRIENTES, JAL.",0,4,4,0,0,0,
20/04/2013,MICH.,"LA PIEDAD, MICH.",4,0,4,0,0,0,
20/04/2013,S.L.P.,"MATEHUALA, S.L.P.",3,0,3,0,0,0,
20/04/2013,HGO.,"HUAUTLA, HGO.",2,1,3,0,0,0,
20/04/2013,MEX.,"ATIZAPAN, MEX.",3,0,3,1,0,0,
20/04/2013,CHIS.,"SALTO DE AGUA, CHIS.",2,1,3,0,0,0,
20/04/2013,TAMPS.,"REYNOSA, TAMPS.",0,3,3,0,0,0,
20/04/2013,OAX.,"SANTIAGO NILTEPEC, OAX.",1,1,2,0,0,0,
20/04/2013,OAX.,"SAN MIGUEL EL GRANDE, OAX.",0,2,2,0,0,0,
20/04/2013,TAMPS.,"GONZALEZ, TAMPS.",1,1,2,2,0,0,
20/04/2013,N.L.,"CARMEN, N.L.",1,1,2,1,0,100,
20/04/2013,NAY.,"TEPIC, NAY.",1,0,1,0,2,0,
20/04/2013,OAX.,"OCOTLAN DE MOR., OAX.",1,0,1,0,0,0,
20/04/2013,MICH.,"MARAVATIO, MICH.",1,0,1,0,0,0,
20/04/2013,VER.,"MEDELLIN, VER.",0,0,0,0,0,40,
20/04/2013,TAMPS.,"TAMPICO, TAMPS.",0,0,0,12,0,500,
20/04/2013,TAMPS.,"CIUDAD MADERO, TAMPS.",0,0,0,0,1,65,
20/04/2013,TAMPS.,"VICTORIA, TAMPS.",0,0,0,0,1,0,
20/04/2013,VER.,"MEDELLIN, VER.",0,0,0,0,0,40,
21/04/2013,N.L.,"CARMEN, N.L.",10,10,20,15,0,50,
21/04/2013,QRO.,"SAN JUAN DEL RIO, QRO.",9,6,15,0,0,0,
21/04/2013,MEX.,"AMECAMECA, MEX.",6,4,10,0,0,0,
21/04/2013,QRO.,"PEÑAMILLER, QRO.",3,0,3,0,0,0,
21/04/2013,OAX.,"SAN DIONISIO OCOTEPEC, OAX.",1,2,3,0,0,0,
21/04/2013,OAX.,"SAN MIGUEL EL GRANDE, OAX.",1,1,2,0,0,0,
21/04/2013,OAX.,"SAN DIONISIO OCOTEPEC, OAX.",1,0,1,0,0,0,
21/04/2013,OAX.,"JUCHITAN DE ZARAGOZA, OAX.",1,0,1,0,0,0,
21/04/2013,S.L.P.,"MATEHUALA, S.L.P.",1,0,1,0,0,0,
21/04/2013,TAMPS.,"TAMPICO, TAMPS.",1,0,1,2,0,437,
21/04/2013,TAMPS.,"CIUDAD MADERO, TAMPS.",1,0,1,3,0,203,
21/04/2013,TAMPS.,"GONZALEZ, TAMPS.",1,0,1,0,0,0,
21/04/2013,MICH.,"MARAVATIO, MICH.",1,0,1,0,0,0,
21/04/2013,HGO.,"HUEHUETLA, HGO.",0,0,0,0,0,10,
22/04/2013,QRO.,"SAN JUAN DEL RIO, QRO.",13,8,21,0,2,0,
22/04/2013,MICH.,"LA PIEDAD, MICH.",14,0,14,0,0,0,
22/04/2013,D.F.,"COYOACAN, D.F.",11,0,11,0,0,208,
22/04/2013,SIN.,"GUASAVE, SIN.",2,5,7,0,0,0,
22/04/2013,VER.,"BOCA DEL RIO, VER.",3,2,5,3,0,4,
22/04/2013,MICH.,"TACAMBARO, MICH.",1,3,4,0,0,0,
22/04/2013,B.C.,"TIJUANA, B.C.",1,2,3,0,0,0,
22/04/2013,TAMPS.,"MATAMOROS, TAMPS.",1,2,3,0,0,0,
22/04/2013,TAMPS.,"MATAMOROS, TAMPS.",1,2,3,0,0,0,
22/04/2013,MICH.,"APATZINGAN, MICH.",2,1,3,0,1,0,
22/04/2013,HGO.,"HUEHUETLA, HGO.",2,0,2,0,0,0,
22/04/2013,CHIS.,"SALTO DE AGUA, CHIS.",1,1,2,0,0,0,
22/04/2013,VER.,"COATZACOALCOS, VER.",1,0,1,1,0,0,
22/04/2013,NAY.,"TEPIC, NAY.",1,0,1,0,0,0,
22/04/2013,NAY.,"ACAPONETA, NAY.",1,0,1,0,0,0,
22/04/2013,QRO.,"SAN JOAQUIN, QRO.",1,0,1,0,1,0,
22/04/2013,S.L.P.,"SALINAS, S.L.P.",0,1,1,0,0,0,
22/04/2013,TAMPS.,"XICOTENCATL, TAMPS.",0,1,1,0,0,0,
22/04/2013,CHIH.,"NUEVO CASAS GRANDES, CHIH.",0,0,0,0,0,0,
22/04/2013,VER.,"MEDELLIN, VER.",0,0,0,0,0,32,
22/04/2013,TAMPS.,"VICTORIA, TAMPS.",0,0,0,0,0,50,
23/04/2013,D.F.,"COYOACAN, D.F.",49,9,58,0,2,230,
23/04/2013,QRO.,"PEDRO ESCOBEDO, QRO.",16,5,21,0,0,0,
23/04/2013,MICH.,"APATZINGAN, MICH.",8,2,10,0,0,0,
23/04/2013,MICH.,"APATZINGAN, MICH.",8,2,10,0,1,0,
23/04/2013,N.L.,"GRAL. TERAN, N.L.",3,4,7,4,0,300,
23/04/2013,MICH.,"LA PIEDAD, MICH.",5,2,7,0,0,0,
23/04/2013,MICH.,"MARAVATIO, MICH.",3,2,5,0,0,0,
23/04/2013,MICH.,"TACAMBARO, MICH.",3,2,5,0,0,0,
23/04/2013,N.L.,"SALINAS VICTORIA, N.L.",1,2,3,7,0,250,
23/04/2013,GRO.,"ACAPULCO DE JUAREZ, GRO.",3,0,3,0,3,0,
23/04/2013,NAY.,"ACAPONETA, NAY.",1,1,2,0,0,0,
23/04/2013,QRO.,"ARROYO SECO, QRO.",2,0,2,0,0,0,
23/04/2013,VER.,"BOCA DEL RIO, VER.",2,0,2,2,0,52,
23/04/2013,B.C.,"ENSENADA, B.C.",1,1,2,0,0,0,
23/04/2013,GRO.,"PETATLAN, GRO.",2,0,2,0,0,0,
23/04/2013,GRO.,"ZIHUATANEJO DE AZUETA, GRO.",2,0,2,0,0,0,
23/04/2013,S.L.P.,"SALINAS, S.L.P.",1,1,2,0,0,0,
23/04/2013,AGS.,"SAN FRANCISCO DE LOS ROMO, AGS.",2,0,2,1,0,48,
23/04/2013,SIN.,"GUASAVE, SIN.",1,1,2,0,9,0,
23/04/2013,NAY.,"TEPIC, NAY.",1,0,1,0,0,0,
23/04/2013,TAMPS.,"MATAMOROS, TAMPS.",0,1,1,0,0,0,
23/04/2013,S.L.P.,"RIOVERDE, S.L.P.",1,0,1,0,0,0,
23/04/2013,CHIH.,"CASAS GRANDES, CHIH.",1,0,1,0,0,0,
23/04/2013,HGO.,"HUEJUTLA DE REYES, HGO.",1,0,1,0,0,0,
24/04/2013,D.F.,"COYOACAN, D.F.",41,10,51,0,0,550,
24/04/2013,B.C.,"TIJUANA, B.C.",4,4,8,0,0,0,
24/04/2013,HGO.,"HUEHUETLA, HGO.",6,0,6,0,0,0,
24/04/2013,MICH.,"LA PIEDAD, MICH.",4,2,6,0,0,0,
24/04/2013,MICH.,"TACAMBARO, MICH.",3,2,5,0,0,0,
24/04/2013,N.L.,"SALINAS VICTORIA, N.L.",4,1,5,7,0,250,
24/04/2013,NAY.,"TEPIC, NAY.",1,4,5,0,0,0,
24/04/2013,QRO.,"HUIMILPAN, QRO.",3,1,4,0,0,0,
24/04/2013,SIN.,"GUASAVE, SIN.",2,1,3,0,5,0,
24/04/2013,NAY.,"ACAPONETA, NAY.",3,0,3,0,0,0,
24/04/2013,OAX.,"SANTA MARIA JACATEPEC, OAX.",2,1,3,0,0,0,
24/04/2013,AGS.,"SAN FRANCISCO DE LOS ROMO, AGS.",2,0,2,0,0,205,
24/04/2013,S.L.P.,"SALINAS, S.L.P.",2,0,2,0,0,0,
24/04/2013,MICH.,"APATZINGAN, MICH.",1,0,1,0,0,0,
24/04/2013,N.L.,"GRAL. TERAN, N.L.",0,1,1,0,0,300,
24/04/2013,OAX.,"TLACOLULA DE MATAMOROS, OAX.",1,0,1,0,0,0,
24/04/2013,VER.,"BOCA DEL RIO, VER.",1,0,1,1,0,0,
24/04/2013,S.L.P.,"RIOVERDE, S.L.P.",0,1,1,0,0,0,
25/04/2013,D.F.,"COYOACAN, D.F.",31,25,56,0,1,200,
25/04/2013,QRO.,"QUERETARO, QRO.",17,4,21,0,0,0,
25/04/2013,OAX.,"TLACOLULA DE MATAMOROS, OAX.",7,4,11,0,0,0,
25/04/2013,SIN.,"GUASAVE, SIN.",4,4,8,0,3,0,
25/04/2013,HGO.,"HUEHUETLA, HGO.",2,3,5,0,0,0,
25/04/2013,N.L.,"HUALAHUISES, N.L.",2,2,4,4,0,50,
25/04/2013,YUC.,"CHEMAX, YUC.",0,3,3,0,0,0,
25/04/2013,CHIS.,"LAS MARGARITAS, CHIS.",2,1,3,0,0,0,
25/04/2013,MICH.,"TACAMBARO, MICH.",2,1,3,0,0,0,
25/04/2013,B.C.,"TIJUANA, B.C.",1,2,3,0,0,0,
25/04/2013,S.L.P.,"SALINAS, S.L.P.",2,0,2,0,0,0,
25/04/2013,VER.,"BOCA DEL RIO, VER.",2,0,2,0,0,15,
25/04/2013,COL.,"COL., COL.",2,0,2,0,1,227,
25/04/2013,NAY.,"ACAPONETA, NAY.",0,2,2,0,0,0,
25/04/2013,MICH.,"APATZINGAN, MICH.",2,0,2,1,0,0,
25/04/2013,OAX.,"SAN JOSE CHILTEPEC, OAX.",2,0,2,0,0,0,
25/04/2013,VER.,"CORDOBA, VER.",1,0,1,0,0,7,
25/04/2013,NAY.,"TEPIC, NAY.",1,0,1,0,0,0,
25/04/2013,MICH.,"CHURUMUCO, MICH.",0,1,1,0,0,0,
25/04/2013,CHIH.,"CUAUHTÉMOC, CHIH.",0,1,1,0,0,0,
25/04/2013,TAMPS.,"VICTORIA, TAMPS.",0,1,1,0,1,0,
25/04/2013,TAMPS.,"VICTORIA, TAMPS.",0,0,0,0,0,50,
25/04/2013,TAMPS.,"NUEVO LAREDO, TAMPS.",0,0,0,0,1,131,
26/04/2013,D.F.,"COYOACAN, D.F.",31,13,44,0,0,180,
26/04/2013,MICH.,"MARAVATIO, MICH.",4,4,8,0,0,0,
26/04/2013,MICH.,"LA PIEDAD, MICH.",4,4,8,0,0,0,
26/04/2013,SIN.,"GUASAVE, SIN.",2,5,7,0,10,0,
26/04/2013,MICH.,"APATZINGAN, MICH.",5,1,6,0,1,0,
26/04/2013,HGO.,"HUEHUETLA, HGO.",3,1,4,0,0,200,
26/04/2013,AGS.,"SAN FRANCISCO DE LOS ROMO, AGS.",2,1,3,0,0,6,
26/04/2013,N.L.,"HUALAHUISES, N.L.",2,1,3,0,0,300,
26/04/2013,MICH.,"CHURUMUCO, MICH.",2,0,2,0,0,0,
26/04/2013,N.L.,"GRAL. ZUAZUA, N.L.",2,0,2,1,0,50,
26/04/2013,VER.,"MEDELLIN, VER.",0,2,2,0,0,0,
26/04/2013,QRO.,"JALPAN DE SERRA, QRO.",2,0,2,0,0,0,
26/04/2013,MICH.,"TACAMBARO, MICH.",2,0,2,0,0,0,
26/04/2013,TAMPS.,"MAINERO, TAMPS.",2,0,2,0,0,0,
26/04/2013,S.L.P.,"SALINAS, S.L.P.",1,0,1,0,0,0,
26/04/2013,VER.,"CORDOBA, VER.",1,0,1,1,0,0,
26/04/2013,CHIH.,"NUEVO CASAS GRANDES, CHIH.",1,0,1,0,1,0,
26/04/2013,COL.,"COL., COL.",1,0,1,1,0,0,
26/04/2013,TAMPS.,"TAMPICO, TAMPS.",1,0,1,0,0,0,
26/04/2013,VER.,"BOCA DEL RIO, VER.",0,0,0,0,1,0,
26/04/2013,TAMPS.,"VICTORIA, TAMPS.",0,0,0,0,1,0,
27/04/2013,N.L.,"HUALAHUISES, N.L.",9,8,17,12,0,250,
27/04/2013,OAX.,"SAN ANTONIO DE LA CAL, OAX.",5,6,11,7,0,0,
27/04/2013,MICH.,"APATZINGAN, MICH.",6,1,7,0,1,0,
27/04/2013,OAX.,"SAN ANTONIO DE LA CAL, OAX.",5,1,6,0,0,0,
27/04/2013,CHIS.,"LAS MARGARITAS, CHIS.",4,1,5,0,0,0,
27/04/2013,N.L.,"GRAL. ZUAZUA, N.L.",3,2,5,1,0,150,
27/04/2013,OAX.,"SALINA CRUZ, OAX.",4,0,4,0,0,0,
27/04/2013,JAL.,"CABO CORRIENTES, JAL.",0,4,4,0,0,0,
27/04/2013,HGO.,"HUEJUTLA DE REYES, HGO.",3,0,3,0,0,0,
27/04/2013,OAX.,"LOMA BONITA, OAX.",2,0,2,0,0,0,
27/04/2013,VER.,"CORDOBA, VER.",2,0,2,1,0,24,
27/04/2013,TAMPS.,"VICTORIA, TAMPS.",2,0,2,7,3,80,
27/04/2013,TAMPS.,"TAMPICO, TAMPS.",1,1,2,18,0,872,
27/04/2013,OAX.,"LOMA BONITA, OAX.",2,0,2,0,0,0,
27/04/2013,YUC.,"TICUL, YUC.",1,1,2,0,0,0,
27/04/2013,NAY.,"ACAPONETA, NAY.",1,0,1,0,0,0,
27/04/2013,CHIS.,"OCOSINGO, CHIS.",1,0,1,0,0,0,
27/04/2013,B.C.,"MEXICALI, B.C.",0,1,1,0,0,0,
28/04/2013,MICH.,"LA PIEDAD, MICH.",20,0,20,0,0,0,
28/04/2013,N.L.,"LINARES, N.L.",4,5,9,2,0,150,
28/04/2013,N.L.,"GRAL. ZUAZUA, N.L.",6,1,7,2,0,0,
28/04/2013,MICH.,"LA PIEDAD, MICH.",3,4,7,0,0,0,
28/04/2013,MICH.,"MARAVATIO, MICH.",3,1,4,0,2,0,
28/04/2013,MICH.,"TACAMBARO, MICH.",1,2,3,0,0,0,
28/04/2013,CHIS.,"LAS MARGARITAS, CHIS.",2,0,2,0,0,0,
28/04/2013,MICH.,"MARAVATIO, MICH.",2,0,2,0,1,0,
28/04/2013,TAMPS.,"GONZALEZ, TAMPS.",2,0,2,0,0,45,
28/04/2013,OAX.,"SAN PEDRO POCHUTLA, OAX.",0,1,1,0,0,0,
28/04/2013,OAX.,"SANTIAGO MINAS, OAX.",0,1,1,0,0,0,
28/04/2013,TAMPS.,"CIUDAD MADERO, TAMPS.",0,1,1,4,0,1087,
29/04/2013,D.F.,"BENITO JUAREZ, D.F.",12,2,14,0,5,100,
29/04/2013,OAX.,"SANTO DOMINGO TEHUANTEPEC, OAX.",9,1,10,7,0,13,
29/04/2013,MICH.,"ZACAPU, MICH.",3,5,8,0,0,0,
29/04/2013,N.L.,"LINARES, N.L.",3,4,7,2,0,50,
29/04/2013,OAX.,"SAN ANTONIO DE LA CAL, OAX.",5,1,6,7,0,0,
29/04/2013,MICH.,"JIQUILPAN, MICH.",3,0,3,0,0,0,
29/04/2013,B.C.,"TIJUANA, B.C.",3,0,3,0,0,0,
29/04/2013,VER.,"MEDELLIN, VER.",1,1,2,0,0,0,
29/04/2013,OAX.,"SANTA MARIA HUATULCO, OAX.",1,1,2,0,0,0,
29/04/2013,SIN.,"EL FUERTE, SIN.",0,2,2,0,8,0,
29/04/2013,OAX.,"LOMA BONITA, OAX.",1,0,1,0,0,0,
29/04/2013,B.C.,"ENSENADA, B.C.",1,0,1,0,0,0,
29/04/2013,N.L.,"GRAL. ZUAZUA, N.L.",0,0,0,1,0,50,
30/04/2013,D.F.,"BENITO JUAREZ, D.F.",35,12,47,0,0,200,
30/04/2013,MICH.,"ZACAPU, MICH.",8,3,11,0,0,0,
30/04/2013,N.L.,"LINARES, N.L.",7,2,9,3,0,450,
30/04/2013,MICH.,"JIQUILPAN, MICH.",6,0,6,0,1,0,
30/04/2013,B.C.,"TIJUANA, B.C.",4,0,4,0,0,0,
30/04/2013,TAMPS.,"VICTORIA, TAMPS.",4,0,4,3,0,60,
30/04/2013,B.C.,"TIJUANA, B.C.",4,0,4,0,0,0,
30/04/2013,CHIS.,"LAS MARGARITAS, CHIS.",2,0,2,0,0,0,
30/04/2013,SIN.,"EL FUERTE, SIN.",1,1,2,0,12,0,
30/04/2013,B.C.,"ENSENADA, B.C.",0,2,2,0,0,0,
30/04/2013,TAMPS.,"XICOTENCATL, TAMPS.",2,0,2,0,0,0,
30/04/2013,B.C.,"ENSENADA, B.C.",0,2,2,0,0,0,
30/04/2013,N.L.,"CIENEGA DE FLORES, N.L.",1,0,1,0,0,550,
30/04/2013,VER.,"CORDOBA, VER.",0,1,1,0,0,0,
01/05/2013,MICH.,"AGUILILLA, MICH.",9,1,10,0,0,0,
01/05/2013,N.L.,"LINARES, N.L.",6,0,6,4,0,100,
01/05/2013,SIN.,"EL FUERTE, SIN.",0,2,2,0,0,0,
01/05/2013,N.L.,"CIENEGA DE FLORES, N.L.",1,1,2,5,0,200,
01/05/2013,B.C.,"ENSENADA, B.C.",0,1,1,0,0,0,
02/05/2013,D.F.,"BENITO JUAREZ, D.F.",33,23,56,0,6,100,
02/05/2013,MICH.,"ZACAPU, MICH.",8,3,11,0,0,0,
02/05/2013,SIN.,"EL FUERTE, SIN.",3,6,9,0,7,0,
02/05/2013,CHIS.,"FRONTERA COMALAPA, CHIS.",3,2,5,0,0,0,
02/05/2013,B.C.,"MEXICALI, B.C.",2,3,5,0,0,0,
02/05/2013,TAB.,"CARDENAS, TAB.",2,1,3,0,0,0,
02/05/2013,B.C.,"TIJUANA, B.C.",1,2,3,0,0,0,
02/05/2013,N.L.,"LINARES, N.L.",0,2,2,1,0,30,
02/05/2013,VER.,"MEDELLIN, VER.",2,0,2,0,0,0,
02/05/2013,CHIS.,"LAS MARGARITAS, CHIS.",1,1,2,0,0,0,
02/05/2013,MICH.,"AGUILILLA, MICH.",2,0,2,1,0,0,
02/05/2013,N.L.,"CIENEGA DE FLORES, N.L.",0,1,1,20,0,1350,
02/05/2013,VER.,"CORDOBA, VER.",1,0,1,1,0,0,
02/05/2013,VER.,"COATZACOALCOS, VER.",1,0,1,0,0,0,
02/05/2013,MICH.,"TURICATO, MICH.",1,0,1,0,0,0,
02/05/2013,TAB.,"CENTRO, TAB.",1,0,1,0,0,0,
02/05/2013,TAMPS.,"MATAMOROS, TAMPS.",1,0,1,0,0,0,
02/05/2013,TAMPS.,"VICTORIA, TAMPS.",0,1,1,0,0,0,
02/05/2013,B.C.,"ENSENADA, B.C.",0,1,1,0,0,0,
02/05/2013,VER.,"BOCA DEL RIO, VER.",0,0,0,0,1,0,
02/05/2013,VER.,"BOCA DEL RIO, VER.",0,0,0,3,0,45,
03/05/2013,SIN.,"EL FUERTE, SIN.",4,4,8,0,9,0,
03/05/2013,MICH.,"ZACAPU, MICH.",5,1,6,0,0,0,
03/05/2013,N.L.,"LINARES, N.L.",1,2,3,0,0,0,
03/05/2013,MICH.,"JIQUILPAN, MICH.",2,1,3,0,0,0,
03/05/2013,B.C.,"TIJUANA, B.C.",2,1,3,0,0,0,
03/05/2013,OAX.,"LOMA BONITA, OAX.",2,0,2,0,0,0,
03/05/2013,CHIS.,"LAS MARGARITAS, CHIS.",1,1,2,0,0,0,
03/05/2013,MICH.,"TURICATO, MICH.",2,0,2,0,0,0,
03/05/2013,B.C.,"TIJUANA, B.C.",1,1,2,0,0,0,
03/05/2013,B.C.,"ENSENADA, B.C.",1,1,2,0,0,0,
03/05/2013,TAMPS.,"CIUDAD MADERO, TAMPS.",2,0,2,0,0,0,
03/05/2013,CHIS.,"FRONTERA COMALAPA, CHIS.",0,1,1,0,0,0,
03/05/2013,NAY.,"SAN PEDRO LAGUNILLAS, NAY.",0,1,1,0,0,0,
03/05/2013,VER.,"COSAMALOAPAN DE CARPIO, VER.",0,1,1,0,0,0,
03/05/2013,N.L.,"CIENEGA DE FLORES, N.L.",1,0,1,4,0,50,
03/05/2013,B.C.,"MEXICALI, B.C.",0,1,1,0,0,0,
03/05/2013,TAMPS.,"GUSTAVO DIAZ ORDAZ, TAMPS.",0,1,1,0,0,0,
03/05/2013,TAMPS.,"CIUDAD MADERO, TAMPS.",1,0,1,0,0,0,
04/05/2013,N.L.,"ITURBIDE, N.L.",3,4,7,9,0,0,
04/05/2013,N.L.,"ABASOLO, N.L.",3,2,5,23,0,1450,
04/05/2013,TAB.,"CARDENAS, TAB.",5,0,5,2,0,0,
04/05/2013,TAMPS.,"EL MANTE, TAMPS.",3,1,4,1,0,0,
04/05/2013,TAB.,"CENTRO, TAB.",3,0,3,2,0,0,
04/05/2013,TAB.,"CARDENAS, TAB.",2,0,2,0,0,0,
04/05/2013,CHIS.,"OCOSINGO, CHIS.",1,0,1,0,0,0,
04/05/2013,TAMPS.,"VICTORIA, TAMPS.",0,1,1,0,0,0,
04/05/2013,B.C.,"TIJUANA, B.C.",0,1,1,0,0,0,
04/05/2013,MICH.,"JIQUILPAN, MICH.",1,0,1,0,0,0,
05/05/2013,MICH.,"ZACAPU, MICH.",3,0,3,0,2,0,
05/05/2013,MICH.,"TURICATO, MICH.",2,0,2,0,0,0,
05/05/2013,VER.,"XALAPA, VER.",0,1,1,0,0,0,
05/05/2013,TAB.,"CARDENAS, TAB.",1,0,1,1,0,0,
05/05/2013,TAMPS.,"EL MANTE, TAMPS.",0,1,1,0,0,0,
06/05/2013,MICH.,"JIQUILPAN, MICH.",7,2,9,0,0,0,
06/05/2013,MICH.,"ZACAPU, MICH.",6,2,8,0,0,0,
06/05/2013,SIN.,"CHOIX, SIN.",2,2,4,0,4,0,
06/05/2013,AGS.,"CALVILLO, AGS.",2,1,3,0,0,0,
06/05/2013,MICH.,"TURICATO, MICH.",1,1,2,0,0,0,
06/05/2013,N.L.,"ABASOLO, N.L.",1,0,1,1,0,1000,
06/05/2013,MICH.,"AGUILILLA, MICH.",1,0,1,1,0,0,
06/05/2013,B.C.,"ENSENADA, B.C.",1,0,1,0,0,0,
06/05/2013,CHIH.,"MEOQUI, CHIH.",0,0,0,0,0,63,
07/05/2013,AGS.,"CALVILLO, AGS.",19,6,25,0,0,50,
07/05/2013,SIN.,"CHOIX, SIN.",10,4,14,0,0,0,
07/05/2013,MICH.,"ZACAPU, MICH.",5,6,11,0,0,0,
07/05/2013,N.L.,"HIGUERAS, N.L.",2,3,5,2,0,50,
07/05/2013,MICH.,"JIQUILPAN, MICH.",3,1,4,0,0,0,
07/05/2013,B.C.,"TIJUANA, B.C.",0,4,4,0,0,0,
07/05/2013,CAMP.,"CHAMPOTÓN, CAMP.",1,1,2,0,0,0,
07/05/2013,NAY.,"TEPIC, NAY.",2,0,2,0,0,0,
07/05/2013,TAMPS.,"EL MANTE, TAMPS.",1,1,2,0,0,0,
07/05/2013,B.C.,"ENSENADA, B.C.",0,2,2,0,0,0,
07/05/2013,VER.,"BOCA DEL RIO, VER.",0,1,1,0,0,11,
07/05/2013,TAB.,"CARDENAS, TAB.",1,0,1,0,0,0,
07/05/2013,N.L.,"CHINA, N.L.",1,0,1,4,0,100,
08/05/2013,MICH.,"ZACAPU, MICH.",6,5,11,0,0,0,
08/05/2013,SIN.,"CHOIX, SIN.",10,1,11,0,0,0,
08/05/2013,N.L.,"HIGUERAS, N.L.",1,7,8,1,0,1700,
08/05/2013,MICH.,"JIQUILPAN, MICH.",5,1,6,0,0,0,
08/05/2013,N.L.,"CHINA, N.L.",2,3,5,2,0,0,
08/05/2013,TAB.,"CENTRO, TAB.",1,3,4,0,0,0,
08/05/2013,TAB.,"CARDENAS, TAB.",1,3,4,0,0,0,
08/05/2013,NAY.,"TEPIC, NAY.",3,0,3,1,0,5,
08/05/2013,AGS.,"CALVILLO, AGS.",0,3,3,0,0,0,
08/05/2013,MICH.,"AGUILILLA, MICH.",1,1,2,0,0,0,
08/05/2013,GRO.,"ACAPULCO DE JUAREZ, GRO.",1,1,2,0,1,45,
08/05/2013,MICH.,"TURICATO, MICH.",2,0,2,0,0,0,
08/05/2013,B.C.S.,"MULEGÉ, B.C.S.",0,2,2,0,0,0,
08/05/2013,VER.,"XALAPA, VER.",1,0,1,0,0,0,
08/05/2013,VER.,"BOCA DEL RIO, VER.",1,0,1,0,0,0,
08/05/2013,B.C.,"TIJUANA, B.C.",0,1,1,0,0,0,
08/05/2013,TAMPS.,"EL MANTE, TAMPS.",1,0,1,0,0,0,
09/05/2013,SIN.,"CHOIX, SIN.",5,5,10,0,0,0,
09/05/2013,MICH.,"TURICATO, MICH.",2,6,8,0,0,0,
09/05/2013,N.L.,"MARIN, N.L.",2,2,4,0,0,600,
09/05/2013,N.L.,"CHINA, N.L.",1,3,4,7,0,200,
09/05/2013,MICH.,"ZACAPU, MICH.",2,2,4,0,0,0,
09/05/2013,MICH.,"JIQUILPAN, MICH.",1,1,2,0,0,0,
09/05/2013,TAB.,"CARDENAS, TAB.",2,0,2,0,0,0,
09/05/2013,B.C.,"ENSENADA, B.C.",1,1,2,0,0,0,
09/05/2013,AGS.,"CALVILLO, AGS.",0,1,1,0,0,0,
09/05/2013,TAMPS.,"EL MANTE, TAMPS.",1,0,1,0,0,0,
09/05/2013,TAMPS.,"EL MANTE, TAMPS.",0,1,1,0,0,0,
09/05/2013,TAMPS.,"VICTORIA, TAMPS.",0,0,0,0,0,64,
10/05/2013,SIN.,"CHOIX, SIN.",6,2,8,0,6,0,
10/05/2013,MICH.,"ZACAPU, MICH.",6,1,7,0,0,0,
10/05/2013,TAB.,"CARDENAS, TAB.",4,1,5,15,1,0,
10/05/2013,B.C.,"TIJUANA, B.C.",2,3,5,0,0,0,
10/05/2013,B.C.S.,"MULEGÉ, B.C.S.",4,0,4,0,0,0,
10/05/2013,B.C.,"MEXICALI, B.C.",2,2,4,0,4,0,
10/05/2013,MICH.,"APATZINGAN, MICH.",2,1,3,0,0,0,
10/05/2013,N.L.,"CHINA, N.L.",2,1,3,0,0,0,
10/05/2013,CHIH.,"NUEVO CASAS GRANDES, CHIH.",0,1,1,0,0,0,
10/05/2013,NAY.,"TEPIC, NAY.",1,0,1,1,0,0,
10/05/2013,NAY.,"ACAPONETA, NAY.",0,1,1,0,0,0,
10/05/2013,N.L.,"MARIN, N.L.",0,1,1,29,0,0,
11/05/2013,MICH.,"ZACAPU, MICH.",3,1,4,0,0,0,
11/05/2013,B.C.,"TIJUANA, B.C.",1,3,4,0,0,0,
11/05/2013,MICH.,"JIQUILPAN, MICH.",3,0,3,0,0,0,
11/05/2013,B.C.,"ENSENADA, B.C.",1,1,2,0,0,0,
11/05/2013,TAB.,"CENTRO, TAB.",1,0,1,1,0,0,
11/05/2013,TAMPS.,"EL MANTE, TAMPS.",0,1,1,1,0,0,
11/05/2013,N.L.,"MARIN, N.L.",0,0,0,27,0,400,
12/05/2013,N.L.,"GRAL. BRAVO, N.L.",2,3,5,0,0,0,
12/05/2013,B.C.,"MEXICALI, B.C.",2,3,5,0,0,0,
12/05/2013,N.L.,"DR. GONZALEZ, N.L.",2,1,3,0,0,500,
12/05/2013,MICH.,"ZACAPU, MICH.",2,0,2,0,0,0,
12/05/2013,MICH.,"TURICATO, MICH.",1,1,2,0,0,0,
12/05/2013,TAMPS.,"GONZALEZ, TAMPS.",1,0,1,0,0,0,
13/05/2013,D.F.,"ALVARO OBREGON, D.F.",23,5,28,0,4,168,
13/05/2013,N.L.,"GRAL. BRAVO, N.L.",2,6,8,1,0,450,
13/05/2013,MICH.,"APATZINGAN, MICH.",3,3,6,0,0,0,
13/05/2013,B.C.,"ENSENADA, B.C.",1,4,5,0,0,0,
13/05/2013,B.C.,"MEXICALI, B.C.",3,2,5,0,0,0,
13/05/2013,GRO.,"TIXTLA DE GRO., GRO.",1,2,3,0,0,0,
13/05/2013,CHIS.,"LAS MARGARITAS, CHIS.",3,0,3,0,0,0,
13/05/2013,MICH.,"HUETAMO, MICH.",2,0,2,0,0,0,
13/05/2013,CHIS.,"OCOSINGO, CHIS.",0,2,2,0,0,0,
13/05/2013,B.C.S.,"MULEGÉ, B.C.S.",0,2,2,0,0,0,
13/05/2013,TAB.,"HUIMANGUILLO, TAB.",1,0,1,0,0,0,
13/05/2013,SIN.,"SIN., SIN.",0,1,1,0,0,0,
13/05/2013,CAMP.,"CAMP., CAMP.",1,0,1,0,0,0,
13/05/2013,B.C.,"TIJUANA, B.C.",0,1,1,0,0,0,
13/05/2013,N.L.,"DR. GONZALEZ, N.L.",0,0,0,3,0,0,
14/05/2013,D.F.,"ALVARO OBREGON, D.F.",24,9,33,0,6,150,
14/05/2013,MICH.,"LAZARO CARDENAS, MICH.",3,2,5,4,0,42,
14/05/2013,B.C.,"MEXICALI, B.C.",1,4,5,0,0,0,
14/05/2013,MICH.,"HUETAMO, MICH.",2,1,3,1,0,0,
14/05/2013,MICH.,"URUAPAN, MICH.",1,1,2,2,0,0,
14/05/2013,TAMPS.,"EL MANTE, TAMPS.",1,1,2,0,0,0,
14/05/2013,MICH.,"ZITACUARO, MICH.",1,0,1,0,0,0,
14/05/2013,NAY.,"SAN BLAS, NAY.",1,0,1,0,0,0,
14/05/2013,NAY.,"TUXPAN, NAY.",0,1,1,0,0,0,
14/05/2013,SIN.,"SIN., SIN.",0,1,1,0,0,0,
14/05/2013,N.L.,"DR. GONZALEZ, N.L.",0,1,1,4,0,0,
14/05/2013,MICH.,"COAHUAYANA, MICH.",1,0,1,0,0,0,
14/05/2013,COL.,"COL., COL.",0,1,1,0,0,0,
14/05/2013,B.C.,"TIJUANA, B.C.",1,0,1,0,0,0,
14/05/2013,B.C.,"ENSENADA, B.C.",1,0,1,0,0,0,
15/05/2013,D.F.,"ALVARO OBREGON, D.F.",23,8,31,0,2,150,
15/05/2013,MICH.,"URUAPAN, MICH.",6,6,12,0,0,0,
15/05/2013,MICH.,"ZITACUARO, MICH.",6,1,7,0,0,0,
15/05/2013,B.C.,"MEXICALI, B.C.",3,3,6,0,0,0,
15/05/2013,MICH.,"LAZARO CARDENAS, MICH.",5,0,5,4,0,66,
15/05/2013,MICH.,"HUETAMO, MICH.",2,2,4,0,0,0,
15/05/2013,B.C.,"TIJUANA, B.C.",0,3,3,0,0,0,
15/05/2013,AGS.,"PABELLÓN DE ARTEAGA, AGS.",1,0,1,0,0,0,
15/05/2013,NAY.,"TUXPAN, NAY.",0,1,1,0,0,0,
15/05/2013,CAMP.,"CAMP., CAMP.",1,0,1,0,0,0,
15/05/2013,MICH.,"COAHUAYANA, MICH.",0,1,1,0,0,0,
15/05/2013,B.C.S.,"MULEGÉ, B.C.S.",1,0,1,0,0,0,
15/05/2013,SIN.,"SIN., SIN.",0,0,0,0,2,0,
15/05/2013,CHIH.,"NUEVO CASAS GRANDES, CHIH.",0,0,0,0,0,71,
15/05/2013,N.L.,"PESQUERIA, N.L.",0,0,0,4,0,150,
16/05/2013,D.F.,"ALVARO OBREGON, D.F.",24,25,49,0,0,800,
16/05/2013,MICH.,"URUAPAN, MICH.",4,9,13,0,0,0,
16/05/2013,MICH.,"LAZARO CARDENAS, MICH.",6,2,8,0,1,0,
16/05/2013,MICH.,"HUETAMO, MICH.",3,2,5,0,0,0,
16/05/2013,CHIS.,"COMITAN DE DOMÍNGUEZ, CHIS.",4,1,5,0,0,0,
16/05/2013,MICH.,"ZITACUARO, MICH.",2,2,4,0,0,0,
16/05/2013,N.L.,"DR. COSS, N.L.",0,3,3,4,0,0,
16/05/2013,TAMPS.,"VICTORIA, TAMPS.",3,0,3,2,3,830,
16/05/2013,B.C.,"ENSENADA, B.C.",0,3,3,0,0,0,
16/05/2013,B.C.,"MEXICALI, B.C.",1,2,3,0,0,0,
16/05/2013,SIN.,"SIN., SIN.",1,1,2,0,14,0,
16/05/2013,TAB.,"CARDENAS, TAB.",1,0,1,0,0,0,
16/05/2013,TAB.,"HUIMANGUILLO, TAB.",1,0,1,0,0,0,
16/05/2013,B.C.S.,"MULEGÉ, B.C.S.",1,0,1,0,0,0,
16/05/2013,COL.,"COL., COL.",1,0,1,0,0,0,
16/05/2013,TAMPS.,"EL MANTE, TAMPS.",1,0,1,0,0,0,
16/05/2013,CHIS.,"LAS MARGARITAS, CHIS.",0,1,1,0,0,0,
17/05/2013,D.F.,"ALVARO OBREGON, D.F.",22,13,35,0,1,150,
17/05/2013,MICH.,"URUAPAN, MICH.",7,4,11,0,0,0,
17/05/2013,SIN.,"SIN., SIN.",7,0,7,0,14,0,
17/05/2013,MICH.,"HUETAMO, MICH.",4,2,6,0,0,0,
17/05/2013,B.C.,"MEXICALI, B.C.",2,4,6,0,0,0,
17/05/2013,YUC.,"KANASIN, YUC.",2,2,4,0,0,32,
17/05/2013,MICH.,"ZITACUARO, MICH.",2,2,4,0,0,0,
17/05/2013,MICH.,"LAZARO CARDENAS, MICH.",4,0,4,1,0,0,
17/05/2013,AGS.,"PABELLÓN DE ARTEAGA, AGS.",2,1,3,0,0,117,
17/05/2013,TAB.,"HUIMANGUILLO, TAB.",2,0,2,0,0,0,
17/05/2013,SIN.,"SIN., SIN.",2,0,2,0,6,0,
17/05/2013,CHIH.,"ALDAMA, CHIH.",1,0,1,0,0,0,
17/05/2013,CHIH.,"NUEVO CASAS GRANDES, CHIH.",1,0,1,0,0,0,
17/05/2013,CHIH.,"DELICIAS, CHIH.",1,0,1,0,0,0,
17/05/2013,N.L.,"PESQUERIA, N.L.",1,0,1,6,0,700,
17/05/2013,TAMPS.,"EL MANTE, TAMPS.",0,1,1,0,0,0,
17/05/2013,B.C.,"TIJUANA, B.C.",1,0,1,0,0,0,
17/05/2013,TAMPS.,"VICTORIA, TAMPS.",0,0,0,0,1,0,
18/05/2013,CHIH.,"CHIH., CHIH.",3,34,37,0,2,116,
18/05/2013,B.C.,"TIJUANA, B.C.",2,24,26,0,0,0,
18/05/2013,N.L.,"MONTERREY, N.L.",0,18,18,0,4,2588,
18/05/2013,TAB.,"CENTRO, TAB.",11,3,14,26,7,60,
18/05/2013,YUC.,"VALLADOLID, YUC.",6,7,13,0,0,164,
18/05/2013,Q. ROO,"BENITO JUAREZ, Q. ROO",10,1,11,7,8,617,
18/05/2013,MICH.,"ZITACUARO, MICH.",8,1,9,0,0,0,
18/05/2013,MICH.,"HUETAMO, MICH.",5,1,6,0,0,0,
18/05/2013,YUC.,"KANASIN, YUC.",5,0,5,0,0,0,
18/05/2013,JAL.,"TOMATLAN, JAL.",1,3,4,0,0,0,
18/05/2013,JAL.,"CABO CORRIENTES, JAL.",4,0,4,0,0,0,
18/05/2013,VER.,"COATZACOALCOS, VER.",0,3,3,0,0,315,
18/05/2013,MICH.,"LAZARO CARDENAS, MICH.",2,0,2,0,0,0,
18/05/2013,N.L.,"PESQUERIA, N.L.",1,1,2,6,0,500,
18/05/2013,TAMPS.,"REYNOSA, TAMPS.",2,0,2,0,0,0,
18/05/2013,TAMPS.,"REYNOSA, TAMPS.",2,0,2,0,0,0,
18/05/2013,VER.,"OTATITLAN, VER.",1,0,1,0,0,77,
18/05/2013,TAB.,"CENTRO, TAB.",1,0,1,0,0,54,
18/05/2013,MICH.,"URUAPAN, MICH.",1,0,1,0,0,0,
18/05/2013,B.C.,"TECATE, B.C.",0,1,1,0,0,0,
18/05/2013,DGO.,"DGO., DGO.",0,0,0,0,0,204,
19/05/2013,HGO.,"PACHUCA DE SOTO, HGO.",48,40,88,0,7,1118,
19/05/2013,S.L.P.,"SAN LUIS POTOSI, S.L.P.",1,10,11,0,3,50,
19/05/2013,NAY.,"TEPIC, NAY.",5,4,9,0,0,0,
19/05/2013,GRO.,"BENITO JUAREZ, GRO.",3,2,5,0,0,0,
19/05/2013,JAL.,"TOMATLAN, JAL.",1,3,4,0,0,0,
19/05/2013,MICH.,"HUETAMO, MICH.",1,2,3,0,0,0,
19/05/2013,N.L.,"PESQUERIA, N.L.",1,2,3,2,0,150,
19/05/2013,JAL.,"GUADALAJARA, JAL.",0,3,3,0,0,56,
19/05/2013,VER.,"OTEAPAN, VER.",0,2,2,0,0,0,
19/05/2013,AGS.,"AGS., AGS.",0,2,2,0,0,200,
19/05/2013,VER.,"VER., VER.",1,1,2,0,1,0,
19/05/2013,GRO.,"ATOYAC DE ALVAREZ, GRO.",1,1,2,0,0,0,
19/05/2013,B.C.,"ENSENADA, B.C.",0,2,2,0,0,0,
19/05/2013,MICH.,"ZITACUARO, MICH.",1,0,1,0,0,0,
19/05/2013,MICH.,"URUAPAN, MICH.",1,0,1,0,0,0,
19/05/2013,QRO.,"QUERETARO, QRO.",0,0,0,0,7,0,
20/05/2013,MEX.,"CHALCO, MEX.",77,9,86,0,0,0,
20/05/2013,GRO.,"ATOYAC DE ALVAREZ, GRO.",58,27,85,0,64,1483,
20/05/2013,MEX.,"TOLUCA, MEX.",53,22,75,0,0,410,
20/05/2013,GRO.,"ACAPULCO DE JUAREZ, GRO.",25,29,54,9,8,72,
20/05/2013,D.F.,"TLALPAN, D.F.",10,6,16,0,0,820,
20/05/2013,CHIS.,"LAS MARGARITAS, CHIS.",10,3,13,0,0,100,
20/05/2013,MICH.,"ZITACUARO, MICH.",7,6,13,0,0,0,
20/05/2013,VER.,"VER., VER.",10,2,12,0,0,169,
20/05/2013,MICH.,"URUAPAN, MICH.",3,6,9,0,0,0,
20/05/2013,B.C.,"TIJUANA, B.C.",5,1,6,0,0,0,
20/05/2013,N.L.,"AGUALEGUAS, N.L.",3,2,5,8,0,335,
20/05/2013,CHIH.,"GALEANA, CHIH.",4,1,5,0,0,0,
20/05/2013,MICH.,"HUETAMO, MICH.",1,2,3,0,0,0,
20/05/2013,CHIS.,"COMITAN DE DOMÍNGUEZ, CHIS.",2,1,3,0,0,0,
20/05/2013,MICH.,"LAZARO CARDENAS, MICH.",3,0,3,3,0,0,
20/05/2013,TAMPS.,"GONZALEZ, TAMPS.",2,1,3,0,0,0,
20/05/2013,TAB.,"HUIMANGUILLO, TAB.",1,1,2,0,0,0,
20/05/2013,CHIH.,"JUÁREZ, CHIH.",2,0,2,0,0,0,
20/05/2013,CAMP.,"CHAMPOTÓN, CAMP.",1,0,1,0,0,0,
20/05/2013,AGS.,"PABELLÓN DE ARTEAGA, AGS.",1,0,1,0,0,9,
20/05/2013,SIN.,"SALVADOR ALVARADO, SIN.",1,0,1,0,0,0,
20/05/2013,CHIH.,"CUAUHTÉMOC, CHIH.",0,0,0,0,0,115,
20/05/2013,OAX.,"CIUDAD IXTEPEC, OAX.",0,0,0,0,1,28,
20/05/2013,MICH.,"APATZINGAN, MICH.",0,0,0,0,0,7,
21/05/2013,D.F.,"TLALPAN, D.F.",24,6,30,0,7,1453,
21/05/2013,CAMP.,"CAMP., CAMP.",6,10,16,0,0,0,
21/05/2013,B.C.,"MEXICALI, B.C.",8,6,14,0,0,0,
21/05/2013,MICH.,"ZITACUARO, MICH.",5,4,9,0,0,0,
21/05/2013,TAMPS.,"REYNOSA, TAMPS.",3,4,7,0,11,9203,
21/05/2013,MICH.,"URUAPAN, MICH.",7,0,7,0,0,0,
21/05/2013,TAMPS.,"VICTORIA, TAMPS.",4,3,7,0,0,0,
21/05/2013,TAMPS.,"VICTORIA, TAMPS.",4,3,7,0,0,0,
21/05/2013,SIN.,"SALVADOR ALVARADO, SIN.",4,1,5,0,4,0,
21/05/2013,N.L.,"LOS RAMONES, N.L.",1,3,4,0,0,50,
21/05/2013,B.C.S.,"MULEGÉ, B.C.S.",2,1,3,0,0,0,
21/05/2013,MICH.,"HUETAMO, MICH.",1,2,3,0,0,0,
21/05/2013,COAH.,"MONCLOVA, COAH.",3,0,3,0,0,0,
21/05/2013,CHIH.,"JUÁREZ, CHIH.",0,2,2,0,0,0,
21/05/2013,TAB.,"HUIMANGUILLO, TAB.",2,0,2,0,0,0,
21/05/2013,N.L.,"AGUALEGUAS, N.L.",1,1,2,0,0,200,
21/05/2013,COAH.,"TORREÓN, COAH.",2,0,2,0,0,0,
21/05/2013,TAMPS.,"EL MANTE, TAMPS.",1,0,1,0,0,0,
21/05/2013,TAMPS.,"EL MANTE, TAMPS.",1,0,1,0,0,0,
22/05/2013,D.F.,"TLALPAN, D.F.",35,8,43,0,0,148,
22/05/2013,MICH.,"URUAPAN, MICH.",8,6,14,0,0,0,
22/05/2013,MICH.,"URUAPAN, MICH.",8,6,14,0,0,0,
22/05/2013,SIN.,"SALVADOR ALVARADO, SIN.",6,2,8,0,0,0,
22/05/2013,N.L.,"AGUALEGUAS, N.L.",1,6,7,0,0,0,
22/05/2013,COAH.,"TORREÓN, COAH.",4,1,5,0,0,0,
22/05/2013,JAL.,"TOMATLAN, JAL.",0,3,3,0,0,0,
22/05/2013,CHIS.,"COMITAN DE DOMÍNGUEZ, CHIS.",1,2,3,0,0,4,
22/05/2013,MICH.,"HUETAMO, MICH.",1,2,3,0,0,0,
22/05/2013,MICH.,"HUETAMO, MICH.",1,2,3,0,0,0,
22/05/2013,MICH.,"ZITACUARO, MICH.",1,1,2,0,0,0,
22/05/2013,N.L.,"LOS RAMONES, N.L.",1,1,2,3,0,0,
22/05/2013,MICH.,"LAZARO CARDENAS, MICH.",2,0,2,0,0,0,
22/05/2013,COAH.,"MONCLOVA, COAH.",2,0,2,1,0,0,
22/05/2013,MICH.,"ZITACUARO, MICH.",1,1,2,0,0,0,
22/05/2013,B.C.,"MEXICALI, B.C.",1,1,2,0,7,0,
22/05/2013,AGS.,"PABELLÓN DE ARTEAGA, AGS.",1,0,1,0,0,121,
22/05/2013,CHIH.,"JUÁREZ, CHIH.",1,0,1,0,0,0,
22/05/2013,MICH.,"COAHUAYANA, MICH.",1,0,1,0,0,0,
22/05/2013,TAMPS.,"EL MANTE, TAMPS.",0,1,1,0,0,0,
22/05/2013,B.C.,"ENSENADA, B.C.",0,0,0,0,1,0,
22/05/2013,TAMPS.,"VICTORIA, TAMPS.",0,0,0,0,0,20,
23/05/2013,D.F.,"TLALPAN, D.F.",32,12,44,0,1,385,
23/05/2013,SIN.,"SALVADOR ALVARADO, SIN.",9,1,10,0,14,0,
23/05/2013,MICH.,"URUAPAN, MICH.",10,0,10,0,0,0,
23/05/2013,B.C.,"TIJUANA, B.C.",6,1,7,0,0,0,
23/05/2013,MICH.,"ZITACUARO, MICH.",3,2,5,1,0,0,
23/05/2013,JAL.,"TOMATLAN, JAL.",2,2,4,0,0,0,
23/05/2013,MICH.,"HUETAMO, MICH.",3,0,3,3,0,0,
23/05/2013,MICH.,"LAZARO CARDENAS, MICH.",3,0,3,1,0,0,
23/05/2013,S.L.P.,"SAN LUIS POTOSI, S.L.P.",2,0,2,0,0,0,
23/05/2013,AGS.,"SAN JOSÉ DE GRACIA, AGS.",2,0,2,0,0,14,
23/05/2013,CHIS.,"COMITAN DE DOMÍNGUEZ, CHIS.",2,0,2,0,0,0,
23/05/2013,B.C.S.,"MULEGÉ, B.C.S.",0,2,2,0,0,0,
23/05/2013,B.C.,"ENSENADA, B.C.",0,2,2,0,0,0,
23/05/2013,MICH.,"COAHUAYANA, MICH.",1,0,1,0,0,0,
23/05/2013,OAX.,"SANTIAGO PINOTEPA NACIONAL, OAX.",1,0,1,0,0,0,
23/05/2013,AGS.,"PABELLÓN DE ARTEAGA, AGS.",0,0,0,0,0,0,
24/05/2013,D.F.,"TLALPAN, D.F.",32,3,35,0,0,298,
24/05/2013,SIN.,"SALVADOR ALVARADO, SIN.",4,3,7,0,9,0,
24/05/2013,CHIH.,"HGO. DEL PARRAL, CHIH.",3,1,4,0,0,0,
24/05/2013,MICH.,"COAHUAYANA, MICH.",2,2,4,0,0,0,
24/05/2013,CAMP.,"CAMP., CAMP.",2,1,3,0,0,0,
24/05/2013,NAY.,"TEPIC, NAY.",1,2,3,0,0,0,
24/05/2013,OAX.,"CIUDAD IXTEPEC, OAX.",2,1,3,1,0,0,
24/05/2013,N.L.,"GRAL. ZARAGOZA, N.L.",2,1,3,14,0,100,
24/05/2013,S.L.P.,"SAN LUIS POTOSI, S.L.P.",3,0,3,0,0,0,
24/05/2013,MICH.,"LAZARO CARDENAS, MICH.",2,1,3,0,0,0,
24/05/2013,B.C.,"TIJUANA, B.C.",2,1,3,0,0,0,
24/05/2013,TAMPS.,"MATAMOROS, TAMPS.",0,3,3,0,0,0,
24/05/2013,OAX.,"CIUDAD IXTEPEC, OAX.",2,1,3,2,0,0,
24/05/2013,AGS.,"SAN JOSÉ DE GRACIA, AGS.",0,2,2,0,0,48,
24/05/2013,N.L.,"PARAS, N.L.",0,2,2,0,0,0,
24/05/2013,OAX.,"MIAHUATLAN DE PORFIRIO DIAZ, OAX.",2,0,2,30,0,49,
24/05/2013,B.C.S.,"MULEGÉ, B.C.S.",2,0,2,0,0,0,
24/05/2013,AGS.,"PABELLÓN DE ARTEAGA, AGS.",1,0,1,0,0,24,
24/05/2013,GRO.,"BENITO JUAREZ, GRO.",1,0,1,0,0,0,
24/05/2013,B.C.,"ENSENADA, B.C.",0,1,1,0,0,0,
24/05/2013,OAX.,"SANTIAGO PINOTEPA NACIONAL, OAX.",1,0,1,0,0,0,
24/05/2013,TAMPS.,"EL MANTE, TAMPS.",1,0,1,0,0,0,
25/05/2013,MICH.,"ZITACUARO, MICH.",6,2,8,3,1,0,
25/05/2013,B.C.,"TIJUANA, B.C.",3,3,6,0,0,0,
25/05/2013,MICH.,"URUAPAN, MICH.",4,0,4,0,0,0,
25/05/2013,N.L.,"PARAS, N.L.",0,2,2,4,0,25,
25/05/2013,S.L.P.,"CIUDAD VALLES, S.L.P.",2,0,2,0,0,0,
25/05/2013,MICH.,"LAZARO CARDENAS, MICH.",1,0,1,0,0,0,
25/05/2013,B.C.S.,"MULEGÉ, B.C.S.",1,0,1,0,0,0,
25/05/2013,N.L.,"GRAL. ZARAGOZA, N.L.",0,0,0,5,0,0,
26/05/2013,MICH.,"HUETAMO, MICH.",8,4,12,8,0,0,
26/05/2013,MICH.,"ZITACUARO, MICH.",4,1,5,1,0,0,
26/05/2013,MICH.,"URUAPAN, MICH.",1,2,3,0,0,0,
26/05/2013,TAMPS.,"MATAMOROS, TAMPS.",0,3,3,0,0,0,
26/05/2013,S.L.P.,"SAN LUIS POTOSI, S.L.P.",1,0,1,0,0,0,
26/05/2013,TAMPS.,"EL MANTE, TAMPS.",1,0,1,0,0,0,
26/05/2013,B.C.,"ENSENADA, B.C.",0,1,1,0,0,0,
26/05/2013,TAMPS.,"MATAMOROS, TAMPS.",0,1,1,0,0,0,
26/05/2013,N.L.,"DR. ARROYO, N.L.",0,0,0,1,0,0,
27/05/2013,D.F.,"MILPA ALTA, D.F.",8,4,12,0,0,0,
27/05/2013,TAB.,"BALANCAN, TAB.",5,3,8,0,0,0,
27/05/2013,SIN.,"SALVADOR ALVARADO, SIN.",5,2,7,0,9,0,
27/05/2013,MICH.,"URUAPAN, MICH.",5,1,6,0,0,0,
27/05/2013,N.L.,"DR. ARROYO, N.L.",2,2,4,11,0,100,
27/05/2013,MICH.,"HUETAMO, MICH.",3,0,3,1,0,0,
27/05/2013,MICH.,"LAZARO CARDENAS, MICH.",3,0,3,1,0,5,
27/05/2013,S.L.P.,"SAN LUIS POTOSI, S.L.P.",0,3,3,0,0,0,
27/05/2013,MICH.,"ZITACUARO, MICH.",2,0,2,1,0,0,
27/05/2013,MICH.,"COAHUAYANA, MICH.",1,1,2,2,0,20,
27/05/2013,CHIH.,"JUÁREZ, CHIH.",1,1,2,0,0,0,
27/05/2013,CHIS.,"COMITAN DE DOMÍNGUEZ, CHIS.",2,0,2,0,0,0,
27/05/2013,GRO.,"ATOYAC DE ALVAREZ, GRO.",1,0,1,1,0,0,
27/05/2013,CHIS.,"FRONTERA COMALAPA, CHIS.",0,1,1,0,0,0,
27/05/2013,CHIH.,"HGO. DEL PARRAL, CHIH.",1,0,1,0,0,0,
27/05/2013,B.C.,"ENSENADA, B.C.",0,1,1,0,0,0,
28/05/2013,D.F.,"MILPA ALTA, D.F.",23,6,29,0,0,0,
28/05/2013,MICH.,"URUAPAN, MICH.",4,4,8,0,0,0,
28/05/2013,S.L.P.,"SAN LUIS POTOSI, S.L.P.",4,1,5,0,0,0,
28/05/2013,MICH.,"ZITACUARO, MICH.",4,1,5,3,0,0,
28/05/2013,SIN.,"SALVADOR ALVARADO, SIN.",3,1,4,0,11,0,
28/05/2013,CHIH.,"JUÁREZ, CHIH.",4,0,4,0,0,0,
28/05/2013,MICH.,"COAHUAYANA, MICH.",2,2,4,0,0,0,
28/05/2013,MICH.,"HUETAMO, MICH.",2,1,3,3,0,0,
28/05/2013,N.L.,"DR. ARROYO, N.L.",0,2,2,17,0,50,
28/05/2013,CHIH.,"CUAUHTÉMOC, CHIH.",1,1,2,0,0,0,
28/05/2013,MICH.,"LAZARO CARDENAS, MICH.",2,0,2,0,0,0,
28/05/2013,B.C.S.,"MULEGÉ, B.C.S.",0,2,2,0,0,0,
28/05/2013,OAX.,"PINOTEPA DE DON LUIS, OAX.",1,0,1,0,0,0,
28/05/2013,CHIH.,"HGO. DEL PARRAL, CHIH.",1,0,1,0,0,0,
28/05/2013,TAB.,"HUIMANGUILLO, TAB.",1,0,1,0,0,50,
28/05/2013,B.C.S.,"MULEGÉ, B.C.S.",0,1,1,0,0,0,
29/05/2013,D.F.,"MILPA ALTA, D.F.",16,14,30,0,0,0,
29/05/2013,MICH.,"URUAPAN, MICH.",10,4,14,0,0,0,
29/05/2013,B.C.,"TIJUANA, B.C.",3,3,6,0,0,0,
29/05/2013,N.L.,"DR. ARROYO, N.L.",4,1,5,1,0,0,
29/05/2013,MICH.,"ZITACUARO, MICH.",2,2,4,1,0,0,
29/05/2013,S.L.P.,"SAN LUIS POTOSI, S.L.P.",3,0,3,0,0,0,
29/05/2013,CAMP.,"CAMP., CAMP.",3,0,3,0,0,0,
29/05/2013,MICH.,"HUETAMO, MICH.",0,3,3,0,0,0,
29/05/2013,B.C.,"TIJUANA, B.C.",0,3,3,0,0,0,
29/05/2013,MICH.,"COAHUAYANA, MICH.",2,0,2,2,0,0,
29/05/2013,OAX.,"MIAHUATLAN DE PORFIRIO DIAZ, OAX.",2,0,2,5,1,0,
29/05/2013,SIN.,"SALVADOR ALVARADO, SIN.",1,0,1,0,0,0,
29/05/2013,B.C.S.,"MULEGÉ, B.C.S.",1,0,1,0,0,0,
29/05/2013,CHIH.,"JUÁREZ, CHIH.",1,0,1,0,0,0,
29/05/2013,CHIS.,"COMITAN DE DOMÍNGUEZ, CHIS.",1,0,1,0,0,0,
29/05/2013,TAMPS.,"EL MANTE, TAMPS.",1,0,1,0,0,0,
29/05/2013,AGS.,"SAN JOSÉ DE GRACIA, AGS.",0,0,0,0,0,117,
30/05/2013,D.F.,"MILPA ALTA, D.F.",17,3,20,0,0,47,
30/05/2013,MICH.,"ZITACUARO, MICH.",5,3,8,2,0,0,
30/05/2013,MICH.,"HUETAMO, MICH.",2,5,7,5,0,0,
30/05/2013,B.C.,"TIJUANA, B.C.",2,5,7,0,0,0,
30/05/2013,N.L.,"LAMPAZOS DE NARANJO, N.L.",1,5,6,0,0,170,
30/05/2013,SIN.,"SALVADOR ALVARADO, SIN.",4,1,5,0,7,0,
30/05/2013,OAX.,"MIAHUATLAN DE PORFIRIO DIAZ, OAX.",1,4,5,20,0,532,
30/05/2013,N.L.,"DR. ARROYO, N.L.",3,1,4,7,0,50,
30/05/2013,CHIH.,"JUÁREZ, CHIH.",3,1,4,0,0,0,
30/05/2013,MICH.,"URUAPAN, MICH.",3,0,3,2,0,0,
30/05/2013,TAMPS.,"MATAMOROS, TAMPS.",2,1,3,0,0,0,
30/05/2013,NAY.,"ROSAMORADA, NAY.",0,2,2,0,0,0,
30/05/2013,MICH.,"LAZARO CARDENAS, MICH.",2,0,2,0,0,0,
30/05/2013,S.L.P.,"CIUDAD VALLES, S.L.P.",1,1,2,0,0,0,
30/05/2013,TAB.,"HUIMANGUILLO, TAB.",1,0,1,0,0,0,
30/05/2013,COL.,"TECOMÁN, COL.",0,1,1,0,0,0,
30/05/2013,AGS.,"SAN JOSÉ DE GRACIA, AGS.",0,1,1,0,0,0,
31/05/2013,D.F.,"MILPA ALTA, D.F.",20,8,28,0,0,0,
31/05/2013,MICH.,"URUAPAN, MICH.",10,3,13,0,0,0,
31/05/2013,MICH.,"ZITACUARO, MICH.",7,4,11,2,1,0,
31/05/2013,N.L.,"LAMPAZOS DE NARANJO, N.L.",5,5,10,5,0,1200,
31/05/2013,MICH.,"LAZARO CARDENAS, MICH.",5,0,5,0,0,0,
31/05/2013,MICH.,"HUETAMO, MICH.",2,2,4,2,0,0,
31/05/2013,S.L.P.,"CIUDAD VALLES, S.L.P.",2,1,3,0,0,0,
31/05/2013,SIN.,"SALVADOR ALVARADO, SIN.",1,1,2,0,11,0,
31/05/2013,TAB.,"BALANCAN, TAB.",1,1,2,0,0,0,
31/05/2013,B.C.S.,"MULEGÉ, B.C.S.",0,2,2,0,0,0,
31/05/2013,B.C.S.,"MULEGÉ, B.C.S.",0,2,2,0,0,0,
31/05/2013,B.C.,"TIJUANA, B.C.",1,1,2,0,0,0,
31/05/2013,GRO.,"QUECHULTENANGO, GRO.",1,0,1,0,0,0,
31/05/2013,CHIS.,"COMITAN DE DOMÍNGUEZ, CHIS.",0,1,1,0,0,0,
31/05/2013,CHIH.,"JUÁREZ, CHIH.",1,0,1,0,0,0,
31/05/2013,CAMP.,"CAMP., CAMP.",1,0,1,0,0,0,
31/05/2013,MICH.,"COAHUAYANA, MICH.",1,0,1,0,0,0,
31/05/2013,OAX.,"CIUDAD IXTEPEC, OAX.",0,0,0,0,0,58,
31/05/2013,N.L.,"MIER Y NORIEGA, N.L.",0,0,0,1,0,0,
01/06/2013,N.L.,"LAMPAZOS DE NARANJO, N.L.",2,6,8,0,0,0,
01/06/2013,MICH.,"ZITACUARO, MICH.",1,5,6,1,0,0,
01/06/2013,B.C.,"TIJUANA, B.C.",0,5,5,0,0,0,
01/06/2013,N.L.,"MIER Y NORIEGA, N.L.",3,1,4,107,0,4823,
01/06/2013,MICH.,"HUETAMO, MICH.",2,1,3,2,0,0,
01/06/2013,TAB.,"HUIMANGUILLO, TAB.",2,0,2,1,0,5,
01/06/2013,B.C.S.,"MULEGÉ, B.C.S.",0,1,1,0,0,0,
01/06/2013,MICH.,"LAZARO CARDENAS, MICH.",0,1,1,0,0,0,
01/06/2013,S.L.P.,"SAN LUIS POTOSI, S.L.P.",1,0,1,0,0,0,
01/06/2013,GRO.,"QUECHULTENANGO, GRO.",0,1,1,0,0,0,
01/06/2013,TAMPS.,"EL MANTE, TAMPS.",1,0,1,0,0,0,
01/06/2013,S.L.P.,"SAN LUIS POTOSI, S.L.P.",1,0,1,0,0,0,
01/06/2013,OAX.,"MIAHUATLAN DE PORFIRIO DIAZ, OAX.",0,0,0,0,1,262,
02/06/2013,MICH.,"URUAPAN, MICH.",23,12,35,9,0,0,
02/06/2013,MICH.,"ZITACUARO, MICH.",10,2,12,3,0,0,
02/06/2013,COAH.,"TORREÓN, COAH.",8,1,9,1,0,20,
02/06/2013,MICH.,"HUETAMO, MICH.",4,3,7,7,0,0,
02/06/2013,N.L.,"LAMPAZOS DE NARANJO, N.L.",2,2,4,0,0,0,
02/06/2013,MICH.,"LAZARO CARDENAS, MICH.",2,2,4,0,0,0,
02/06/2013,OAX.,"MATIAS ROMERO AVENDAÑO, OAX.",1,1,2,0,0,0,
02/06/2013,GRO.,"QUECHULTENANGO, GRO.",0,1,1,0,0,0,
02/06/2013,B.C.,"ENSENADA, B.C.",1,0,1,0,0,0,
03/06/2013,N.L.,"ANAHUAC, N.L.",0,8,8,2,0,150,
03/06/2013,SIN.,"ANGOSTURA, SIN.",2,1,3,0,5,0,
03/06/2013,MICH.,"BUENAVISTA, MICH.",1,0,1,0,0,0,
03/06/2013,B.C.,"TIJUANA, B.C.",0,1,1,0,0,0,
04/06/2013,N.L.,"ANAHUAC, N.L.",1,11,12,25,0,1157,
04/06/2013,B.C.,"MEXICALI, B.C.",5,3,8,0,0,0,
04/06/2013,B.C.,"TIJUANA, B.C.",4,2,6,0,0,0,
04/06/2013,COAH.,"TORREÓN, COAH.",5,0,5,0,0,106,
04/06/2013,MICH.,"BUENAVISTA, MICH.",3,1,4,0,0,0,
04/06/2013,S.L.P.,"SAN LUIS POTOSI, S.L.P.",3,0,3,0,0,0,
04/06/2013,S.L.P.,"SAN LUIS POTOSI, S.L.P.",2,0,2,0,0,0,
04/06/2013,TAB.,"BALANCAN, TAB.",0,1,1,0,0,0,
04/06/2013,NAY.,"TEPIC, NAY.",1,0,1,0,0,0,
04/06/2013,CAMP.,"CAMP., CAMP.",1,0,1,0,0,0,
04/06/2013,MICH.,"TEPALCATEPEC, MICH.",1,0,1,1,0,0,
04/06/2013,SIN.,"ANGOSTURA, SIN.",0,1,1,0,0,0,
04/06/2013,CHIH.,"HGO. DEL PARRAL, CHIH.",1,0,1,0,0,0,
04/06/2013,AGS.,"SAN JOSÉ DE GRACIA, AGS.",1,0,1,0,0,0,
04/06/2013,B.C.,"ENSENADA, B.C.",0,1,1,0,0,0,
05/06/2013,MICH.,"BUENAVISTA, MICH.",2,4,6,0,0,0,
05/06/2013,B.C.,"MEXICALI, B.C.",3,3,6,0,0,0,
05/06/2013,COAH.,"TORREÓN, COAH.",3,1,4,0,0,0,
05/06/2013,MICH.,"TEPALCATEPEC, MICH.",1,2,3,1,0,0,
05/06/2013,SIN.,"ANGOSTURA, SIN.",2,1,3,0,3,0,
05/06/2013,COAH.,"ACUÑA, COAH.",0,2,2,0,0,0,
05/06/2013,B.C.,"TIJUANA, B.C.",2,0,2,0,0,0,
05/06/2013,S.L.P.,"CIUDAD VALLES, S.L.P.",2,0,2,0,0,0,
05/06/2013,S.L.P.,"SAN LUIS POTOSI, S.L.P.",2,0,2,0,0,0,
05/06/2013,CHIH.,"HGO. DEL PARRAL, CHIH.",1,0,1,0,0,0,
05/06/2013,VER.,"TEZONAPA, VER.",1,0,1,0,0,0,
05/06/2013,N.L.,"GRAL. ESCOBEDO, N.L.",1,0,1,0,0,62,
05/06/2013,B.C.,"ENSENADA, B.C.",1,0,1,0,0,0,
05/06/2013,OAX.,"MIAHUATLAN DE PORFIRIO DIAZ, OAX.",0,1,1,0,0,0,
06/06/2013,COAH.,"TORREÓN, COAH.",5,0,5,0,0,0,
06/06/2013,MICH.,"BUENAVISTA, MICH.",2,3,5,0,0,0,
06/06/2013,CAMP.,"HECELCHAKÁN, CAMP.",2,2,4,0,0,0,
06/06/2013,TAB.,"BALANCAN, TAB.",2,1,3,0,0,0,
06/06/2013,B.C.,"TIJUANA, B.C.",3,0,3,0,0,0,
06/06/2013,NAY.,"ROSAMORADA, NAY.",2,0,2,0,0,0,
07/06/2013,TAMPS.,"VICTORIA, TAMPS.",1,8,9,0,3,300,
07/06/2013,B.C.,"MEXICALI, B.C.",4,3,7,0,0,0,
07/06/2013,SIN.,"ANGOSTURA, SIN.",1,3,4,0,8,0,
07/06/2013,B.C.,"TIJUANA, B.C.",0,4,4,0,0,0,
07/06/2013,B.C.,"ENSENADA, B.C.",3,0,3,0,0,0,
07/06/2013,OAX.,"CIUDAD IXTEPEC, OAX.",0,2,2,0,0,0,
07/06/2013,TAMPS.,"EL MANTE, TAMPS.",1,0,1,0,0,0,
07/06/2013,COL.,"MANZANILLO, COL.",1,0,1,2,0,0,
08/06/2013,MICH.,"APATZINGAN, MICH.",3,8,11,0,1,0,
08/06/2013,B.C.S.,"LA PAZ, B.C.S.",5,4,9,3,0,69,
08/06/2013,B.C.S.,"LA PAZ, B.C.S.",6,2,8,0,0,0,
08/06/2013,JAL.,"AUTLAN DE NAVARRO, JAL.",4,4,8,0,0,31,
08/06/2013,COAH.,"TORREÓN, COAH.",3,1,4,0,0,0,
08/06/2013,NAY.,"TEPIC, NAY.",3,0,3,0,1,0,
08/06/2013,B.C.,"TIJUANA, B.C.",0,2,2,0,0,0,
08/06/2013,MICH.,"COALCOMAN DE VAZQUEZ PALLARES, MICH.",1,0,1,0,0,0,
08/06/2013,S.L.P.,"SAN LUIS POTOSI, S.L.P.",1,0,1,0,0,0,
08/06/2013,CHIS.,"YAJALÓN, CHIS.",0,1,1,0,0,0,
09/06/2013,D.F.,"MILPA ALTA, D.F.",26,6,32,0,1,161,
09/06/2013,B.C.S.,"MULEGÉ, B.C.S.",5,5,10,0,0,0,
09/06/2013,MICH.,"APATZINGAN, MICH.",1,1,2,0,0,0,
09/06/2013,B.C.S.,"LA PAZ, B.C.S.",2,0,2,0,0,0,
09/06/2013,S.L.P.,"CIUDAD VALLES, S.L.P.",1,0,1,0,0,0,
09/06/2013,TAB.,"JONUTA, TAB.",1,0,1,0,0,0,
09/06/2013,TAB.,"JONUTA, TAB.",1,0,1,0,0,0,
09/06/2013,JAL.,"AUTLAN DE NAVARRO, JAL.",0,1,1,0,0,310,
09/06/2013,MICH.,"COALCOMAN DE VAZQUEZ PALLARES, MICH.",0,1,1,0,0,0,
09/06/2013,MICH.,"TEPALCATEPEC, MICH.",1,0,1,0,0,0,
10/06/2013,D.F.,"CUAUHTEMOC, D.F.",75,9,84,0,5,614,
10/06/2013,MEX.,"NAUCALPAN DE JUAREZ, MEX.",18,4,22,1,0,43,
10/06/2013,MICH.,"APATZINGAN, MICH.",0,7,7,0,0,0,
10/06/2013,COAH.,"TORREÓN, COAH.",5,0,5,0,0,0,
10/06/2013,B.C.,"ENSENADA, B.C.",0,4,4,0,0,0,
10/06/2013,B.C.,"TIJUANA, B.C.",1,2,3,0,0,0,
10/06/2013,S.L.P.,"SAN LUIS POTOSI, S.L.P.",3,0,3,0,1,0,
10/06/2013,TAB.,"BALANCAN, TAB.",2,0,2,0,0,0,
10/06/2013,JAL.,"AUTLAN DE NAVARRO, JAL.",1,0,1,0,0,0,
10/06/2013,SIN.,"MOCORITO, SIN.",0,1,1,0,0,0,
10/06/2013,CHIS.,"LA INDEPENDENCIA, CHIS.",0,1,1,0,0,0,
10/06/2013,CAMP.,"CAMP., CAMP.",1,0,1,0,0,0,
11/06/2013,D.F.,"CUAUHTEMOC, D.F.",83,23,106,0,5,1223,
11/06/2013,MEX.,"NAUCALPAN DE JUAREZ, MEX.",15,5,20,4,0,745,
11/06/2013,CAMP.,"HECELCHAKÁN, CAMP.",2,1,3,0,0,0,
11/06/2013,MICH.,"APATZINGAN, MICH.",3,0,3,0,0,0,
11/06/2013,SIN.,"MOCORITO, SIN.",3,0,3,0,2,0,
11/06/2013,S.L.P.,"SAN LUIS POTOSI, S.L.P.",1,1,2,0,0,0,
11/06/2013,MICH.,"COALCOMAN DE VAZQUEZ PALLARES, MICH.",1,0,1,0,0,0,
11/06/2013,B.C.,"TIJUANA, B.C.",0,1,1,0,0,0,
12/06/2013,D.F.,"CUAUHTEMOC, D.F.",83,30,113,0,3,363,
12/06/2013,TAMPS.,"MATAMOROS, TAMPS.",2,4,6,1,0,0,
12/06/2013,COAH.,"TORREÓN, COAH.",4,0,4,0,0,0,
12/06/2013,TAMPS.,"VICTORIA, TAMPS.",2,2,4,1,0,0,
12/06/2013,S.L.P.,"SAN LUIS POTOSI, S.L.P.",2,1,3,0,0,0,
12/06/2013,MICH.,"APATZINGAN, MICH.",2,1,3,0,0,0,
12/06/2013,B.C.,"MEXICALI, B.C.",2,1,3,0,0,0,
12/06/2013,OAX.,"MATIAS ROMERO AVENDAÑO, OAX.",1,1,2,0,0,0,
12/06/2013,B.C.S.,"MULEGÉ, B.C.S.",0,2,2,0,0,0,
12/06/2013,CAMP.,"CAMP., CAMP.",1,0,1,0,0,0,
12/06/2013,MICH.,"TEPALCATEPEC, MICH.",0,1,1,0,0,0,
12/06/2013,TAB.,"JONUTA, TAB.",0,1,1,0,0,0,
12/06/2013,TAMPS.,"EL MANTE, TAMPS.",1,0,1,0,0,23,
12/06/2013,B.C.,"TIJUANA, B.C.",0,1,1,0,0,0,
12/06/2013,B.C.,"ENSENADA, B.C.",0,1,1,0,0,0,
13/06/2013,D.F.,"CUAUHTEMOC, D.F.",84,28,112,0,5,107,
13/06/2013,MEX.,"NAUCALPAN DE JUAREZ, MEX.",15,9,24,18,2,435,
13/06/2013,MICH.,"BUENAVISTA, MICH.",3,2,5,0,0,0,
13/06/2013,B.C.,"TIJUANA, B.C.",2,2,4,0,0,0,
13/06/2013,COAH.,"TORREÓN, COAH.",2,1,3,0,0,0,
13/06/2013,B.C.,"ENSENADA, B.C.",1,2,3,0,0,0,
13/06/2013,S.L.P.,"CIUDAD VALLES, S.L.P.",1,1,2,0,0,0,
13/06/2013,MICH.,"TEPALCATEPEC, MICH.",0,1,1,0,0,0,
13/06/2013,SIN.,"MOCORITO, SIN.",1,0,1,0,0,0,
13/06/2013,B.C.,"ENSENADA, B.C.",1,0,1,0,0,0,
13/06/2013,CHIH.,"CUAUHTÉMOC, CHIH.",1,0,1,0,0,0,
13/06/2013,TAMPS.,"EL MANTE, TAMPS.",1,0,1,0,0,0,
14/06/2013,D.F.,"CUAUHTEMOC, D.F.",105,11,116,0,8,122,
14/06/2013,MEX.,"NAUCALPAN DE JUAREZ, MEX.",15,1,16,5,1,275,
14/06/2013,COAH.,"TORREÓN, COAH.",4,5,9,0,0,0,
14/06/2013,B.C.S.,"LORETO, B.C.S.",3,5,8,0,0,0,
14/06/2013,SIN.,"MOCORITO, SIN.",4,0,4,0,1,0,
14/06/2013,COAH.,"TORREÓN, COAH.",4,0,4,0,0,0,
14/06/2013,S.L.P.,"SAN LUIS POTOSI, S.L.P.",2,1,3,0,0,0,
14/06/2013,TAB.,"COMALCALCO, TAB.",2,1,3,0,0,0,
14/06/2013,B.C.,"ENSENADA, B.C.",0,2,2,0,0,0,
14/06/2013,MICH.,"BUENAVISTA, MICH.",0,2,2,0,0,0,
14/06/2013,CHIH.,"ALDAMA, CHIH.",0,2,2,0,0,0,
14/06/2013,TAMPS.,"EL MANTE, TAMPS.",1,1,2,0,0,0,
14/06/2013,TAMPS.,"VICTORIA, TAMPS.",2,0,2,0,3,0,
14/06/2013,B.C.S.,"MULEGÉ, B.C.S.",1,0,1,0,0,0,
14/06/2013,TAB.,"BALANCAN, TAB.",1,0,1,0,0,0,
14/06/2013,OAX.,"MIAHUATLAN DE PORFIRIO DIAZ, OAX.",1,0,1,0,0,156,
14/06/2013,COAH.,"ACUÑA, COAH.",0,1,1,0,0,0,
15/06/2013,MEX.,"NAUCALPAN DE JUAREZ, MEX.",16,1,17,3,5,357,
15/06/2013,NAY.,"RUIZ, NAY.",5,0,5,0,0,0,
15/06/2013,JAL.,"AUTLAN DE NAVARRO, JAL.",3,1,4,0,0,127,
15/06/2013,B.C.,"TIJUANA, B.C.",2,1,3,0,0,0,
15/06/2013,CHIS.,"YAJALÓN, CHIS.",0,2,2,0,0,0,
15/06/2013,NAY.,"LA YESCA, NAY.",1,0,1,0,0,0,
15/06/2013,S.L.P.,"SAN LUIS POTOSI, S.L.P.",0,1,1,0,0,0,
15/06/2013,VER.,"CARLOS A. CARRILLO, VER.",1,0,1,0,0,0,
15/06/2013,OAX.,"MATIAS ROMERO AVENDAÑO, OAX.",1,0,1,0,0,0,
15/06/2013,B.C.S.,"LOS CABOS, B.C.S.",1,0,1,1,0,14,
15/06/2013,TAMPS.,"EL MANTE, TAMPS.",1,0,1,0,0,68,
16/06/2013,MICH.,"BUENAVISTA, MICH.",4,12,16,0,0,0,
16/06/2013,MEX.,"NAUCALPAN DE JUAREZ, MEX.",8,2,10,3,3,132,
16/06/2013,JAL.,"AUTLAN DE NAVARRO, JAL.",8,1,9,0,0,450,
16/06/2013,JAL.,"AUTLAN DE NAVARRO, JAL.",2,1,3,0,0,6,
16/06/2013,B.C.S.,"LOS CABOS, B.C.S.",1,1,2,1,0,0,
16/06/2013,B.C.S.,"MULEGÉ, B.C.S.",1,0,1,0,0,0,
16/06/2013,S.L.P.,"SAN LUIS POTOSI, S.L.P.",1,0,1,0,0,0,
17/06/2013,MICH.,"BUENAVISTA, MICH.",3,17,20,0,0,0,
17/06/2013,B.C.,"MEXICALI, B.C.",5,8,13,0,0,0,
17/06/2013,MEX.,"NAUCALPAN DE JUAREZ, MEX.",5,1,6,3,1,741,
17/06/2013,NAY.,"RUIZ, NAY.",3,2,5,1,0,0,
17/06/2013,B.C.S.,"MULEGÉ, B.C.S.",1,0,1,0,0,0,
17/06/2013,B.C.,"TIJUANA, B.C.",1,0,1,0,0,0,
18/06/2013,MEX.,"NAUCALPAN DE JUAREZ, MEX.",3,4,7,5,0,92,
18/06/2013,COAH.,"TORREÓN, COAH.",6,1,7,0,0,0,
18/06/2013,NAY.,"RUIZ, NAY.",4,1,5,0,0,0,
18/06/2013,B.C.,"TIJUANA, B.C.",2,3,5,0,0,0,
18/06/2013,B.C.,"TIJUANA, B.C.",2,1,3,0,0,0,
18/06/2013,SIN.,"BADIRAGUATO, SIN.",0,2,2,0,0,0,
18/06/2013,CHIH.,"BUENAVENTURA, CHIH.",0,1,1,0,0,0,
18/06/2013,SIN.,"BADIRAGUATO, SIN.",0,1,1,0,0,0,
18/06/2013,COAH.,"CUATROCIÉNEGAS, COAH.",0,1,1,0,0,0,
18/06/2013,TAB.,"CENTRO, TAB.",0,0,0,0,2,29,
19/06/2013,MEX.,"NAUCALPAN DE JUAREZ, MEX.",11,5,16,6,1,257,
19/06/2013,NAY.,"RUIZ, NAY.",5,0,5,0,0,0,
19/06/2013,TAMPS.,"VICTORIA, TAMPS.",5,0,5,0,0,0,
19/06/2013,CHIH.,"AHUMADA, CHIH.",3,0,3,0,0,0,
19/06/2013,COAH.,"TORREÓN, COAH.",0,2,2,0,0,0,
19/06/2013,B.C.,"TIJUANA, B.C.",1,1,2,0,0,0,
19/06/2013,TAB.,"CENTRO, TAB.",1,0,1,1,0,49,
19/06/2013,CAMP.,"CARMEN, CAMP.",1,0,1,0,0,0,
20/06/2013,MEX.,"NAUCALPAN DE JUAREZ, MEX.",5,6,11,2,0,426,
20/06/2013,TAMPS.,"EL MANTE, TAMPS.",11,0,11,0,0,0,
20/06/2013,B.C.,"TIJUANA, B.C.",4,3,7,0,0,0,
20/06/2013,B.C.,"MEXICALI, B.C.",5,2,7,0,0,0,
20/06/2013,COAH.,"TORREÓN, COAH.",6,1,7,0,0,0,
20/06/2013,COAH.,"ACUÑA, COAH.",5,1,6,0,0,0,
20/06/2013,SIN.,"BADIRAGUATO, SIN.",4,1,5,0,0,0,
20/06/2013,COAH.,"LAMADRID, COAH.",3,2,5,0,0,79,
20/06/2013,NAY.,"RUIZ, NAY.",4,0,4,0,0,0,
20/06/2013,B.C.,"ENSENADA, B.C.",1,2,3,0,0,0,
20/06/2013,TAB.,"TENOSIQUE, TAB.",1,0,1,0,0,0,
21/06/2013,MEX.,"NAUCALPAN DE JUAREZ, MEX.",7,5,12,3,0,300,
21/06/2013,SIN.,"BADIRAGUATO, SIN.",5,0,5,2,0,0,
21/06/2013,B.C.,"TIJUANA, B.C.",3,1,4,0,0,0,
21/06/2013,NAY.,"RUIZ, NAY.",3,1,4,0,0,0,
21/06/2013,B.C.S.,"LA PAZ, B.C.S.",0,2,2,0,0,0,
21/06/2013,B.C.S.,"LOS CABOS, B.C.S.",1,0,1,0,0,0,
21/06/2013,TAB.,"COMALCALCO, TAB.",0,0,0,0,2,0,
22/06/2013,COAH.,"TORREÓN, COAH.",6,5,11,0,0,0,
22/06/2013,MEX.,"NAUCALPAN DE JUAREZ, MEX.",5,3,8,1,0,136,
22/06/2013,NAY.,"RUIZ, NAY.",3,1,4,0,0,0,
22/06/2013,CHIS.,"CHICOMUSELO, CHIS.",2,1,3,0,0,0,
22/06/2013,TAMPS.,"REYNOSA, TAMPS.",2,1,3,0,0,0,
22/06/2013,GRO.,"ATENANGO DEL RIO, GRO.",1,1,2,0,0,0,
22/06/2013,CHIH.,"CHIH., CHIH.",2,0,2,0,0,8,
22/06/2013,B.C.S.,"MULEGÉ, B.C.S.",0,2,2,0,0,0,
22/06/2013,TAMPS.,"GONZALEZ, TAMPS.",2,0,2,0,0,23,
22/06/2013,CHIS.,"YAJALÓN, CHIS.",0,1,1,0,0,0,
22/06/2013,B.C.S.,"LA PAZ, B.C.S.",0,1,1,0,0,0,
22/06/2013,B.C.S.,"LOS CABOS, B.C.S.",1,0,1,0,0,160,
22/06/2013,TAB.,"JONUTA, TAB.",0,1,1,0,0,0,
22/06/2013,TAB.,"JONUTA, TAB.",0,1,1,0,0,0,
23/06/2013,MEX.,"NAUCALPAN DE JUAREZ, MEX.",12,0,12,4,6,499,
23/06/2013,JAL.,"PUERTO VALLARTA, JAL.",5,0,5,1,0,4,
23/06/2013,B.C.S.,"LOS CABOS, B.C.S.",0,2,2,0,0,0,
23/06/2013,TAB.,"BALANCAN, TAB.",2,0,2,0,0,0,
23/06/2013,B.C.S.,"LA PAZ, B.C.S.",1,0,1,0,0,0,
23/06/2013,GRO.,"ATENANGO DEL RIO, GRO.",1,0,1,0,0,0,
24/06/2013,MEX.,"NAUCALPAN DE JUAREZ, MEX.",12,1,13,2,0,286,
24/06/2013,GTO.,"LEON, GTO.",8,3,11,0,0,0,
24/06/2013,PUE.,"PUE., PUE.",6,2,8,0,3,160,
24/06/2013,B.C.,"TIJUANA, B.C.",5,1,6,0,0,0,
24/06/2013,B.C.,"MEXICALI, B.C.",3,3,6,0,0,0,
24/06/2013,B.C.,"TIJUANA, B.C.",5,1,6,0,0,0,
24/06/2013,B.C.,"MEXICALI, B.C.",3,3,6,0,0,0,
24/06/2013,COAH.,"TORREÓN, COAH.",2,3,5,0,3,0,
24/06/2013,CHIS.,"CHICOMUSELO, CHIS.",2,2,4,0,0,0,
24/06/2013,CHIS.,"CHICOMUSELO, CHIS.",2,2,4,0,0,0,
24/06/2013,NAY.,"RUIZ, NAY.",1,1,2,0,0,0,
24/06/2013,PUE.,"TEHUACAN, PUE.",2,0,2,0,0,0,
24/06/2013,NAY.,"JALA, NAY.",0,1,1,0,0,0,
24/06/2013,VER.,"TUXPAM, VER.",0,1,1,0,0,0,
24/06/2013,PUE.,"HUAUCHINANGO, PUE.",1,0,1,0,0,0,
24/06/2013,TAB.,"COMALCALCO, TAB.",0,0,0,0,0,45,
24/06/2013,TAB.,"COMALCALCO, TAB.",0,0,0,0,0,45,
25/06/2013,PUE.,"PUE., PUE.",33,8,41,7,10,2100,
25/06/2013,GTO.,"LEON, GTO.",16,2,18,0,0,0,
25/06/2013,PUE.,"TEHUACAN, PUE.",11,5,16,1,0,210,
25/06/2013,MEX.,"NAUCALPAN DE JUAREZ, MEX.",9,6,15,2,0,110,
25/06/2013,B.C.,"MEXICALI, B.C.",3,5,8,0,0,0,
25/06/2013,COAH.,"TORREÓN, COAH.",1,5,6,0,0,0,
25/06/2013,B.C.,"TIJUANA, B.C.",0,5,5,0,0,0,
25/06/2013,NAY.,"RUIZ, NAY.",3,1,4,0,0,0,
25/06/2013,CHIS.,"CHICOMUSELO, CHIS.",2,1,3,0,0,0,
25/06/2013,COAH.,"SACRAMENTO, COAH.",1,1,2,0,0,0,
25/06/2013,TAB.,"BALANCAN, TAB.",1,0,1,0,0,0,
25/06/2013,PUE.,"HUAUCHINANGO, PUE.",1,0,1,0,0,0,
25/06/2013,NAY.,"JALA, NAY.",0,1,1,0,0,0,
26/06/2013,PUE.,"PUE., PUE.",27,2,29,21,2,1597,
26/06/2013,MEX.,"NAUCALPAN DE JUAREZ, MEX.",6,11,17,7,0,109,
26/06/2013,PUE.,"TEHUACAN, PUE.",6,4,10,7,0,220,
26/06/2013,COAH.,"TORREÓN, COAH.",4,1,5,0,0,0,
26/06/2013,COAH.,"NADADORES, COAH.",4,1,5,0,0,72,
26/06/2013,B.C.,"ENSENADA, B.C.",0,4,4,0,0,0,
26/06/2013,B.C.,"TIJUANA, B.C.",0,2,2,0,0,0,
26/06/2013,PUE.,"HUAUCHINANGO, PUE.",1,0,1,0,0,150,
26/06/2013,SIN.,"BADIRAGUATO, SIN.",0,1,1,0,0,0,
26/06/2013,COAH.,"MÚZQUIZ, COAH.",0,1,1,0,0,5,
26/06/2013,NAY.,"JALA, NAY.",1,0,1,0,0,0,
27/06/2013,GTO.,"LEON, GTO.",8,19,27,0,0,0,
27/06/2013,GTO.,"LEON, GTO.",20,5,25,0,0,0,
27/06/2013,PUE.,"PUE., PUE.",13,4,17,4,4,1472,
27/06/2013,GTO.,"GTO., GTO.",1,12,13,0,0,0,
27/06/2013,PUE.,"TEHUACAN, PUE.",7,4,11,0,0,0,
27/06/2013,MEX.,"NAUCALPAN DE JUAREZ, MEX.",6,5,11,3,0,79,
27/06/2013,B.C.S.,"LA PAZ, B.C.S.",5,4,9,0,0,0,
27/06/2013,TAMPS.,"VICTORIA, TAMPS.",3,5,8,0,0,300,
27/06/2013,TAMPS.,"VICTORIA, TAMPS.",4,3,7,0,4,546,
27/06/2013,COAH.,"MÚZQUIZ, COAH.",5,1,6,0,0,18,
27/06/2013,B.C.,"TIJUANA, B.C.",3,2,5,0,0,0,
27/06/2013,SIN.,"BADIRAGUATO, SIN.",1,3,4,0,0,0,
27/06/2013,GTO.,"GTO., GTO.",3,1,4,0,0,40,
27/06/2013,B.C.,"ENSENADA, B.C.",1,2,3,0,0,0,
27/06/2013,B.C.,"MEXICALI, B.C.",0,3,3,0,0,0,
27/06/2013,COAH.,"SAN BUENAVENTURA, COAH.",1,2,3,0,0,0,
27/06/2013,S.L.P.,"SAN LUIS POTOSI, S.L.P.",0,3,3,0,0,0,
27/06/2013,PUE.,"HUAUCHINANGO, PUE.",1,1,2,0,0,50,
27/06/2013,TAB.,"BALANCAN, TAB.",2,0,2,0,0,0,
27/06/2013,CHIS.,"CHICOMUSELO, CHIS.",1,1,2,0,0,0,
27/06/2013,COAH.,"TORREÓN, COAH.",1,0,1,0,0,0,
27/06/2013,TAB.,"COMALCALCO, TAB.",0,1,1,0,5,0,
27/06/2013,GRO.,"BENITO JUAREZ, GRO.",0,1,1,0,0,0,
27/06/2013,NAY.,"RUIZ, NAY.",1,0,1,0,0,0,
28/06/2013,GTO.,"GTO., GTO.",18,3,21,0,0,269,
28/06/2013,MEX.,"NAUCALPAN DE JUAREZ, MEX.",13,6,19,8,0,1252,
28/06/2013,GTO.,"LEON, GTO.",11,6,17,0,0,850,
28/06/2013,PUE.,"PUE., PUE.",9,5,14,2,2,3026,
28/06/2013,PUE.,"TEHUACAN, PUE.",4,1,5,0,0,0,
28/06/2013,NAY.,"RUIZ, NAY.",3,0,3,0,0,0,
28/06/2013,CHIS.,"CHICOMUSELO, CHIS.",1,1,2,0,0,0,
28/06/2013,PUE.,"HUAUCHINANGO, PUE.",2,0,2,0,0,0,
28/06/2013,SIN.,"BADIRAGUATO, SIN.",0,1,1,0,0,0,
28/06/2013,COAH.,"TORREÓN, COAH.",1,0,1,0,4,0,
28/06/2013,OAX.,"CIUDAD IXTEPEC, OAX.",1,0,1,1,0,0,
28/06/2013,COL.,"MANZANILLO, COL.",1,0,1,0,1,0,
29/06/2013,MEX.,"NAUCALPAN DE JUAREZ, MEX.",9,2,11,2,0,74,
29/06/2013,JAL.,"AUTLAN DE NAVARRO, JAL.",2,1,3,0,0,0,
29/06/2013,B.C.S.,"LA PAZ, B.C.S.",1,2,3,0,0,0,
29/06/2013,CHIS.,"YAJALÓN, CHIS.",0,2,2,0,0,0,
29/06/2013,B.C.S.,"MULEGÉ, B.C.S.",2,0,2,0,0,0,
29/06/2013,B.C.,"TIJUANA, B.C.",2,0,2,0,0,0,
29/06/2013,NAY.,"RUIZ, NAY.",1,0,1,0,0,0,
29/06/2013,COAH.,"ALLENDE, COAH.",1,0,1,0,0,0,
30/06/2013,GTO.,"GTO., GTO.",20,4,24,0,0,74,
30/06/2013,GTO.,"GTO., GTO.",13,3,16,0,0,40,
30/06/2013,MEX.,"NAUCALPAN DE JUAREZ, MEX.",2,3,5,3,1,174,
30/06/2013,JAL.,"AUTLAN DE NAVARRO, JAL.",2,0,2,0,0,0,
30/06/2013,B.C.S.,"LA PAZ, B.C.S.",1,1,2,0,0,0,
30/06/2013,TAMPS.,"GONZALEZ, TAMPS.",1,0,1,1,0,8,
30/06/2013,TAMPS.,"EL MANTE, TAMPS.",0,1,1,0,0,0,
01/07/2013,GTO.,"LEON, GTO.",8,10,18,0,0,48,
01/07/2013,CHIS.,"TAPACHULA, CHIS.",5,3,8,0,0,78,
01/07/2013,PUE.,"PUE., PUE.",3,3,6,2,12,2176,
01/07/2013,MOR.,"CUERNAVACA, MOR.",4,2,6,3,0,30,
01/07/2013,CHIS.,"CHICOMUSELO, CHIS.",3,2,5,0,0,0,
01/07/2013,MEX.,"NAUCALPAN DE JUAREZ, MEX.",4,1,5,5,2,3,
01/07/2013,NAY.,"HUAJICORI, NAY.",2,0,2,0,0,0,
01/07/2013,PUE.,"TEHUACAN, PUE.",0,1,1,0,2,0,
01/07/2013,TAB.,"COMALCALCO, TAB.",1,0,1,1,0,0,
01/07/2013,CHIS.,"MOTOZINTLA, CHIS.",1,0,1,0,0,0,
01/07/2013,CHIS.,"TONALÁ, CHIS.",0,1,1,0,0,0,
01/07/2013,CHIS.,"CINTALAPA, CHIS.",0,1,1,0,0,30,
01/07/2013,CHIS.,"METAPA, CHIS.",0,0,0,0,1,0,
02/07/2013,GTO.,"LEON, GTO.",7,11,18,0,0,85,
02/07/2013,PUE.,"PUE., PUE.",5,5,10,4,1,172,
02/07/2013,CHIS.,"TAPACHULA, CHIS.",4,4,8,0,0,10,
02/07/2013,MEX.,"NAUCALPAN DE JUAREZ, MEX.",6,1,7,2,1,504,
02/07/2013,MOR.,"CUERNAVACA, MOR.",3,1,4,0,0,241,
02/07/2013,CHIS.,"TONALÁ, CHIS.",2,1,3,0,0,16,
02/07/2013,TAMPS.,"VICTORIA, TAMPS.",0,3,3,0,0,0,
02/07/2013,PUE.,"XICOTEPEC, PUE.",2,0,2,0,0,50,
02/07/2013,COAH.,"ACUÑA, COAH.",0,1,1,1,0,0,
02/07/2013,TAB.,"BALANCAN, TAB.",1,0,1,0,0,0,
02/07/2013,SIN.,"NAVOLATO, SIN.",1,0,1,1,0,0,
02/07/2013,CHIS.,"MOTOZINTLA, CHIS.",1,0,1,0,0,0,
02/07/2013,CHIS.,"CINTALAPA, CHIS.",0,1,1,0,0,0,
02/07/2013,TAMPS.,"EL MANTE, TAMPS.",1,0,1,0,0,0,
02/07/2013,PUE.,"TEHUACAN, PUE.",0,1,1,0,0,150,
03/07/2013,GTO.,"LEON, GTO.",10,8,18,8,0,174,
03/07/2013,MEX.,"NAUCALPAN DE JUAREZ, MEX.",5,5,10,0,2,294,
03/07/2013,PUE.,"PUE., PUE.",6,3,9,0,1,1727,
03/07/2013,CHIS.,"TONALÁ, CHIS.",2,5,7,0,0,0,
03/07/2013,MOR.,"CUERNAVACA, MOR.",4,2,6,0,1,0,
03/07/2013,CHIS.,"TAPACHULA, CHIS.",2,4,6,2,1,239,
03/07/2013,B.C.,"TIJUANA, B.C.",3,2,5,0,0,0,
03/07/2013,CHIS.,"TUXTLA GUTIÉRREZ, CHIS.",3,1,4,1,0,151,
03/07/2013,PUE.,"TEHUACAN, PUE.",1,2,3,0,0,0,
03/07/2013,NAY.,"IXTLAN DEL RIO, NAY.",2,1,3,0,0,0,
03/07/2013,B.C.,"ENSENADA, B.C.",0,2,2,0,0,0,
03/07/2013,SIN.,"NAVOLATO, SIN.",1,1,2,0,2,0,
03/07/2013,OAX.,"CIUDAD IXTEPEC, OAX.",0,1,1,0,0,0,
03/07/2013,TAB.,"COMALCALCO, TAB.",1,0,1,0,0,0,
03/07/2013,TAB.,"CENTRO, TAB.",0,1,1,0,0,0,
03/07/2013,COAH.,"TORREÓN, COAH.",1,0,1,0,0,0,
03/07/2013,COAH.,"MÚZQUIZ, COAH.",1,0,1,0,0,60,
03/07/2013,NAY.,"HUAJICORI, NAY.",1,0,1,0,0,0,
03/07/2013,PUE.,"XICOTEPEC, PUE.",0,0,0,0,0,150,
04/07/2013,GTO.,"LEON, GTO.",17,9,26,0,1,156,
04/07/2013,CHIS.,"TAPACHULA, CHIS.",19,3,22,0,0,97,
04/07/2013,MOR.,"CUERNAVACA, MOR.",5,4,9,2,1,112,
04/07/2013,PUE.,"PUE., PUE.",6,3,9,0,1,1358,
04/07/2013,SIN.,"NAVOLATO, SIN.",7,0,7,1,0,0,
04/07/2013,MEX.,"NAUCALPAN DE JUAREZ, MEX.",4,2,6,0,0,38,
04/07/2013,CHIS.,"TONALÁ, CHIS.",0,2,2,1,0,0,
04/07/2013,CHIS.,"LA INDEPENDENCIA, CHIS.",0,1,1,0,0,0,
04/07/2013,CHIS.,"CHICOMUSELO, CHIS.",1,0,1,0,0,0,
04/07/2013,PUE.,"XICOTEPEC, PUE.",0,1,1,0,0,0,
04/07/2013,OAX.,"MIAHUATLAN DE PORFIRIO DIAZ, OAX.",0,0,0,0,0,719,
04/07/2013,COAH.,"MÚZQUIZ, COAH.",0,0,0,0,0,50,
04/07/2013,CHIS.,"CINTALAPA, CHIS.",0,0,0,1,0,10,
05/07/2013,GTO.,"LEON, GTO.",5,7,12,0,0,0,
05/07/2013,MOR.,"CUERNAVACA, MOR.",5,4,9,1,0,154,
05/07/2013,MEX.,"NAUCALPAN DE JUAREZ, MEX.",3,3,6,4,1,60,
05/07/2013,SIN.,"NAVOLATO, SIN.",3,2,5,0,0,0,
05/07/2013,COAH.,"TORREÓN, COAH.",3,1,4,0,0,0,
05/07/2013,PUE.,"PUE., PUE.",3,0,3,56,2,2486,
05/07/2013,PUE.,"XICOTEPEC, PUE.",2,1,3,0,0,0,
05/07/2013,CHIS.,"CHICOMUSELO, CHIS.",1,2,3,0,0,0,
05/07/2013,CHIS.,"TONALÁ, CHIS.",2,1,3,1,0,41,
05/07/2013,CHIS.,"CINTALAPA, CHIS.",1,2,3,1,0,115,
05/07/2013,NAY.,"HUAJICORI, NAY.",2,0,2,0,0,0,
05/07/2013,NAY.,"IXTLAN DEL RIO, NAY.",1,0,1,1,0,0,
05/07/2013,TAB.,"CENTRO, TAB.",1,0,1,0,0,0,
05/07/2013,COAH.,"TORREÓN, COAH.",1,0,1,0,0,0,
05/07/2013,PUE.,"TEHUACAN, PUE.",1,0,1,0,0,0,
06/07/2013,CHIS.,"TAPACHULA, CHIS.",7,4,11,0,0,85,
06/07/2013,MEX.,"NAUCALPAN DE JUAREZ, MEX.",6,1,7,10,0,707,
06/07/2013,CHIS.,"TAPACHULA, CHIS.",4,0,4,0,0,0,
06/07/2013,MOR.,"CUERNAVACA, MOR.",1,2,3,0,0,55,
06/07/2013,NAY.,"HUAJICORI, NAY.",2,1,3,0,0,0,
06/07/2013,JAL.,"CIHUATLAN, JAL.",0,2,2,0,0,24,
06/07/2013,CHIS.,"TONALÁ, CHIS.",2,0,2,0,0,0,
07/07/2013,MOR.,"CUERNAVACA, MOR.",6,1,7,0,0,74,
07/07/2013,MEX.,"NAUCALPAN DE JUAREZ, MEX.",4,2,6,2,0,0,
07/07/2013,B.C.,"MEXICALI, B.C.",0,1,1,0,0,0,
07/07/2013,JAL.,"CIHUATLAN, JAL.",0,0,0,0,2,0,
08/07/2013,MEX.,"NAUCALPAN DE JUAREZ, MEX.",2,3,5,0,0,0,
08/07/2013,PUE.,"PUE., PUE.",2,2,4,14,9,750,
08/07/2013,MOR.,"CUERNAVACA, MOR.",2,1,3,0,4,0,
08/07/2013,B.C.,"TIJUANA, B.C.",1,2,3,0,0,0,
08/07/2013,COAH.,"TORREÓN, COAH.",2,1,3,0,0,0,
08/07/2013,TAB.,"TEAPA, TAB.",2,0,2,1,0,0,
08/07/2013,PUE.,"TEHUACAN, PUE.",2,0,2,0,0,50,
08/07/2013,SIN.,"NAVOLATO, SIN.",1,0,1,0,0,0,
08/07/2013,PUE.,"CAÑADA MOR., PUE.",1,0,1,0,0,0,
08/07/2013,TAB.,"JONUTA, TAB.",1,0,1,0,0,0,
09/07/2013,SIN.,"NAVOLATO, SIN.",6,3,9,0,1,0,
09/07/2013,N.L.,"APODACA, N.L.",5,3,8,3,0,4320,
09/07/2013,MOR.,"CUERNAVACA, MOR.",5,2,7,0,4,386,
09/07/2013,MEX.,"NAUCALPAN DE JUAREZ, MEX.",3,4,7,0,0,0,
09/07/2013,B.C.,"MEXICALI, B.C.",1,3,4,0,0,0,
09/07/2013,B.C.,"TIJUANA, B.C.",1,2,3,0,0,0,
09/07/2013,CHIS.,"CINTALAPA, CHIS.",1,1,2,0,0,0,
09/07/2013,PUE.,"TEHUACAN, PUE.",2,0,2,0,0,0,
09/07/2013,B.C.,"ENSENADA, B.C.",0,2,2,0,0,0,
09/07/2013,N.L.,"JUAREZ, N.L.",0,2,2,0,0,0,
09/07/2013,PUE.,"PUE., PUE.",1,0,1,0,0,633,
09/07/2013,COAH.,"TORREÓN, COAH.",1,0,1,0,0,0,
09/07/2013,TAMPS.,"EL MANTE, TAMPS.",0,1,1,0,0,0,
10/07/2013,MEX.,"NAUCALPAN DE JUAREZ, MEX.",2,34,36,2,0,62,
10/07/2013,MOR.,"CUERNAVACA, MOR.",11,2,13,0,1,86,
10/07/2013,N.L.,"APODACA, N.L.",5,2,7,8,0,1437,
10/07/2013,B.C.,"MEXICALI, B.C.",1,5,6,0,0,0,
10/07/2013,TAB.,"BALANCAN, TAB.",1,2,3,0,0,0,
10/07/2013,PUE.,"PUE., PUE.",1,2,3,0,3,521,
10/07/2013,B.C.,"TIJUANA, B.C.",2,1,3,0,0,0,
10/07/2013,SIN.,"NAVOLATO, SIN.",2,0,2,0,0,0,
10/07/2013,GRO.,"CHILPANCINGO DE LOS BRAVO, GRO.",0,1,1,0,0,0,
10/07/2013,TAB.,"TEAPA, TAB.",1,0,1,1,0,0,
10/07/2013,PUE.,"TECAMACHALCO, PUE.",0,1,1,0,1,0,
10/07/2013,PUE.,"HUITZILAN DE SERDAN, PUE.",1,0,1,0,0,0,
10/07/2013,B.C.S.,"MULEGÉ, B.C.S.",0,1,1,0,0,0,
10/07/2013,NAY.,"AMATLAN DE CAÑAS, NAY.",1,0,1,0,0,0,
10/07/2013,B.C.,"ENSENADA, B.C.",1,0,1,0,0,0,
10/07/2013,DGO.,"SANTIAGO PAPASQUIARO, DGO.",1,0,1,0,0,0,
10/07/2013,CHIS.,"CINTALAPA, CHIS.",0,0,0,0,0,32,
11/07/2013,N.L.,"APODACA, N.L.",13,3,16,3,0,9723,
11/07/2013,B.C.,"MEXICALI, B.C.",4,5,9,0,0,0,
11/07/2013,MOR.,"CUERNAVACA, MOR.",7,1,8,0,1,281,
11/07/2013,GRO.,"CHILPANCINGO DE LOS BRAVO, GRO.",3,3,6,0,1,140,
11/07/2013,CHIS.,"MAZATÁN, CHIS.",1,4,5,0,0,0,
11/07/2013,PUE.,"PUE., PUE.",3,1,4,3,0,881,
11/07/2013,MEX.,"NAUCALPAN DE JUAREZ, MEX.",0,3,3,0,0,150,
11/07/2013,COAH.,"SALTILLO, COAH.",1,2,3,0,0,0,
11/07/2013,PUE.,"TECAMACHALCO, PUE.",0,2,2,0,0,0,
11/07/2013,CHIS.,"HUEHUETÁN, CHIS.",2,0,2,0,0,0,
11/07/2013,CHIS.,"JIQUIPILAS, CHIS.",1,1,2,0,0,0,
11/07/2013,B.C.,"ENSENADA, B.C.",1,1,2,0,0,0,
11/07/2013,SIN.,"NAVOLATO, SIN.",0,1,1,0,4,0,
11/07/2013,TAB.,"TEAPA, TAB.",1,0,1,0,0,0,
11/07/2013,B.C.,"TIJUANA, B.C.",0,1,1,0,0,0,
12/07/2013,MEX.,"NAUCALPAN DE JUAREZ, MEX.",3,5,8,0,0,0,
12/07/2013,GRO.,"CHILPANCINGO DE LOS BRAVO, GRO.",3,4,7,0,5,45,
12/07/2013,MOR.,"CUERNAVACA, MOR.",5,1,6,0,0,153,
12/07/2013,N.L.,"APODACA, N.L.",2,2,4,6,0,8212,
12/07/2013,PUE.,"CHALCHICOMULA DE SESMA, PUE.",3,1,4,0,0,0,
12/07/2013,PUE.,"PUE., PUE.",3,0,3,0,3,766,
12/07/2013,SIN.,"NAVOLATO, SIN.",2,0,2,0,6,0,
12/07/2013,CHIS.,"LA TRINITARIA, CHIS.",0,1,1,0,0,0,
12/07/2013,VER.,"JUAN RODRIGUEZ CLARA, VER.",1,0,1,0,0,0,
12/07/2013,CHIH.,"GÓMEZ FARÍAS, CHIH.",0,1,1,0,0,0,
12/07/2013,CHIH.,"ALDAMA, CHIH.",0,1,1,0,0,0,
12/07/2013,B.C.,"TIJUANA, B.C.",1,0,1,0,0,0,
12/07/2013,B.C.,"ENSENADA, B.C.",1,0,1,0,0,0,
12/07/2013,COAH.,"ACUÑA, COAH.",0,1,1,0,0,0,
12/07/2013,PUE.,"TECAMACHALCO, PUE.",1,0,1,0,0,0,
12/07/2013,N.L.,"JUAREZ, N.L.",0,0,0,5,0,0,
12/07/2013,B.C.,"MEXICALI, B.C.",0,0,0,0,0,0,
13/07/2013,B.C.,"TIJUANA, B.C.",3,8,11,0,0,0,
13/07/2013,N.L.,"APODACA, N.L.",4,5,9,9,0,24442,
13/07/2013,GRO.,"CHILPANCINGO DE LOS BRAVO, GRO.",3,4,7,4,7,437,
13/07/2013,MEX.,"NAUCALPAN DE JUAREZ, MEX.",1,4,5,0,1,0,
13/07/2013,MOR.,"CUERNAVACA, MOR.",3,2,5,0,1,360,
13/07/2013,B.C.S.,"LA PAZ, B.C.S.",1,3,4,0,0,0,
13/07/2013,CHIS.,"HUEHUETÁN, CHIS.",0,2,2,0,0,0,
13/07/2013,NAY.,"AMATLAN DE CAÑAS, NAY.",1,0,1,0,0,0,
13/07/2013,CHIS.,"MAZATÁN, CHIS.",0,1,1,0,0,0,
13/07/2013,TAMPS.,"EL MANTE, TAMPS.",0,1,1,1,0,208,
13/07/2013,N.L.,"JUAREZ, N.L.",0,1,1,0,0,0,
13/07/2013,PUE.,"ZARAGOZA, PUE.",0,0,0,0,0,40,
14/07/2013,N.L.,"APODACA, N.L.",8,5,13,13,0,1757,
14/07/2013,GRO.,"CHILPANCINGO DE LOS BRAVO, GRO.",4,4,8,0,6,30,
14/07/2013,MEX.,"NAUCALPAN DE JUAREZ, MEX.",2,3,5,0,0,0,
14/07/2013,CHIS.,"MAZATÁN, CHIS.",2,2,4,1,0,0,
14/07/2013,JAL.,"CIHUATLAN, JAL.",1,2,3,0,0,5,
14/07/2013,TAB.,"BALANCAN, TAB.",1,1,2,0,0,0,
14/07/2013,CHIS.,"HUEHUETÁN, CHIS.",1,0,1,0,0,0,
14/07/2013,MOR.,"CUERNAVACA, MOR.",1,0,1,0,0,301,
14/07/2013,B.C.S.,"COMONDÚ, B.C.S.",0,1,1,0,0,0,
14/07/2013,N.L.,"JUAREZ, N.L.",0,0,0,0,0,300,
15/07/2013,D.F.,"GUSTAVO A. MADERO, D.F.",17,2,19,0,1,150,
15/07/2013,N.L.,"APODACA, N.L.",9,7,16,15,0,787,
15/07/2013,PUE.,"PUE., PUE.",1,6,7,0,0,760,
15/07/2013,MOR.,"CUERNAVACA, MOR.",2,3,5,0,1,20,
15/07/2013,COAH.,"TORREÓN, COAH.",2,0,2,0,0,0,
15/07/2013,B.C.,"TIJUANA, B.C.",1,1,2,0,0,0,
15/07/2013,CHIS.,"OCOSINGO, CHIS.",0,1,1,0,0,0,
15/07/2013,N.L.,"JUAREZ, N.L.",1,0,1,0,0,0,
15/07/2013,CHIS.,"JIQUIPILAS, CHIS.",1,0,1,0,0,0,
15/07/2013,TAMPS.,"REYNOSA, TAMPS.",1,0,1,1,0,27,
15/07/2013,PUE.,"HUITZILAN DE SERDAN, PUE.",0,0,0,0,1,0,
16/07/2013,D.F.,"GUSTAVO A. MADERO, D.F.",45,13,58,0,1,400,
16/07/2013,PUE.,"PUE., PUE.",8,4,12,2,1,0,
16/07/2013,MOR.,"CUERNAVACA, MOR.",4,5,9,0,8,74,
16/07/2013,B.C.,"TECATE, B.C.",5,0,5,0,0,0,
16/07/2013,N.L.,"APODACA, N.L.",2,3,5,0,0,483,
16/07/2013,B.C.,"MEXICALI, B.C.",3,1,4,0,0,0,
16/07/2013,CHIH.,"MADERA, CHIH.",1,1,2,9,0,0,
16/07/2013,COAH.,"TORREÓN, COAH.",2,0,2,0,0,0,
16/07/2013,B.C.,"TIJUANA, B.C.",0,1,1,0,0,0,
16/07/2013,N.L.,"JUAREZ, N.L.",0,1,1,5,0,0,
16/07/2013,B.C.S.,"MULEGÉ, B.C.S.",0,1,1,0,0,0,
16/07/2013,QRO.,"QUERETARO, QRO.",0,1,1,0,0,0,
16/07/2013,PUE.,"CHALCHICOMULA DE SESMA, PUE.",1,0,1,2,0,0,
17/07/2013,D.F.,"GUSTAVO A. MADERO, D.F.",52,15,67,0,1,840,
17/07/2013,MOR.,"CUERNAVACA, MOR.",6,4,10,0,2,107,
17/07/2013,PUE.,"PUE., PUE.",1,6,7,0,2,555,
17/07/2013,B.C.,"TECATE, B.C.",1,5,6,0,0,0,
17/07/2013,NAY.,"AHUACATLAN, NAY.",1,1,2,0,0,0,
17/07/2013,TAB.,"TEAPA, TAB.",1,1,2,2,0,7,
17/07/2013,COAH.,"TORREÓN, COAH.",2,0,2,0,0,0,
17/07/2013,PUE.,"HUITZILAN DE SERDAN, PUE.",0,2,2,3,0,100,
17/07/2013,N.L.,"APODACA, N.L.",1,0,1,0,0,100,
17/07/2013,TAB.,"COMALCALCO, TAB.",1,0,1,0,0,0,
17/07/2013,PUE.,"TECAMACHALCO, PUE.",1,0,1,0,0,0,
17/07/2013,VER.,"OTATITLAN, VER.",1,0,1,0,0,0,
17/07/2013,CHIH.,"MADERA, CHIH.",1,0,1,0,0,0,
17/07/2013,CHIS.,"LA TRINITARIA, CHIS.",0,0,0,0,0,50,
18/07/2013,D.F.,"GUSTAVO A. MADERO, D.F.",54,18,72,0,7,430,
18/07/2013,MOR.,"CUERNAVACA, MOR.",7,1,8,0,0,127,
18/07/2013,B.C.,"TECATE, B.C.",0,5,5,0,0,0,
18/07/2013,COAH.,"TORREÓN, COAH.",3,2,5,0,0,0,
18/07/2013,CHIS.,"ESCUINTLA, CHIS.",2,1,3,2,0,0,
18/07/2013,B.C.,"TIJUANA, B.C.",1,2,3,0,0,0,
18/07/2013,PUE.,"TECAMACHALCO, PUE.",3,0,3,0,0,0,
18/07/2013,PUE.,"HUITZILAN DE SERDAN, PUE.",1,2,3,0,0,0,
18/07/2013,NAY.,"AHUACATLAN, NAY.",0,3,3,0,0,0,
18/07/2013,TAMPS.,"NUEVO LAREDO, TAMPS.",0,3,3,0,0,131,
18/07/2013,CHIS.,"JIQUIPILAS, CHIS.",1,1,2,0,0,0,
18/07/2013,PUE.,"PUE., PUE.",2,0,2,5,1,255,
18/07/2013,QRO.,"QUERETARO, QRO.",2,0,2,0,1,0,
18/07/2013,QRO.,"CORREGIDORA, QRO.",2,0,2,0,1,0,
18/07/2013,TAB.,"COMALCALCO, TAB.",1,0,1,0,0,0,
18/07/2013,N.L.,"JUAREZ, N.L.",0,1,1,3,0,0,
18/07/2013,TAB.,"BALANCAN, TAB.",1,0,1,0,0,0,
18/07/2013,VER.,"COATZACOALCOS, VER.",1,0,1,0,0,0,
18/07/2013,TAMPS.,"EL MANTE, TAMPS.",0,1,1,0,0,136,
18/07/2013,B.C.S.,"MULEGÉ, B.C.S.",0,1,1,0,0,0,
18/07/2013,TAMPS.,"EL MANTE, TAMPS.",1,0,1,0,0,0,
18/07/2013,N.L.,"APODACA, N.L.",0,0,0,2,0,0,
19/07/2013,D.F.,"GUSTAVO A. MADERO, D.F.",39,8,47,0,10,724,
19/07/2013,N.L.,"MONTERREY, N.L.",19,7,26,6,0,913,
19/07/2013,MOR.,"CUERNAVACA, MOR.",7,2,9,0,1,459,
19/07/2013,B.C.,"TIJUANA, B.C.",1,5,6,0,0,0,
19/07/2013,CHIH.,"MADERA, CHIH.",1,4,5,7,0,0,
19/07/2013,CHIS.,"ESCUINTLA, CHIS.",4,1,5,3,0,0,
19/07/2013,B.C.,"TECATE, B.C.",0,4,4,0,0,0,
19/07/2013,PUE.,"PUE., PUE.",2,2,4,1,0,121,
19/07/2013,NAY.,"AHUACATLAN, NAY.",3,1,4,1,0,11,
19/07/2013,QRO.,"QUERETARO, QRO.",4,0,4,0,0,0,
19/07/2013,TAMPS.,"REYNOSA, TAMPS.",2,1,3,1,0,60,
19/07/2013,PUE.,"LOS REYES DE JUAREZ, PUE.",1,1,2,0,0,0,
19/07/2013,COAH.,"TORREÓN, COAH.",1,1,2,0,0,0,
19/07/2013,VER.,"MINATITLAN, VER.",1,0,1,0,0,32,
19/07/2013,COAH.,"TORREÓN, COAH.",1,0,1,0,0,0,
19/07/2013,PUE.,"SAN MARTIN TEXMELUCAN, PUE.",1,0,1,0,0,900,
19/07/2013,PUE.,"SAN ANDRES CHOLULA, PUE.",1,0,1,0,0,22,
19/07/2013,OAX.,"MIAHUATLAN DE PORFIRIO DIAZ, OAX.",1,0,1,0,1,1785,
19/07/2013,AGS.,"ASIENTOS, AGS.",1,0,1,0,0,0,
19/07/2013,CHIS.,"MAPASTEPEC, CHIS.",0,0,0,0,0,127,
19/07/2013,N.L.,"GRAL. ESCOBEDO, N.L.",0,0,0,0,0,147,
20/07/2013,N.L.,"MONTERREY, N.L.",28,9,37,13,1,2129,
20/07/2013,MOR.,"CUERNAVACA, MOR.",3,3,6,0,6,72,
20/07/2013,B.C.,"TIJUANA, B.C.",0,3,3,0,0,0,
20/07/2013,B.C.,"TECATE, B.C.",0,3,3,0,0,0,
20/07/2013,VER.,"COATZACOALCOS, VER.",2,0,2,0,0,0,
20/07/2013,PUE.,"SAN MARTIN TEXMELUCAN, PUE.",2,0,2,0,0,0,
20/07/2013,N.L.,"GRAL. ESCOBEDO, N.L.",1,1,2,0,0,0,
20/07/2013,JAL.,"TALPA DE ALLENDE, JAL.",2,0,2,0,0,0,
20/07/2013,PUE.,"VENUSTIANO CARRANZA, PUE.",0,1,1,0,0,0,
20/07/2013,TAB.,"BALANCAN, TAB.",1,0,1,0,0,0,
20/07/2013,CHIS.,"ESCUINTLA, CHIS.",1,0,1,0,0,0,
20/07/2013,TAMPS.,"REYNOSA, TAMPS.",0,1,1,1,0,60,
20/07/2013,TAMPS.,"GONZALEZ, TAMPS.",1,0,1,1,1,0,
20/07/2013,JAL.,"PUERTO VALLARTA, JAL.",1,0,1,0,0,0,
20/07/2013,TAB.,"TEAPA, TAB.",0,0,0,0,1,0,
21/07/2013,N.L.,"MONTERREY, N.L.",32,13,45,61,0,6008,
21/07/2013,MOR.,"CUERNAVACA, MOR.",1,4,5,0,1,60,
21/07/2013,B.C.,"MEXICALI, B.C.",4,1,5,0,0,0,
21/07/2013,PUE.,"SAN MARTIN TEXMELUCAN, PUE.",3,0,3,0,2,23,
21/07/2013,B.C.,"ENSENADA, B.C.",0,1,1,0,0,0,
21/07/2013,PUE.,"PUE., PUE.",1,0,1,0,0,0,
21/07/2013,PUE.,"VENUSTIANO CARRANZA, PUE.",1,0,1,1,0,0,
21/07/2013,N.L.,"GRAL. ESCOBEDO, N.L.",0,0,0,0,0,50,
22/07/2013,D.F.,"GUSTAVO A. MADERO, D.F.",30,18,48,0,2,480,
22/07/2013,N.L.,"MONTERREY, N.L.",7,8,15,13,0,3700,
22/07/2013,B.C.,"MEXICALI, B.C.",4,1,5,0,0,0,
22/07/2013,QRO.,"QUERETARO, QRO.",1,4,5,0,1,0,
22/07/2013,VER.,"COATZACOALCOS, VER.",3,0,3,0,0,0,
22/07/2013,MOR.,"PUENTE DE IXTLA, MOR.",3,0,3,0,0,148,
22/07/2013,CHIS.,"TUXTLA GUTIÉRREZ, CHIS.",3,0,3,1,0,52,
22/07/2013,COAH.,"TORREÓN, COAH.",2,0,2,0,0,0,
22/07/2013,AGS.,"ASIENTOS, AGS.",1,1,2,0,0,234,
22/07/2013,PUE.,"VENUSTIANO CARRANZA, PUE.",1,1,2,0,0,0,
22/07/2013,N.L.,"GRAL. ESCOBEDO, N.L.",0,1,1,1,0,111,
22/07/2013,PUE.,"SAN MARTIN TEXMELUCAN, PUE.",0,1,1,0,0,0,
22/07/2013,TAB.,"TEAPA, TAB.",0,0,0,0,1,0,
22/07/2013,PUE.,"SAN ANDRES CHOLULA, PUE.",0,0,0,0,4,38,
23/07/2013,QRO.,"QUERETARO, QRO.",24,8,32,0,1,0,
23/07/2013,N.L.,"MONTERREY, N.L.",19,8,27,60,0,1350,
23/07/2013,D.F.,"GUSTAVO A. MADERO, D.F.",21,5,26,0,0,830,
23/07/2013,JAL.,"ZAPOTLAN EL GRANDE, JAL.",6,3,9,2,0,102,
23/07/2013,CHIS.,"ARRIAGA, CHIS.",3,4,7,0,1,6,
23/07/2013,PUE.,"SAN MARTIN TEXMELUCAN, PUE.",5,1,6,0,6,342,
23/07/2013,N.L.,"GRAL. ESCOBEDO, N.L.",2,1,3,4,0,90,
23/07/2013,NAY.,"TECUALA, NAY.",3,0,3,0,0,0,
23/07/2013,B.C.,"ENSENADA, B.C.",0,3,3,0,0,0,
23/07/2013,MOR.,"PUENTE DE IXTLA, MOR.",3,0,3,0,2,0,
23/07/2013,NAY.,"COMPOSTELA, NAY.",0,2,2,0,0,0,
23/07/2013,AGS.,"ASIENTOS, AGS.",1,0,1,0,0,0,
23/07/2013,PUE.,"VENUSTIANO CARRANZA, PUE.",1,0,1,0,0,0,
23/07/2013,COAH.,"TORREÓN, COAH.",1,0,1,0,0,0,
23/07/2013,TAB.,"COMALCALCO, TAB.",1,0,1,0,0,0,
23/07/2013,PUE.,"SAN ANDRES CHOLULA, PUE.",0,0,0,0,0,179,
23/07/2013,S.L.P.,"CIUDAD DEL MAIZ, S.L.P.",0,0,0,0,0,84,
24/07/2013,N.L.,"MONTERREY, N.L.",27,17,44,13,0,4072,
24/07/2013,D.F.,"GUSTAVO A. MADERO, D.F.",30,3,33,0,5,150,
24/07/2013,QRO.,"QUERETARO, QRO.",15,9,24,0,1,0,
24/07/2013,B.C.,"MEXICALI, B.C.",1,7,8,0,0,0,
24/07/2013,MOR.,"PUENTE DE IXTLA, MOR.",5,2,7,3,0,90,
24/07/2013,N.L.,"GRAL. ESCOBEDO, N.L.",4,2,6,8,0,0,
24/07/2013,PUE.,"PUE., PUE.",2,1,3,1,0,270,
24/07/2013,NAY.,"TECUALA, NAY.",0,3,3,1,0,0,
24/07/2013,PUE.,"LOS REYES DE JUAREZ, PUE.",1,1,2,0,0,50,
24/07/2013,GRO.,"ACAPULCO DE JUAREZ, GRO.",2,0,2,0,3,7,
24/07/2013,JAL.,"GUADALAJARA, JAL.",1,1,2,0,0,0,
24/07/2013,B.C.,"TIJUANA, B.C.",0,2,2,0,0,0,
24/07/2013,PUE.,"SAN MARTIN TEXMELUCAN, PUE.",1,0,1,1,0,87,
24/07/2013,PUE.,"VENUSTIANO CARRANZA, PUE.",1,0,1,0,0,0,
24/07/2013,JAL.,"ZAPOTLAN EL GRANDE, JAL.",0,1,1,0,0,0,
24/07/2013,B.C.,"ENSENADA, B.C.",0,1,1,0,0,0,
24/07/2013,PUE.,"SAN ANDRES CHOLULA, PUE.",0,1,1,0,1,0,
25/07/2013,D.F.,"GUSTAVO A. MADERO, D.F.",30,6,36,2,2,100,
25/07/2013,N.L.,"MONTERREY, N.L.",21,15,36,21,0,2560,
25/07/2013,QRO.,"QUERETARO, QRO.",21,6,27,0,4,0,
25/07/2013,JAL.,"GUADALAJARA, JAL.",5,1,6,0,0,0,
25/07/2013,B.C.,"MEXICALI, B.C.",1,4,5,0,0,0,
25/07/2013,CHIS.,"TUXTLA GUTIÉRREZ, CHIS.",3,1,4,6,0,1476,
25/07/2013,B.C.,"TIJUANA, B.C.",0,3,3,0,0,0,
25/07/2013,NAY.,"COMPOSTELA, NAY.",2,1,3,0,0,0,
25/07/2013,CHIS.,"TUZANTÁN, CHIS.",1,1,2,0,0,40,
25/07/2013,PUE.,"SAN MARTIN TEXMELUCAN, PUE.",2,0,2,0,3,125,
25/07/2013,TAMPS.,"NUEVO LAREDO, TAMPS.",0,2,2,0,0,36,
25/07/2013,S.L.P.,"CIUDAD DEL MAIZ, S.L.P.",1,0,1,0,0,0,
25/07/2013,MOR.,"PUENTE DE IXTLA, MOR.",0,1,1,0,0,0,
25/07/2013,GRO.,"CHILPANCINGO DE LOS BRAVO, GRO.",1,0,1,0,3,0,
25/07/2013,JAL.,"ZAPOPAN, JAL.",1,0,1,0,0,0,
26/07/2013,D.F.,"GUSTAVO A. MADERO, D.F.",32,8,40,5,13,380,
26/07/2013,N.L.,"MONTERREY, N.L.",19,4,23,12,0,2165,
26/07/2013,CHIS.,"TUXTLA GUTIÉRREZ, CHIS.",6,5,11,0,4,2021,
26/07/2013,COAH.,"TORREÓN, COAH.",6,0,6,0,0,0,
26/07/2013,N.L.,"GRAL. ESCOBEDO, N.L.",3,3,6,0,0,65,
26/07/2013,GRO.,"CHILPANCINGO DE LOS BRAVO, GRO.",3,1,4,0,2,0,
26/07/2013,PUE.,"PUE., PUE.",3,0,3,0,0,75,
26/07/2013,B.C.,"TIJUANA, B.C.",1,2,3,0,0,0,
26/07/2013,PUE.,"SAN MARTIN TEXMELUCAN, PUE.",2,0,2,1,2,378,
26/07/2013,MOR.,"PUENTE DE IXTLA, MOR.",1,1,2,0,0,0,
26/07/2013,S.L.P.,"CIUDAD DEL MAIZ, S.L.P.",2,0,2,0,0,0,
26/07/2013,CHIS.,"TUXTLA GUTIÉRREZ, CHIS.",1,1,2,0,2,475,
26/07/2013,PUE.,"VENUSTIANO CARRANZA, PUE.",0,1,1,0,0,0,
26/07/2013,B.C.S.,"MULEGÉ, B.C.S.",0,1,1,0,0,0,
26/07/2013,CHIS.,"TUZANTÁN, CHIS.",0,1,1,2,0,0,
26/07/2013,TAMPS.,"RIO BRAVO, TAMPS.",0,1,1,1,0,27,
26/07/2013,TAMPS.,"NUEVO LAREDO, TAMPS.",0,0,0,4,0,325,
27/07/2013,N.L.,"MONTERREY, N.L.",21,12,33,11,0,1093,
27/07/2013,CHIS.,"TUXTLA GUTIÉRREZ, CHIS.",11,4,15,0,2,0,
27/07/2013,PUE.,"SAN MARTIN TEXMELUCAN, PUE.",3,2,5,0,0,0,
27/07/2013,PUE.,"VENUSTIANO CARRANZA, PUE.",2,1,3,0,0,0,
27/07/2013,CHIS.,"TUZANTÁN, CHIS.",1,1,2,0,0,0,
27/07/2013,N.L.,"GRAL. ESCOBEDO, N.L.",2,0,2,11,0,260,
27/07/2013,B.C.S.,"MULEGÉ, B.C.S.",1,1,2,0,0,0,
27/07/2013,COAH.,"TORREÓN, COAH.",1,0,1,0,0,0,
27/07/2013,MOR.,"PUENTE DE IXTLA, MOR.",1,0,1,0,0,0,
27/07/2013,GRO.,"CHILPANCINGO DE LOS BRAVO, GRO.",1,0,1,0,0,0,
28/07/2013,N.L.,"MONTERREY, N.L.",17,15,32,21,0,2261,
28/07/2013,GRO.,"ATENANGO DEL RIO, GRO.",5,3,8,0,0,86,
28/07/2013,N.L.,"GRAL. ESCOBEDO, N.L.",3,1,4,1,0,46,
28/07/2013,CHIS.,"TUXTLA GUTIÉRREZ, CHIS.",1,1,2,0,2,475,
28/07/2013,CHIS.,"TUZANTÁN, CHIS.",2,0,2,0,2,2,
29/07/2013,N.L.,"MONTERREY, N.L.",24,8,32,24,0,3507,
29/07/2013,D.F.,"TLAHUAC, D.F.",13,5,18,0,0,90,
29/07/2013,CHIS.,"TUXTLA GUTIÉRREZ, CHIS.",3,3,6,2,2,506,
29/07/2013,MOR.,"PUENTE DE IXTLA, MOR.",2,3,5,0,0,25,
29/07/2013,N.L.,"GUADALUPE, N.L.",1,3,4,0,1,176,
29/07/2013,NAY.,"TECUALA, NAY.",2,0,2,0,0,0,
29/07/2013,N.L.,"GARCIA, N.L.",1,1,2,10,0,0,
29/07/2013,B.C.,"TIJUANA, B.C.",1,1,2,0,0,0,
29/07/2013,B.C.,"ENSENADA, B.C.",0,2,2,0,0,0,
29/07/2013,TLAX.,"TLAX., TLAX.",2,0,2,1,0,20,
29/07/2013,PUE.,"VENUSTIANO CARRANZA, PUE.",0,2,2,0,0,0,
29/07/2013,SIN.,"COSALA, SIN.",1,0,1,0,0,0,
29/07/2013,COAH.,"TORREÓN, COAH.",1,0,1,0,0,0,
29/07/2013,CHIS.,"OCOSINGO, CHIS.",0,1,1,0,0,0,
29/07/2013,PUE.,"PUE., PUE.",1,0,1,1,0,337,
29/07/2013,PUE.,"SAN MARTIN TEXMELUCAN, PUE.",0,1,1,0,1,0,
29/07/2013,PUE.,"SAN ANDRES CHOLULA, PUE.",0,1,1,0,0,49,
29/07/2013,QRO.,"QUERETARO, QRO.",0,0,0,0,5,0,
30/07/2013,JAL.,"ZAPOPAN, JAL.",10,31,41,2,0,102,
30/07/2013,N.L.,"GUADALUPE, N.L.",14,9,23,1,0,718,
30/07/2013,D.F.,"TLAHUAC, D.F.",16,4,20,0,0,80,
30/07/2013,N.L.,"MONTERREY, N.L.",6,6,12,50,0,1394,
30/07/2013,QRO.,"QUERETARO, QRO.",4,8,12,0,0,0,
30/07/2013,B.C.,"TIJUANA, B.C.",5,3,8,0,0,0,
30/07/2013,COAH.,"TORREÓN, COAH.",5,1,6,0,0,0,
30/07/2013,CHIS.,"TUXTLA GUTIÉRREZ, CHIS.",2,3,5,2,1,379,
30/07/2013,B.C.,"TIJUANA, B.C.",3,2,5,0,0,0,
30/07/2013,MOR.,"CUERNAVACA, MOR.",2,1,3,0,0,25,
30/07/2013,SIN.,"COSALA, SIN.",2,1,3,0,0,0,
30/07/2013,B.C.,"ENSENADA, B.C.",2,0,2,0,0,0,
30/07/2013,PUE.,"PUE., PUE.",2,0,2,0,0,0,
30/07/2013,B.C.,"MEXICALI, B.C.",0,1,1,0,0,0,
30/07/2013,JAL.,"TECALITLAN, JAL.",0,1,1,0,0,0,
30/07/2013,PUE.,"SAN MARTIN TEXMELUCAN, PUE.",0,1,1,0,2,223,
30/07/2013,VER.,"COATZACOALCOS, VER.",0,0,0,0,0,0,
30/07/2013,N.L.,"GARCIA, N.L.",0,0,0,23,0,1350,
30/07/2013,OAX.,"MIAHUATLAN DE PORFIRIO DIAZ, OAX.",0,0,0,6,0,113,
30/07/2013,OAX.,"MIAHUATLAN DE PORFIRIO DIAZ, OAX.",0,0,0,6,0,113,
30/07/2013,JAL.,"TLAQUEPAQUE, JAL.",0,0,0,0,1,0,
31/07/2013,D.F.,"TLAHUAC, D.F.",13,9,22,0,0,42,
31/07/2013,N.L.,"GUADALUPE, N.L.",11,10,21,17,0,1028,
31/07/2013,N.L.,"MONTERREY, N.L.",3,6,9,1,0,0,
31/07/2013,SIN.,"COSALA, SIN.",0,6,6,0,0,0,
31/07/2013,MOR.,"PUENTE DE IXTLA, MOR.",2,1,3,0,0,0,
31/07/2013,CHIS.,"TUXTLA GUTIÉRREZ, CHIS.",3,0,3,2,1,514,
31/07/2013,N.L.,"GARCIA, N.L.",1,1,2,0,0,0,
31/07/2013,NAY.,"COMPOSTELA, NAY.",0,2,2,0,0,0,
31/07/2013,B.C.,"TIJUANA, B.C.",1,1,2,0,0,0,
31/07/2013,PUE.,"PUE., PUE.",1,0,1,0,0,150,
31/07/2013,B.C.,"TIJUANA, B.C.",1,0,1,0,0,0,
31/07/2013,B.C.,"ENSENADA, B.C.",0,1,1,0,0,0,
31/07/2013,AGS.,"TEPEZALÁ, AGS.",1,0,1,71,0,0,
31/07/2013,PUE.,"SAN MARTIN TEXMELUCAN, PUE.",0,1,1,0,1,454,
31/07/2013,PUE.,"VENUSTIANO CARRANZA, PUE.",1,0,1,1,0,0,
31/07/2013,PUE.,"SAN ANDRES CHOLULA, PUE.",0,0,0,0,0,300,
01/08/2013,D.F.,"TLAHUAC, D.F.",15,3,18,0,0,65,
01/08/2013,JAL.,"TLAQUEPAQUE, JAL.",12,5,17,3,0,53,
01/08/2013,N.L.,"MONTERREY, N.L.",8,7,15,31,0,607,
01/08/2013,COAH.,"TORREÓN, COAH.",6,0,6,0,0,0,
01/08/2013,TLAX.,"TLAX., TLAX.",2,2,4,1,0,70,
01/08/2013,SIN.,"COSALA, SIN.",2,2,4,0,0,0,
01/08/2013,CHIS.,"TUXTLA GUTIÉRREZ, CHIS.",3,1,4,0,2,1032,
01/08/2013,N.L.,"GUADALUPE, N.L.",1,2,3,0,0,198,
01/08/2013,PUE.,"SAN MARTIN TEXMELUCAN, PUE.",0,2,2,0,2,230,
01/08/2013,B.C.,"ENSENADA, B.C.",0,2,2,0,0,0,
01/08/2013,N.L.,"GARCIA, N.L.",1,1,2,14,0,400,
01/08/2013,VER.,"COATZACOALCOS, VER.",1,0,1,0,0,0,
01/08/2013,CHIH.,"JUÁREZ, CHIH.",0,1,1,0,0,0,
01/08/2013,B.C.,"TIJUANA, B.C.",0,1,1,0,0,0,
01/08/2013,MOR.,"PUENTE DE IXTLA, MOR.",0,1,1,0,0,0,
01/08/2013,PUE.,"SAN ANDRES CHOLULA, PUE.",0,0,0,0,0,70,
02/08/2013,D.F.,"TLAHUAC, D.F.",11,8,19,3,1,90,
02/08/2013,N.L.,"MONTERREY, N.L.",7,1,8,0,0,637,
02/08/2013,SIN.,"COSALA, SIN.",3,2,5,0,2,0,
02/08/2013,COAH.,"TORREÓN, COAH.",5,0,5,0,0,0,
02/08/2013,TLAX.,"TLAX., TLAX.",3,1,4,1,0,0,
02/08/2013,B.C.,"TIJUANA, B.C.",2,2,4,0,0,0,
02/08/2013,CHIS.,"TUXTLA GUTIÉRREZ, CHIS.",3,1,4,0,1,1032,
02/08/2013,TLAX.,"TLAX., TLAX.",2,2,4,3,0,0,
02/08/2013,NAY.,"COMPOSTELA, NAY.",1,2,3,0,0,0,
02/08/2013,N.L.,"GUADALUPE, N.L.",2,1,3,0,0,402,
02/08/2013,N.L.,"GARCIA, N.L.",1,1,2,0,0,0,
02/08/2013,AGS.,"TEPEZALÁ, AGS.",0,1,1,0,0,0,
02/08/2013,VER.,"TUXPAM, VER.",0,1,1,0,0,0,
02/08/2013,TAB.,"CUNDUACAN, TAB.",1,0,1,0,0,0,
02/08/2013,TAMPS.,"NUEVO LAREDO, TAMPS.",1,0,1,4,0,899,
02/08/2013,PUE.,"VENUSTIANO CARRANZA, PUE.",1,0,1,0,0,1,
02/08/2013,PUE.,"PUE., PUE.",0,0,0,0,0,14,
02/08/2013,PUE.,"SAN ANDRES CHOLULA, PUE.",0,0,0,0,1,10,
03/08/2013,JAL.,"ZAPOPAN, JAL.",20,57,77,11,1,318,
03/08/2013,N.L.,"MONTERREY, N.L.",19,10,29,30,1,1201,
03/08/2013,B.C.,"TIJUANA, B.C.",2,1,3,0,0,0,
03/08/2013,N.L.,"GUADALUPE, N.L.",1,2,3,0,0,198,
03/08/2013,PUE.,"SAN MARTIN TEXMELUCAN, PUE.",1,2,3,0,0,212,
03/08/2013,MOR.,"PUENTE DE IXTLA, MOR.",1,0,1,0,0,0,
03/08/2013,PUE.,"PUE., PUE.",1,0,1,0,0,0,
03/08/2013,PUE.,"VENUSTIANO CARRANZA, PUE.",1,0,1,0,0,0,
03/08/2013,N.L.,"GARCIA, N.L.",0,0,0,2,0,0,
03/08/2013,OAX.,"MIAHUATLAN DE PORFIRIO DIAZ, OAX.",0,0,0,0,2,0,
04/08/2013,N.L.,"MONTERREY, N.L.",28,10,38,9,2,1647,
04/08/2013,N.L.,"GUADALUPE, N.L.",0,1,1,12,0,70,
04/08/2013,B.C.,"TECATE, B.C.",1,0,1,0,0,0,
04/08/2013,B.C.,"ENSENADA, B.C.",1,0,1,0,0,0,
04/08/2013,N.L.,"GARCIA, N.L.",0,0,0,8,0,1050,
05/08/2013,D.F.,"TLAHUAC, D.F.",11,2,13,2,1,35,
05/08/2013,COAH.,"TORREÓN, COAH.",4,3,7,0,2,0,
05/08/2013,N.L.,"GUADALUPE, N.L.",2,3,5,0,0,238,
05/08/2013,SIN.,"ELOTA, SIN.",2,1,3,0,0,0,
05/08/2013,B.C.,"MEXICALI, B.C.",0,3,3,0,0,0,
05/08/2013,TLAX.,"TLAX., TLAX.",2,0,2,0,0,0,
05/08/2013,PUE.,"ATLIXCO, PUE.",0,1,1,0,1,392,
05/08/2013,N.L.,"GARCIA, N.L.",0,1,1,1,0,24,
05/08/2013,PUE.,"PUE., PUE.",0,0,0,0,0,223,
06/08/2013,D.F.,"TLAHUAC, D.F.",9,3,12,2,2,29,
06/08/2013,N.L.,"GUADALUPE, N.L.",4,4,8,7,0,1051,
06/08/2013,JAL.,"ZAPOPAN, JAL.",3,4,7,4,0,190,
06/08/2013,TLAX.,"TLAX., TLAX.",5,1,6,0,0,1,
06/08/2013,COAH.,"TORREÓN, COAH.",4,0,4,0,1,0,
06/08/2013,COAH.,"TORREÓN, COAH.",4,0,4,0,1,0,
06/08/2013,PUE.,"ATLIXCO, PUE.",1,2,3,8,8,597,
06/08/2013,HGO.,"HUEJUTLA DE REYES, HGO.",2,1,3,0,0,0,
06/08/2013,MOR.,"PUENTE DE IXTLA, MOR.",2,0,2,0,0,0,
06/08/2013,CHIH.,"ASCENSIÓN, CHIH.",0,2,2,0,0,0,
06/08/2013,SIN.,"CULIACAN, SIN.",1,1,2,0,4,0,
06/08/2013,B.C.,"TIJUANA, B.C.",2,0,2,0,0,0,
06/08/2013,GRO.,"ATOYAC DE ALVAREZ, GRO.",0,1,1,0,0,0,
06/08/2013,JAL.,"PIHUAMO, JAL.",1,0,1,0,0,0,
06/08/2013,PUE.,"AMOZOC, PUE.",0,0,0,0,0,25,
06/08/2013,PUE.,"PUE., PUE.",0,0,0,0,0,300,
06/08/2013,N.L.,"GARCIA, N.L.",0,0,0,14,0,1121,
07/08/2013,D.F.,"TLAHUAC, D.F.",11,2,13,0,1,30,
07/08/2013,N.L.,"GUADALUPE, N.L.",6,1,7,1,0,4480,
07/08/2013,B.C.,"MEXICALI, B.C.",2,3,5,0,2,0,
07/08/2013,CHIH.,"ASCENSIÓN, CHIH.",2,1,3,0,0,0,
07/08/2013,PUE.,"ATLIXCO, PUE.",1,1,2,5,4,228,
07/08/2013,COAH.,"TORREÓN, COAH.",2,0,2,0,0,0,
07/08/2013,MOR.,"PUENTE DE IXTLA, MOR.",2,0,2,0,0,0,
07/08/2013,JAL.,"PIHUAMO, JAL.",2,0,2,1,0,0,
07/08/2013,HGO.,"HUEJUTLA DE REYES, HGO.",1,0,1,0,0,0,
07/08/2013,B.C.,"TIJUANA, B.C.",1,0,1,0,0,0,
07/08/2013,B.C.,"ENSENADA, B.C.",1,0,1,0,0,0,
07/08/2013,JAL.,"ZAPOPAN, JAL.",1,0,1,0,0,0,
07/08/2013,PUE.,"PUE., PUE.",0,0,0,1,1,155,
07/08/2013,PUE.,"AMOZOC, PUE.",0,0,0,0,0,100,
07/08/2013,N.L.,"GARCIA, N.L.",0,0,0,2,0,0,
07/08/2013,SIN.,"ELOTA, SIN.",0,0,0,0,4,0,
08/08/2013,D.F.,"TLAHUAC, D.F.",11,6,17,2,1,60,
08/08/2013,N.L.,"SANTA CATARINA, N.L.",8,8,16,3,0,1125,
08/08/2013,JAL.,"ZAPOPAN, JAL.",8,4,12,0,0,0,
08/08/2013,HGO.,"PACHUCA DE SOTO, HGO.",4,1,5,0,0,0,
08/08/2013,SIN.,"ELOTA, SIN.",3,1,4,0,2,0,
08/08/2013,CHIH.,"ASCENSIÓN, CHIH.",1,3,4,0,0,0,
08/08/2013,TLAX.,"TLAX., TLAX.",1,3,4,1,0,79,
08/08/2013,N.L.,"SAN NICOLAS DE LOS GARZA, N.L.",3,0,3,9,0,43,
08/08/2013,COAH.,"TORREÓN, COAH.",3,0,3,0,0,0,
08/08/2013,VER.,"COATZACOALCOS, VER.",2,0,2,0,0,0,
08/08/2013,B.C.,"TIJUANA, B.C.",1,1,2,0,0,0,
08/08/2013,PUE.,"ATLIXCO, PUE.",1,1,2,11,5,62,
08/08/2013,COAH.,"ACUÑA, COAH.",0,1,1,0,0,0,
08/08/2013,HGO.,"IXMIQUILPAN, HGO.",0,0,0,0,0,200,
08/08/2013,PUE.,"PUE., PUE.",0,0,0,0,0,62,
08/08/2013,PUE.,"AMOZOC, PUE.",0,0,0,0,0,767,
09/08/2013,D.F.,"TLAHUAC, D.F.",11,4,15,0,2,20,
09/08/2013,B.C.,"MEXICALI, B.C.",6,4,10,0,0,0,
09/08/2013,QRO.,"TEQUISQUIAPAN, QRO.",3,3,6,0,0,0,
09/08/2013,CHIH.,"ASCENSIÓN, CHIH.",2,3,5,0,0,0,
09/08/2013,N.L.,"SANTA CATARINA, N.L.",4,1,5,5,0,600,
09/08/2013,B.C.,"TIJUANA, B.C.",1,4,5,0,0,0,
09/08/2013,TAMPS.,"REYNOSA, TAMPS.",2,3,5,4,0,0,
09/08/2013,COAH.,"TORREÓN, COAH.",1,3,4,0,0,0,
09/08/2013,JAL.,"ZAPOPAN, JAL.",3,0,3,0,0,0,
09/08/2013,SIN.,"CULIACAN, SIN.",1,2,3,0,4,0,
09/08/2013,MOR.,"PUENTE DE IXTLA, MOR.",3,0,3,0,2,0,
09/08/2013,PUE.,"ATLIXCO, PUE.",2,0,2,0,0,931,
09/08/2013,N.L.,"SAN NICOLAS DE LOS GARZA, N.L.",2,0,2,6,0,236,
09/08/2013,HGO.,"HUEJUTLA DE REYES, HGO.",2,0,2,0,0,0,
09/08/2013,B.C.S.,"MULEGÉ, B.C.S.",1,0,1,0,0,0,
10/08/2013,QRO.,"TEQUISQUIAPAN, QRO.",7,5,12,0,0,0,
10/08/2013,N.L.,"SAN NICOLAS DE LOS GARZA, N.L.",1,2,3,6,0,395,
10/08/2013,N.L.,"SANTA CATARINA, N.L.",2,1,3,3,0,128,
10/08/2013,TAMPS.,"REYNOSA, TAMPS.",2,1,3,0,0,0,
10/08/2013,TAB.,"CUNDUACAN, TAB.",1,0,1,0,0,0,
10/08/2013,COAH.,"ACUÑA, COAH.",0,1,1,0,0,0,
10/08/2013,B.C.S.,"MULEGÉ, B.C.S.",1,0,1,0,0,0,
10/08/2013,TAMPS.,"GONZALEZ, TAMPS.",0,1,1,0,0,0,
10/08/2013,PUE.,"ATLIXCO, PUE.",0,0,0,2,0,1082,
11/08/2013,QRO.,"TEQUISQUIAPAN, QRO.",2,4,6,0,0,0,
11/08/2013,B.C.,"TECATE, B.C.",2,2,4,0,0,0,
11/08/2013,PUE.,"ATLIXCO, PUE.",2,1,3,4,0,650,
11/08/2013,N.L.,"SAN NICOLAS DE LOS GARZA, N.L.",1,1,2,0,0,0,
11/08/2013,JAL.,"CIHUATLAN, JAL.",2,0,2,0,0,0,
11/08/2013,N.L.,"SANTA CATARINA, N.L.",1,0,1,3,0,271,
12/08/2013,D.F.,"MIGUEL HGO., D.F.",7,0,7,0,0,51,
12/08/2013,HGO.,"PACHUCA DE SOTO, HGO.",4,1,5,0,0,0,
12/08/2013,TLAX.,"TLAX., TLAX.",4,1,5,2,0,32,
12/08/2013,N.L.,"SAN NICOLAS DE LOS GARZA, N.L.",3,1,4,1,0,72,
12/08/2013,N.L.,"SANTA CATARINA, N.L.",2,2,4,5,0,273,
12/08/2013,MOR.,"CUAUTLA, MOR.",2,1,3,0,0,0,
12/08/2013,HGO.,"HUEJUTLA DE REYES, HGO.",0,2,2,0,2,0,
12/08/2013,HGO.,"IXMIQUILPAN, HGO.",2,0,2,0,0,0,
12/08/2013,JAL.,"TONALA, JAL.",0,2,2,0,0,0,
12/08/2013,COAH.,"TORREÓN, COAH.",1,0,1,0,0,0,
12/08/2013,B.C.,"TIJUANA, B.C.",0,1,1,0,0,0,
12/08/2013,PUE.,"ATLIXCO, PUE.",1,0,1,0,0,0,
12/08/2013,CHIS.,"OCOSINGO, CHIS.",0,1,1,0,0,0,
12/08/2013,VER.,"NANCHITAL DE LAZARO CARDENAS DEL RIO, VER.",1,0,1,0,0,0,
12/08/2013,PUE.,"TEPEACA, PUE.",0,0,0,0,0,346,
13/08/2013,COAH.,"RAMOS ARIZPE, COAH.",11,10,21,0,0,0,
13/08/2013,D.F.,"MIGUEL HGO., D.F.",14,2,16,1,0,220,
13/08/2013,HGO.,"IXMIQUILPAN, HGO.",12,0,12,0,0,200,
13/08/2013,HGO.,"PACHUCA DE SOTO, HGO.",7,0,7,0,1,0,
13/08/2013,MOR.,"CUAUTLA, MOR.",6,1,7,6,0,2449,
13/08/2013,JAL.,"GUADALAJARA, JAL.",4,1,5,0,0,0,
13/08/2013,B.C.,"TIJUANA, B.C.",0,4,4,0,0,0,
13/08/2013,HGO.,"HUEJUTLA DE REYES, HGO.",3,0,3,0,0,0,
13/08/2013,GRO.,"CHILPANCINGO DE LOS BRAVO, GRO.",1,2,3,0,0,0,
13/08/2013,N.L.,"SANTA CATARINA, N.L.",3,0,3,0,0,0,
13/08/2013,SIN.,"SAN IGNACIO, SIN.",1,1,2,0,0,0,
13/08/2013,YUC.,"PETO, YUC.",0,2,2,0,0,112,
13/08/2013,COAH.,"TORREÓN, COAH.",1,0,1,0,0,0,
13/08/2013,COAH.,"ACUÑA, COAH.",0,1,1,0,0,0,
13/08/2013,PUE.,"ATLIXCO, PUE.",1,0,1,3,0,326,
13/08/2013,PUE.,"TEPEACA, PUE.",1,0,1,0,0,0,
13/08/2013,N.L.,"SAN NICOLAS DE LOS GARZA, N.L.",0,0,0,2,0,910,
13/08/2013,YUC.,"PETO, YUC.",0,0,0,1,0,154,
13/08/2013,PUE.,"ZACATLAN, PUE.",0,0,0,1,0,0,
14/08/2013,D.F.,"MIGUEL HGO., D.F.",9,7,16,0,1,12,
14/08/2013,COAH.,"RAMOS ARIZPE, COAH.",5,4,9,0,0,0,
14/08/2013,HGO.,"PACHUCA DE SOTO, HGO.",6,2,8,0,0,0,
14/08/2013,MOR.,"CUAUTLA, MOR.",4,3,7,2,2,0,
14/08/2013,AGS.,"AGS., AGS.",5,1,6,2,0,100,
14/08/2013,B.C.,"MEXICALI, B.C.",2,2,4,0,0,0,
14/08/2013,GRO.,"CHILPANCINGO DE LOS BRAVO, GRO.",1,3,4,0,6,102,
14/08/2013,N.L.,"SANTA CATARINA, N.L.",4,0,4,0,0,184,
14/08/2013,TLAX.,"TLAX., TLAX.",2,0,2,1,0,5,
14/08/2013,YUC.,"PETO, YUC.",2,0,2,0,0,0,
14/08/2013,N.L.,"SAN NICOLAS DE LOS GARZA, N.L.",1,1,2,0,0,558,
14/08/2013,HGO.,"HUEJUTLA DE REYES, HGO.",0,1,1,0,0,0,
14/08/2013,HGO.,"IXMIQUILPAN, HGO.",1,0,1,0,0,200,
14/08/2013,COAH.,"TORREÓN, COAH.",1,0,1,0,0,0,
14/08/2013,COAH.,"ACUÑA, COAH.",1,0,1,0,0,0,
14/08/2013,PUE.,"ATLIXCO, PUE.",0,0,0,0,0,200,
15/08/2013,D.F.,"MIGUEL HGO., D.F.",11,5,16,0,1,50,
15/08/2013,COAH.,"RAMOS ARIZPE, COAH.",8,4,12,0,0,0,
15/08/2013,MOR.,"CUAUTLA, MOR.",2,5,7,0,5,0,
15/08/2013,TLAX.,"TLAX., TLAX.",3,2,5,0,0,5,
15/08/2013,B.C.,"TIJUANA, B.C.",2,2,4,0,0,0,
15/08/2013,B.C.,"MEXICALI, B.C.",2,1,3,0,0,0,
15/08/2013,SIN.,"SAN IGNACIO, SIN.",1,0,1,0,0,0,
15/08/2013,PUE.,"ATLIXCO, PUE.",1,0,1,0,1,0,
15/08/2013,YUC.,"CHICHIMILA, YUC.",0,1,1,0,0,0,
16/08/2013,D.F.,"MIGUEL HGO., D.F.",12,3,15,0,0,100,
16/08/2013,COAH.,"RAMOS ARIZPE, COAH.",9,2,11,0,0,0,
16/08/2013,HGO.,"PACHUCA DE SOTO, HGO.",6,2,8,0,0,100,
16/08/2013,TLAX.,"TLAX., TLAX.",3,4,7,1,0,22,
16/08/2013,B.C.,"MEXICALI, B.C.",4,3,7,0,0,0,
16/08/2013,QRO.,"TEQUISQUIAPAN, QRO.",2,4,6,0,4,0,
16/08/2013,JAL.,"TONALA, JAL.",5,0,5,2,0,54,
16/08/2013,PUE.,"ATLIXCO, PUE.",1,3,4,0,0,172,
16/08/2013,HGO.,"IXMIQUILPAN, HGO.",3,0,3,0,0,0,
16/08/2013,MOR.,"CUAUTLA, MOR.",2,1,3,0,0,0,
16/08/2013,N.L.,"SAN NICOLAS DE LOS GARZA, N.L.",1,1,2,4,0,350,
16/08/2013,N.L.,"SANTA CATARINA, N.L.",2,0,2,25,0,0,
16/08/2013,HGO.,"HUEJUTLA DE REYES, HGO.",0,1,1,0,0,0,
16/08/2013,CHIH.,"NUEVO CASAS GRANDES, CHIH.",0,1,1,0,0,0,
16/08/2013,COL.,"TECOMÁN, COL.",0,1,1,0,0,0,
16/08/2013,COAH.,"ACUÑA, COAH.",0,1,1,0,0,0,
16/08/2013,TAMPS.,"VICTORIA, TAMPS.",1,0,1,0,1,0,
16/08/2013,JAL.,"GUACHINANGO, JAL.",1,0,1,0,0,22,
16/08/2013,YUC.,"OXKUTZCAB, YUC.",0,1,1,0,0,0,
16/08/2013,PUE.,"TEPEACA, PUE.",0,0,0,0,1,0,
16/08/2013,PUE.,"SAN ANDRES CHOLULA, PUE.",0,0,0,0,0,38,
17/08/2013,N.L.,"SANTA CATARINA, N.L.",3,3,6,65,0,125,
17/08/2013,N.L.,"SAN NICOLAS DE LOS GARZA, N.L.",3,2,5,28,0,50,
17/08/2013,B.C.,"TIJUANA, B.C.",2,1,3,0,0,0,
17/08/2013,QRO.,"TEQUISQUIAPAN, QRO.",2,1,3,0,0,0,
17/08/2013,HGO.,"HUEJUTLA DE REYES, HGO.",2,0,2,0,0,0,
17/08/2013,HGO.,"PACHUCA DE SOTO, HGO.",1,1,2,0,0,600,
17/08/2013,MOR.,"CUAUTLA, MOR.",2,0,2,1,1,26,
17/08/2013,COAH.,"TORREÓN, COAH.",2,0,2,0,0,39,
17/08/2013,HGO.,"IXMIQUILPAN, HGO.",1,0,1,0,0,0,
17/08/2013,PUE.,"ATLIXCO, PUE.",0,0,0,0,0,257,
17/08/2013,PUE.,"TEPEACA, PUE.",0,0,0,0,0,530,
18/08/2013,QRO.,"TEQUISQUIAPAN, QRO.",2,6,8,0,0,0,
18/08/2013,MOR.,"CUAUTLA, MOR.",2,4,6,2,0,157,
18/08/2013,PUE.,"ATLIXCO, PUE.",3,1,4,1,1,711,
18/08/2013,B.C.,"TECATE, B.C.",1,2,3,0,0,0,
18/08/2013,N.L.,"SAN NICOLAS DE LOS GARZA, N.L.",1,1,2,3,0,0,
18/08/2013,N.L.,"SAN PEDRO GARZA GARCIA, N.L.",0,0,0,60,1,115,
19/08/2013,D.F.,"IZTAPALAPA, D.F.",8,5,13,0,1,285,
19/08/2013,GTO.,"SAN FRANCISCO DEL RINCON, GTO.",10,3,13,0,0,0,
19/08/2013,B.C.,"TIJUANA, B.C.",5,0,5,0,0,0,
19/08/2013,AGS.,"AGS., AGS.",5,0,5,1,0,390,
19/08/2013,TLAX.,"TLAX., TLAX.",3,1,4,0,0,0,
19/08/2013,B.C.,"MEXICALI, B.C.",3,0,3,0,0,0,
19/08/2013,PUE.,"ZACATLAN, PUE.",1,2,3,2,0,113,
19/08/2013,TAMPS.,"VICTORIA, TAMPS.",1,2,3,1,0,0,
19/08/2013,MOR.,"CUAUTLA, MOR.",1,1,2,0,1,0,
19/08/2013,N.L.,"SAN NICOLAS DE LOS GARZA, N.L.",0,1,1,12,0,50,
19/08/2013,N.L.,"SAN PEDRO GARZA GARCIA, N.L.",0,1,1,4,0,100,
19/08/2013,PUE.,"ATLIXCO, PUE.",1,0,1,0,0,121,
19/08/2013,PUE.,"TEPEACA, PUE.",1,0,1,1,0,10,
20/08/2013,D.F.,"IZTAPALAPA, D.F.",15,7,22,4,1,0,
20/08/2013,B.C.,"MEXICALI, B.C.",18,4,22,0,0,0,
20/08/2013,MOR.,"CUAUTLA, MOR.",4,5,9,1,4,60,
20/08/2013,B.C.,"TIJUANA, B.C.",3,3,6,0,0,0,
20/08/2013,TLAX.,"PANOTLA, TLAX.",1,4,5,1,0,0,
20/08/2013,AGS.,"AGS., AGS.",3,1,4,0,0,0,
20/08/2013,SIN.,"MAZATLAN, SIN.",3,0,3,0,0,0,
20/08/2013,B.C.,"ENSENADA, B.C.",1,1,2,0,0,0,
20/08/2013,N.L.,"GARCIA, N.L.",1,1,2,5,0,46,
20/08/2013,PUE.,"ATLIXCO, PUE.",1,0,1,0,0,0,
20/08/2013,CHIH.,"CASAS GRANDES, CHIH.",1,0,1,0,0,0,
20/08/2013,YUC.,"TEKAX, YUC.",0,1,1,0,0,0,
20/08/2013,YUC.,"KAUA, YUC.",0,1,1,0,0,0,
20/08/2013,YUC.,"TEKAX, YUC.",1,0,1,0,0,0,
20/08/2013,PUE.,"ZACATLAN, PUE.",0,0,0,0,0,500,
21/08/2013,D.F.,"IZTAPALAPA, D.F.",24,6,30,0,1,60,
21/08/2013,TAMPS.,"VICTORIA, TAMPS.",7,3,10,0,0,0,
21/08/2013,SIN.,"MAZATLAN, SIN.",5,2,7,0,0,0,
21/08/2013,GTO.,"SAN FRANCISCO DEL RINCON, GTO.",3,4,7,0,0,0,
21/08/2013,B.C.,"TIJUANA, B.C.",3,3,6,0,0,0,
21/08/2013,AGS.,"AGS., AGS.",5,0,5,1,0,46,
21/08/2013,TLAX.,"TLAX., TLAX.",1,3,4,0,0,0,
21/08/2013,HGO.,"JACALA DE LEDEZMA, HGO.",3,0,3,0,0,0,
21/08/2013,PUE.,"TEPEACA, PUE.",2,0,2,2,0,403,
21/08/2013,PUE.,"ZACATLAN, PUE.",2,0,2,0,0,0,
21/08/2013,N.L.,"SAN PEDRO GARZA GARCIA, N.L.",0,2,2,2,0,200,
21/08/2013,HGO.,"TEPEAPULCO, HGO.",0,2,2,0,0,0,
21/08/2013,SON.,"HERMOSILLO, SON.",2,0,2,27,0,750,
21/08/2013,TAB.,"CUNDUACAN, TAB.",0,1,1,0,0,0,
21/08/2013,CHIH.,"CASAS GRANDES, CHIH.",1,0,1,0,0,0,
21/08/2013,PUE.,"SAN SALVADOR EL SECO, PUE.",1,0,1,0,0,0,
21/08/2013,N.L.,"VALLECILLO, N.L.",0,1,1,35,0,149,
21/08/2013,MOR.,"CUAUTLA, MOR.",0,1,1,0,3,18,
21/08/2013,HGO.,"SAN BARTOLO TUTOTEPEC, HGO.",1,0,1,0,0,0,
21/08/2013,PUE.,"ATLIXCO, PUE.",0,0,0,0,0,201,
22/08/2013,SON.,"HERMOSILLO, SON.",96,38,134,479,7,2154,
22/08/2013,D.F.,"IZTAPALAPA, D.F.",17,7,24,3,0,120,
22/08/2013,N.L.,"VALLECILLO, N.L.",1,11,12,0,0,110,
22/08/2013,TLAX.,"TLAX., TLAX.",6,2,8,1,0,0,
22/08/2013,B.C.,"TIJUANA, B.C.",4,1,5,0,0,0,
22/08/2013,AGS.,"AGS., AGS.",4,0,4,0,0,149,
22/08/2013,SIN.,"MAZATLAN, SIN.",3,1,4,0,0,0,
22/08/2013,HGO.,"JACALA DE LEDEZMA, HGO.",4,0,4,0,0,0,
22/08/2013,MOR.,"CUAUTLA, MOR.",3,0,3,0,0,0,
22/08/2013,JAL.,"TLAJOMULCO DE ZUÑIGA, JAL.",3,0,3,0,1,0,
22/08/2013,PUE.,"ZACATLAN, PUE.",0,2,2,0,0,0,
22/08/2013,HGO.,"TEPEAPULCO, HGO.",2,0,2,0,0,68,
22/08/2013,PUE.,"TEPEACA, PUE.",0,1,1,0,0,7,
22/08/2013,CHIH.,"CASAS GRANDES, CHIH.",1,0,1,0,0,0,
22/08/2013,N.L.,"SAN PEDRO GARZA GARCIA, N.L.",1,0,1,21,1,245,
22/08/2013,PUE.,"ATLIXCO, PUE.",0,0,0,0,0,218,
23/08/2013,D.F.,"IZTAPALAPA, D.F.",14,11,25,4,5,70,
23/08/2013,N.L.,"ITURBIDE, N.L.",2,10,12,34,0,533,
23/08/2013,MOR.,"CUAUTLA, MOR.",2,8,10,1,0,82,
23/08/2013,TLAX.,"TLAX., TLAX.",4,5,9,1,0,0,
23/08/2013,SIN.,"MAZATLAN, SIN.",5,0,5,0,2,0,
23/08/2013,YUC.,"TEKAL DE VENEGAS, YUC.",2,3,5,0,0,0,
23/08/2013,B.C.,"TIJUANA, B.C.",2,2,4,0,0,0,
23/08/2013,PUE.,"ATLIXCO, PUE.",1,2,3,0,0,25,
23/08/2013,HGO.,"JACALA DE LEDEZMA, HGO.",1,1,2,0,0,0,
23/08/2013,SON.,"HERMOSILLO, SON.",1,1,2,23,0,11,
23/08/2013,SON.,"CAJEME, SON.",0,2,2,23,0,126,
23/08/2013,B.C.,"MEXICALI, B.C.",0,2,2,0,0,0,
23/08/2013,HGO.,"SAN BARTOLO TUTOTEPEC, HGO.",0,1,1,0,0,0,
23/08/2013,HGO.,"TEPEAPULCO, HGO.",1,0,1,0,0,0,
23/08/2013,N.L.,"GARCIA, N.L.",1,0,1,0,0,0,
23/08/2013,B.C.,"TECATE, B.C.",1,0,1,0,0,0,
24/08/2013,B.C.,"MEXICALI, B.C.",10,0,10,0,0,0,
24/08/2013,N.L.,"VALLECILLO, N.L.",1,6,7,6,0,450,
24/08/2013,B.C.,"TIJUANA, B.C.",3,1,4,0,0,0,
24/08/2013,JAL.,"TLAJOMULCO DE ZUÑIGA, JAL.",1,2,3,20,0,0,
24/08/2013,HGO.,"TEPEAPULCO, HGO.",0,2,2,0,0,0,
24/08/2013,PUE.,"TEPEXI DE RODRIGUEZ, PUE.",0,1,1,0,0,0,
24/08/2013,PUE.,"SAN SALVADOR EL SECO, PUE.",1,0,1,0,0,0,
24/08/2013,B.C.,"TECATE, B.C.",0,1,1,0,0,0,
24/08/2013,HGO.,"JACALA DE LEDEZMA, HGO.",1,0,1,0,0,0,
24/08/2013,JAL.,"CUAUTITLAN DE GARCIA BARRAGAN, JAL.",0,1,1,0,0,0,
24/08/2013,Q. ROO,"OTHON P. BLANCO, Q. ROO",0,0,0,0,0,1008,
24/08/2013,N.L.,"SAN PEDRO GARZA GARCIA, N.L.",0,0,0,3,0,150,
25/08/2013,N.L.,"VALLECILLO, N.L.",1,3,4,13,0,0,
25/08/2013,JAL.,"CUAUTITLAN DE GARCIA BARRAGAN, JAL.",0,3,3,0,0,0,
25/08/2013,MOR.,"CUAUTLA, MOR.",0,2,2,0,0,55,
25/08/2013,PUE.,"ATLIXCO, PUE.",0,0,0,0,0,630,
25/08/2013,PUE.,"ZACATLAN, PUE.",0,0,0,0,3,0,
26/08/2013,SON.,"NOGALES, SON.",22,13,35,265,3,685,
26/08/2013,D.F.,"IZTAPALAPA, D.F.",16,8,24,3,1,40,
26/08/2013,TLAX.,"TLAX., TLAX.",2,4,6,0,0,0,
26/08/2013,B.C.,"MEXICALI, B.C.",2,3,5,0,0,0,
26/08/2013,SIN.,"MAZATLAN, SIN.",3,2,5,0,0,0,
26/08/2013,B.C.,"TIJUANA, B.C.",2,1,3,0,0,0,
26/08/2013,HGO.,"JACALA DE LEDEZMA, HGO.",2,1,3,0,0,0,
26/08/2013,MOR.,"CUAUTLA, MOR.",2,0,2,0,1,180,
26/08/2013,HGO.,"TEPEAPULCO, HGO.",1,1,2,0,0,0,
26/08/2013,COAH.,"ACUÑA, COAH.",2,0,2,1,0,100,
26/08/2013,SON.,"CAJEME, SON.",2,0,2,0,0,0,
26/08/2013,TAB.,"CUNDUACAN, TAB.",1,0,1,0,0,11,
26/08/2013,PUE.,"ATLIXCO, PUE.",0,1,1,0,0,229,
26/08/2013,SON.,"HERMOSILLO, SON.",1,0,1,0,0,0,
27/08/2013,D.F.,"IZTAPALAPA, D.F.",15,15,30,0,2,70,
27/08/2013,SIN.,"MAZATLAN, SIN.",7,1,8,0,4,0,
27/08/2013,MOR.,"CUAUTLA, MOR.",3,3,6,4,1,2305,
27/08/2013,GTO.,"CELAYA, GTO.",4,2,6,0,0,0,
27/08/2013,B.C.,"MEXICALI, B.C.",5,0,5,0,0,0,
27/08/2013,TLAX.,"TLAX., TLAX.",2,0,2,1,0,0,
27/08/2013,N.L.,"PARAS, N.L.",0,2,2,10,0,150,
27/08/2013,N.L.,"SAN PEDRO GARZA GARCIA, N.L.",2,0,2,0,0,50,
27/08/2013,PUE.,"ATLIXCO, PUE.",2,0,2,0,0,116,
27/08/2013,HGO.,"SAN BARTOLO TUTOTEPEC, HGO.",1,0,1,0,0,0,
27/08/2013,HGO.,"JACALA DE LEDEZMA, HGO.",1,0,1,0,0,0,
27/08/2013,CAMP.,"CAMP., CAMP.",1,0,1,0,0,0,
27/08/2013,CHIH.,"BUENAVENTURA, CHIH.",1,0,1,0,0,77,
27/08/2013,SON.,"CAJEME, SON.",0,1,1,0,0,0,
27/08/2013,B.C.,"TIJUANA, B.C.",1,0,1,0,0,0,
27/08/2013,PUE.,"LIBRES, PUE.",0,0,0,0,0,100,
27/08/2013,GTO.,"CELAYA, GTO.",0,0,0,0,0,450,
28/08/2013,SON.,"AGUA PRIETA, SON.",20,22,42,20,1,659,
28/08/2013,D.F.,"IZTAPALAPA, D.F.",17,6,23,4,0,360,
28/08/2013,GTO.,"CELAYA, GTO.",2,18,20,4,0,1,
28/08/2013,PUE.,"ATLIXCO, PUE.",2,3,5,0,0,0,
28/08/2013,TLAX.,"TLAX., TLAX.",2,2,4,1,0,0,
28/08/2013,JAL.,"TEPATITLAN DE MOR., JAL.",3,0,3,0,0,0,
28/08/2013,COAH.,"ACUÑA, COAH.",1,2,3,0,0,0,
28/08/2013,HGO.,"TEPEAPULCO, HGO.",1,1,2,0,0,0,
28/08/2013,JAL.,"GUADALAJARA, JAL.",2,0,2,0,0,0,
28/08/2013,N.L.,"PARAS, N.L.",0,2,2,0,0,0,
28/08/2013,SIN.,"MAZATLAN, SIN.",1,1,2,0,7,0,
28/08/2013,B.C.,"TIJUANA, B.C.",2,0,2,0,0,0,
28/08/2013,GTO.,"SAN FRANCISCO DEL RINCON, GTO.",0,2,2,0,0,0,
28/08/2013,HGO.,"SAN BARTOLO TUTOTEPEC, HGO.",1,0,1,0,0,0,
28/08/2013,MOR.,"CUAUTLA, MOR.",1,0,1,1,0,0,
29/08/2013,D.F.,"IZTAPALAPA, D.F.",22,5,27,3,2,120,
29/08/2013,GTO.,"CELAYA, GTO.",14,5,19,0,0,0,
29/08/2013,JAL.,"GUADALAJARA, JAL.",5,3,8,6,0,36,
29/08/2013,TLAX.,"TLAX., TLAX.",2,3,5,0,0,34,
29/08/2013,JAL.,"JAMAY, JAL.",1,3,4,1,0,0,
29/08/2013,HGO.,"SAN BARTOLO TUTOTEPEC, HGO.",3,0,3,0,0,0,
29/08/2013,SIN.,"MAZATLAN, SIN.",1,2,3,0,4,0,
29/08/2013,N.L.,"CHINA, N.L.",2,1,3,4,0,0,
29/08/2013,GTO.,"SAN FRANCISCO DEL RINCON, GTO.",1,2,3,0,0,0,
29/08/2013,HGO.,"TEPEAPULCO, HGO.",1,1,2,0,0,0,
29/08/2013,Q. ROO,"OTHON P. BLANCO, Q. ROO",0,2,2,0,0,40,
29/08/2013,HGO.,"JACALA DE LEDEZMA, HGO.",0,1,1,0,0,0,
29/08/2013,SON.,"HERMOSILLO, SON.",1,0,1,0,0,14,
29/08/2013,SON.,"CAJEME, SON.",1,0,1,0,0,1,
29/08/2013,B.C.,"TIJUANA, B.C.",1,0,1,0,0,0,
29/08/2013,B.C.,"ENSENADA, B.C.",0,1,1,0,0,0,
29/08/2013,MOR.,"CUAUTLA, MOR.",1,0,1,1,0,60,
29/08/2013,PUE.,"LIBRES, PUE.",0,0,0,0,0,270,
29/08/2013,CHIH.,"NUEVO CASAS GRANDES, CHIH.",0,0,0,0,0,10,
30/08/2013,D.F.,"IZTAPALAPA, D.F.",32,11,43,5,0,110,
30/08/2013,TLAX.,"TLAX., TLAX.",6,4,10,5,0,9,
30/08/2013,GTO.,"CELAYA, GTO.",5,3,8,0,0,0,
30/08/2013,B.C.,"TIJUANA, B.C.",3,3,6,0,0,0,
30/08/2013,GTO.,"SAN FRANCISCO DEL RINCON, GTO.",3,2,5,0,0,0,
30/08/2013,SIN.,"MAZATLAN, SIN.",2,2,4,0,4,0,
30/08/2013,PUE.,"ATLIXCO, PUE.",2,2,4,9,0,0,
30/08/2013,JAL.,"GUADALAJARA, JAL.",3,1,4,0,1,0,
30/08/2013,JAL.,"TEPATITLAN DE MOR., JAL.",0,4,4,0,0,0,
30/08/2013,PUE.,"CHIGNAHUAPAN, PUE.",1,0,1,0,0,0,
30/08/2013,N.L.,"PARAS, N.L.",0,1,1,7,0,1600,
30/08/2013,N.L.,"CHINA, N.L.",1,0,1,0,0,0,
30/08/2013,Q. ROO,"OTHON P. BLANCO, Q. ROO",0,0,0,0,0,112,
30/08/2013,SON.,"CAJEME, SON.",0,0,0,0,0,40,
31/08/2013,TAMPS.,"VICTORIA, TAMPS.",8,0,8,2,0,367,
31/08/2013,TLAX.,"TLAX., TLAX.",4,3,7,1,0,0,
31/08/2013,SON.,"HERMOSILLO, SON.",2,2,4,2,0,114,
31/08/2013,HGO.,"SAN BARTOLO TUTOTEPEC, HGO.",1,3,4,0,0,0,
31/08/2013,HGO.,"TEPEAPULCO, HGO.",1,3,4,0,0,0,
31/08/2013,HGO.,"JACALA DE LEDEZMA, HGO.",2,1,3,0,0,0,
31/08/2013,B.C.,"ENSENADA, B.C.",0,2,2,0,0,0,
31/08/2013,GTO.,"CELAYA, GTO.",2,0,2,0,0,0,
31/08/2013,N.L.,"CHINA, N.L.",0,1,1,3,0,0,
31/08/2013,MOR.,"CUAUTLA, MOR.",1,0,1,0,0,0,
01/09/2013,GTO.,"CELAYA, GTO.",11,1,12,0,0,0,
01/09/2013,MOR.,"CUERNAVACA, MOR.",1,6,7,0,6,2213,
01/09/2013,PUE.,"ATLIXCO, PUE.",3,3,6,1,1,918,
01/09/2013,B.C.,"TIJUANA, B.C.",2,0,2,0,0,0,
01/09/2013,JAL.,"CUAUTITLAN DE GARCIA BARRAGAN, JAL.",1,1,2,0,1,200,
01/09/2013,TAMPS.,"GONZALEZ, TAMPS.",0,1,1,1,0,107,
01/09/2013,N.L.,"CHINA, N.L.",0,0,0,14,0,0,
02/09/2013,D.F.,"VENUSTIANO CARRANZA, D.F.",12,17,29,0,0,350,
02/09/2013,MOR.,"XOCHITEPEC, MOR.",1,1,2,1,1,159,
02/09/2013,CHIH.,"HGO. DEL PARRAL, CHIH.",0,1,1,0,0,0,
03/09/2013,SON.,"SAN LUIS RIO COLORADO, SON.",39,59,98,13,8,47,
03/09/2013,D.F.,"VENUSTIANO CARRANZA, D.F.",12,5,17,3,0,90,
03/09/2013,N.L.,"AGUALEGUAS, N.L.",1,7,8,2,0,0,
03/09/2013,N.L.,"GRAL. BRAVO, N.L.",2,4,6,0,0,0,
03/09/2013,MOR.,"XOCHITEPEC, MOR.",4,1,5,0,8,236,
03/09/2013,YUC.,"TEKOM, YUC.",1,2,3,0,0,0,
03/09/2013,PUE.,"ATLIXCO, PUE.",1,1,2,0,0,90,
03/09/2013,CHIH.,"HGO. DEL PARRAL, CHIH.",0,1,1,0,0,0,
03/09/2013,B.C.,"TIJUANA, B.C.",1,0,1,0,0,0,
04/09/2013,D.F.,"VENUSTIANO CARRANZA, D.F.",13,5,18,2,1,90,
04/09/2013,SON.,"SAN LUIS RIO COLORADO, SON.",1,5,6,1,3,0,
04/09/2013,N.L.,"AGUALEGUAS, N.L.",1,2,3,0,0,1240,
04/09/2013,N.L.,"GRAL. BRAVO, N.L.",0,3,3,6,0,900,
04/09/2013,TAMPS.,"VICTORIA, TAMPS.",0,3,3,0,6,100,
04/09/2013,Q. ROO,"OTHON P. BLANCO, Q. ROO",1,0,1,0,0,0,
04/09/2013,YUC.,"CHANKOM, YUC.",1,0,1,0,0,0,
04/09/2013,PUE.,"ATLIXCO, PUE.",1,0,1,1,0,528,
04/09/2013,COAH.,"ACUÑA, COAH.",1,0,1,0,0,0,
04/09/2013,Q. ROO,"BACALAR, Q. ROO",0,0,0,0,0,22,
04/09/2013,PUE.,"TEZIUTLAN, PUE.",0,0,0,0,0,831,
05/09/2013,D.F.,"VENUSTIANO CARRANZA, D.F.",20,19,39,4,1,700,
05/09/2013,SON.,"SAN LUIS RIO COLORADO, SON.",4,4,8,0,0,8,
05/09/2013,N.L.,"AGUALEGUAS, N.L.",0,7,7,2,0,65,
05/09/2013,B.C.,"TECATE, B.C.",1,2,3,0,0,0,
05/09/2013,MOR.,"XOCHITEPEC, MOR.",3,0,3,0,1,0,
05/09/2013,SON.,"HERMOSILLO, SON.",2,0,2,11,0,0,
05/09/2013,MOR.,"XOCHITEPEC, MOR.",2,0,2,1,0,0,
05/09/2013,SON.,"HERMOSILLO, SON.",1,0,1,1,0,0,
05/09/2013,SON.,"CAJEME, SON.",1,0,1,0,0,0,
05/09/2013,PUE.,"TEZIUTLAN, PUE.",1,0,1,0,0,274,
05/09/2013,B.C.,"ENSENADA, B.C.",0,1,1,0,0,0,
05/09/2013,COAH.,"ACUÑA, COAH.",1,0,1,0,0,0,
05/09/2013,PUE.,"ATLIXCO, PUE.",0,0,0,4,3,406,
05/09/2013,N.L.,"GRAL. BRAVO, N.L.",0,0,0,0,0,90,
05/09/2013,SON.,"CAJEME, SON.",0,0,0,0,0,160,
06/09/2013,D.F.,"VENUSTIANO CARRANZA, D.F.",28,5,33,5,0,300,
06/09/2013,B.C.,"TIJUANA, B.C.",2,3,5,0,0,0,
06/09/2013,TAMPS.,"VICTORIA, TAMPS.",4,0,4,0,1,0,
06/09/2013,N.L.,"GRAL. BRAVO, N.L.",0,3,3,0,0,202,
06/09/2013,N.L.,"AGUALEGUAS, N.L.",0,2,2,0,0,100,
06/09/2013,MOR.,"XOCHITEPEC, MOR.",2,0,2,1,0,0,
06/09/2013,YUC.,"TEKOM, YUC.",1,0,1,0,0,0,
06/09/2013,PUE.,"ATLIXCO, PUE.",1,0,1,0,0,146,
06/09/2013,Q. ROO,"OTHON P. BLANCO, Q. ROO",1,0,1,0,0,372,
06/09/2013,CHIH.,"CASAS GRANDES, CHIH.",1,0,1,0,0,0,
06/09/2013,CHIH.,"ALDAMA, CHIH.",1,0,1,0,0,0,
06/09/2013,PUE.,"TEZIUTLAN, PUE.",0,0,0,0,0,70,
07/09/2013,N.L.,"GRAL. BRAVO, N.L.",3,4,7,1,0,0,
07/09/2013,SON.,"SAN LUIS RIO COLORADO, SON.",4,3,7,1,0,0,
07/09/2013,MOR.,"XOCHITEPEC, MOR.",2,1,3,1,2,0,
07/09/2013,B.C.,"ENSENADA, B.C.",2,1,3,0,0,0,
07/09/2013,COAH.,"ACUÑA, COAH.",2,0,2,0,0,0,
07/09/2013,B.C.,"TECATE, B.C.",2,0,2,0,0,0,
07/09/2013,PUE.,"ATLIXCO, PUE.",1,1,2,1,0,326,
07/09/2013,TAMPS.,"GONZALEZ, TAMPS.",1,0,1,0,0,0,
07/09/2013,PUE.,"CALPAN, PUE.",1,0,1,0,0,50,
07/09/2013,PUE.,"TEZIUTLAN, PUE.",0,0,0,0,0,150,
08/09/2013,B.C.,"TIJUANA, B.C.",1,2,3,0,0,0,
08/09/2013,MOR.,"XOCHITEPEC, MOR.",2,0,2,0,1,0,
08/09/2013,N.L.,"GRAL. BRAVO, N.L.",0,2,2,0,0,0,
08/09/2013,SON.,"SAN LUIS RIO COLORADO, SON.",2,0,2,1,4,0,
08/09/2013,B.C.,"ENSENADA, B.C.",0,1,1,0,0,0,
09/09/2013,D.F.,"IZTACALCO, D.F.",19,5,24,4,4,95,
09/09/2013,B.C.,"MEXICALI, B.C.",10,2,12,0,0,0,
09/09/2013,SON.,"SAN LUIS RIO COLORADO, SON.",2,4,6,3,0,0,
09/09/2013,MOR.,"XOCHITEPEC, MOR.",2,2,4,1,0,327,
09/09/2013,B.C.,"TIJUANA, B.C.",1,3,4,0,0,0,
09/09/2013,TAMPS.,"VICTORIA, TAMPS.",3,1,4,0,1,0,
09/09/2013,N.L.,"DR. COSS, N.L.",0,3,3,0,0,0,
09/09/2013,B.C.,"ENSENADA, B.C.",2,0,2,0,0,0,
09/09/2013,N.L.,"GRAL. BRAVO, N.L.",1,0,1,0,0,50,
09/09/2013,PUE.,"TEZIUTLAN, PUE.",0,0,0,0,0,715,
10/09/2013,D.F.,"IZTACALCO, D.F.",19,3,22,3,0,350,
10/09/2013,SON.,"SAN LUIS RIO COLORADO, SON.",3,3,6,1,1,0,
10/09/2013,B.C.,"TIJUANA, B.C.",2,3,5,0,0,0,
10/09/2013,SON.,"HERMOSILLO, SON.",0,4,4,0,0,0,
10/09/2013,B.C.,"ENSENADA, B.C.",1,2,3,0,0,0,
10/09/2013,B.C.,"MEXICALI, B.C.",2,1,3,0,0,0,
10/09/2013,PUE.,"ATLIXCO, PUE.",2,1,3,0,0,176,
10/09/2013,MOR.,"XOCHITEPEC, MOR.",1,1,2,0,0,1,
10/09/2013,N.L.,"GRAL. TREVIÑO, N.L.",0,2,2,6,0,20,
10/09/2013,N.L.,"DR. COSS, N.L.",0,1,1,6,0,0,
10/09/2013,PUE.,"TEZIUTLAN, PUE.",0,0,0,0,0,150,
11/09/2013,D.F.,"IZTACALCO, D.F.",22,5,27,2,1,80,
11/09/2013,SON.,"SAN LUIS RIO COLORADO, SON.",4,1,5,0,0,0,
11/09/2013,B.C.,"TIJUANA, B.C.",2,2,4,0,0,0,
11/09/2013,MOR.,"XOCHITEPEC, MOR.",2,0,2,1,0,110,
11/09/2013,B.C.,"ENSENADA, B.C.",1,0,1,0,0,0,
11/09/2013,Q. ROO,"LAZARO CARDENAS, Q. ROO",1,0,1,0,0,0,
11/09/2013,PUE.,"ATLIXCO, PUE.",1,0,1,6,3,802,
11/09/2013,PUE.,"TEZIUTLAN, PUE.",0,1,1,0,0,0,
11/09/2013,SON.,"HERMOSILLO, SON.",0,0,0,0,0,750,
12/09/2013,D.F.,"IZTACALCO, D.F.",12,10,22,3,0,1210,
12/09/2013,B.C.,"MEXICALI, B.C.",9,2,11,0,0,0,
12/09/2013,SON.,"SAN LUIS RIO COLORADO, SON.",3,2,5,3,0,46,
12/09/2013,CHIH.,"GALEANA, CHIH.",3,0,3,0,0,65,
12/09/2013,MOR.,"XOCHITEPEC, MOR.",3,0,3,1,0,99,
12/09/2013,B.C.,"TIJUANA, B.C.",2,1,3,0,0,0,
12/09/2013,B.C.,"TECATE, B.C.",0,2,2,0,0,0,
12/09/2013,PUE.,"ATLIXCO, PUE.",2,0,2,0,1,0,
12/09/2013,SON.,"CAJEME, SON.",1,0,1,0,0,0,
12/09/2013,COAH.,"ACUÑA, COAH.",0,1,1,0,0,0,
12/09/2013,SON.,"HERMOSILLO, SON.",0,0,0,0,0,10,
12/09/2013,TAMPS.,"VICTORIA, TAMPS.",0,0,0,1,0,255,
12/09/2013,PUE.,"CALPAN, PUE.",0,0,0,0,0,250,
13/09/2013,D.F.,"IZTACALCO, D.F.",35,11,46,5,1,20,
13/09/2013,B.C.,"MEXICALI, B.C.",12,2,14,0,0,0,
13/09/2013,B.C.,"TIJUANA, B.C.",2,4,6,0,0,0,
13/09/2013,SON.,"SAN LUIS RIO COLORADO, SON.",0,3,3,6,0,0,
13/09/2013,MOR.,"XOCHITEPEC, MOR.",1,1,2,0,1,132,
13/09/2013,CHIH.,"OJINAGA, CHIH.",0,2,2,0,0,0,
14/09/2013,SON.,"SAN LUIS RIO COLORADO, SON.",2,5,7,3,1,0,
14/09/2013,MOR.,"XOCHITEPEC, MOR.",2,1,3,1,2,0,
14/09/2013,B.C.,"MEXICALI, B.C.",3,0,3,0,0,0,
14/09/2013,B.C.,"TIJUANA, B.C.",1,1,2,0,0,0,
14/09/2013,SON.,"HERMOSILLO, SON.",0,1,1,6,0,0,
14/09/2013,COAH.,"ACUÑA, COAH.",0,1,1,0,0,0,
14/09/2013,N.L.,"MELCHOR OCAMPO, N.L.",0,1,1,0,0,0,
14/09/2013,OAX.,"MIAHUATLAN DE PORFIRIO DIAZ, OAX.",0,0,0,0,0,667,
16/09/2013,SON.,"SAN LUIS RIO COLORADO, SON.",1,0,1,0,0,0,
17/09/2013,SON.,"SAN LUIS RIO COLORADO, SON.",1,3,4,0,3,0,
17/09/2013,SIN.,"CULIACAN, SIN.",0,1,1,2,0,0,
17/09/2013,PUE.,"ATLIXCO, PUE.",0,1,1,0,2,0,
17/09/2013,CHIH.,"GALEANA, CHIH.",0,0,0,0,4,0,
17/09/2013,OAX.,"MIAHUATLAN DE PORFIRIO DIAZ, OAX.",0,0,0,3,0,174,
17/09/2013,PUE.,"TEZIUTLAN, PUE.",0,0,0,0,0,850,
18/09/2013,SON.,"SAN LUIS RIO COLORADO, SON.",0,5,5,5,0,4,
18/09/2013,PUE.,"ATLIXCO, PUE.",1,0,1,0,0,0,
18/09/2013,PUE.,"TEZIUTLAN, PUE.",0,1,1,0,0,25,
18/09/2013,MOR.,"XOCHITEPEC, MOR.",0,1,1,0,0,0,
19/09/2013,SON.,"SAN LUIS RIO COLORADO, SON.",2,3,5,0,0,0,
19/09/2013,SON.,"HERMOSILLO, SON.",1,0,1,4,0,47,
19/09/2013,PUE.,"ATLIXCO, PUE.",0,1,1,1,3,0,
19/09/2013,MOR.,"XOCHITEPEC, MOR.",1,0,1,0,0,0,
20/09/2013,SON.,"SAN LUIS RIO COLORADO, SON.",1,2,3,0,1,0,
20/09/2013,PUE.,"ATLIXCO, PUE.",1,0,1,0,0,400,
20/09/2013,PUE.,"TEZIUTLAN, PUE.",1,0,1,0,0,0,
20/09/2013,SON.,"CAJEME, SON.",1,0,1,0,0,0,
20/09/2013,CHIH.,"ALDAMA, CHIH.",1,0,1,0,0,0,
20/09/2013,MOR.,"XOCHITEPEC, MOR.",0,1,1,0,2,0,
20/09/2013,B.C.,"TIJUANA, B.C.",1,0,1,0,0,0,
20/09/2013,B.C.,"ENSENADA, B.C.",1,0,1,0,0,0,
20/09/2013,SON.,"HERMOSILLO, SON.",0,0,0,0,0,13,
20/09/2013,TAMPS.,"NUEVO LAREDO, TAMPS.",0,0,0,3,0,70,
21/09/2013,MOR.,"XOCHITEPEC, MOR.",2,0,2,0,0,0,
21/09/2013,B.C.,"TECATE, B.C.",0,2,2,0,0,0,
21/09/2013,SON.,"SAN LUIS RIO COLORADO, SON.",1,1,2,2,1,5,
21/09/2013,SON.,"CAJEME, SON.",0,1,1,0,0,0,
21/09/2013,PUE.,"ATLIXCO, PUE.",1,0,1,0,0,0,
21/09/2013,TAMPS.,"NUEVO LAREDO, TAMPS.",0,0,0,0,1,400,
22/09/2013,PUE.,"ATLIXCO, PUE.",4,0,4,0,0,1070,
22/09/2013,MOR.,"XOCHITEPEC, MOR.",2,0,2,0,1,0,
23/09/2013,D.F.,"XOCHIMILCO, D.F.",16,3,19,3,0,100,
23/09/2013,SIN.,"CULIACAN, SIN.",3,1,4,3,3,9,
23/09/2013,PUE.,"ATLIXCO, PUE.",2,0,2,0,1,378,
23/09/2013,PUE.,"TEZIUTLAN, PUE.",1,0,1,0,0,24,
23/09/2013,SON.,"CAJEME, SON.",1,0,1,0,0,0,
23/09/2013,B.C.,"ENSENADA, B.C.",1,0,1,0,0,0,
23/09/2013,SON.,"SAN LUIS RIO COLORADO, SON.",1,0,1,1,0,60,
24/09/2013,D.F.,"XOCHIMILCO, D.F.",19,10,29,7,1,200,
24/09/2013,SIN.,"CULIACAN, SIN.",6,3,9,0,6,0,
24/09/2013,SON.,"SAN LUIS RIO COLORADO, SON.",1,4,5,2,2,0,
24/09/2013,B.C.,"TIJUANA, B.C.",2,2,4,0,0,0,
24/09/2013,PUE.,"ATLIXCO, PUE.",2,1,3,0,2,35,
24/09/2013,B.C.,"ENSENADA, B.C.",0,2,2,0,0,0,
24/09/2013,PUE.,"CALPAN, PUE.",1,0,1,0,0,0,
24/09/2013,OAX.,"PINOTEPA DE DON LUIS, OAX.",0,1,1,0,0,0,
25/09/2013,D.F.,"XOCHIMILCO, D.F.",32,7,39,8,1,50,
25/09/2013,SIN.,"CULIACAN, SIN.",8,0,8,0,7,0,
25/09/2013,ZAC.,"GUADALUPE, ZAC.",4,0,4,2,0,0,
25/09/2013,YUC.,"TIXKOKOB, YUC.",3,0,3,0,0,0,
25/09/2013,B.C.,"TIJUANA, B.C.",2,1,3,0,0,0,
25/09/2013,MOR.,"TEMIXCO, MOR.",2,0,2,0,0,0,
25/09/2013,PUE.,"ATLIXCO, PUE.",1,0,1,0,0,326,
25/09/2013,PUE.,"CALPAN, PUE.",0,1,1,0,0,0,
25/09/2013,B.C.,"ENSENADA, B.C.",1,0,1,0,0,0,
26/09/2013,D.F.,"XOCHIMILCO, D.F.",36,5,41,4,0,1000,
26/09/2013,ZAC.,"FRESNILLO, ZAC.",11,6,17,0,1,13,
26/09/2013,SIN.,"CULIACAN, SIN.",7,0,7,2,0,51,
26/09/2013,B.C.,"TIJUANA, B.C.",3,2,5,0,0,0,
26/09/2013,B.C.,"ENSENADA, B.C.",2,3,5,0,0,0,
26/09/2013,ZAC.,"JALPA, ZAC.",4,0,4,0,0,100,
26/09/2013,MOR.,"XOCHITEPEC, MOR.",3,0,3,0,0,65,
26/09/2013,ZAC.,"TLALTENANGO DE SANCHEZ ROMAN, ZAC.",1,2,3,0,0,0,
26/09/2013,PUE.,"ATLIXCO, PUE.",1,1,2,6,0,20,
26/09/2013,SON.,"HERMOSILLO, SON.",1,1,2,0,0,160,
26/09/2013,SON.,"CAJEME, SON.",1,1,2,1,0,32,
26/09/2013,ZAC.,"JALPA, ZAC.",1,0,1,0,0,0,
26/09/2013,SON.,"SAN LUIS RIO COLORADO, SON.",0,0,0,0,1,0,
26/09/2013,PUE.,"TEZIUTLAN, PUE.",0,0,0,39,0,0,
26/09/2013,TAMPS.,"NUEVO LAREDO, TAMPS.",0,0,0,8,1,430,
27/09/2013,D.F.,"XOCHIMILCO, D.F.",32,10,42,3,1,60,
27/09/2013,SIN.,"CULIACAN, SIN.",16,7,23,0,4,0,
27/09/2013,ZAC.,"TLALTENANGO DE SANCHEZ ROMAN, ZAC.",5,0,5,3,0,26,
27/09/2013,ZAC.,"FRESNILLO, ZAC.",4,1,5,0,0,72,
27/09/2013,MOR.,"XOCHITEPEC, MOR.",1,1,2,0,0,129,
27/09/2013,ZAC.,"GUADALUPE, ZAC.",2,0,2,1,0,231,
27/09/2013,NAY.,"ACAPONETA, NAY.",2,0,2,0,0,0,
27/09/2013,ZAC.,"JALPA, ZAC.",1,0,1,0,0,0,
27/09/2013,NAY.,"TEPIC, NAY.",1,0,1,1,0,0,
27/09/2013,TAMPS.,"NUEVO LAREDO, TAMPS.",0,1,1,4,0,118,
28/09/2013,B.C.,"TIJUANA, B.C.",3,3,6,0,0,0,
28/09/2013,ZAC.,"TLALTENANGO DE SANCHEZ ROMAN, ZAC.",5,0,5,0,0,0,
28/09/2013,ZAC.,"GUADALUPE, ZAC.",3,0,3,0,0,7,
28/09/2013,MOR.,"XOCHITEPEC, MOR.",2,0,2,0,2,25,
28/09/2013,ZAC.,"FRESNILLO, ZAC.",1,0,1,0,0,0,
28/09/2013,OAX.,"MIAHUATLAN DE PORFIRIO DIAZ, OAX.",0,0,0,1,0,0,
29/09/2013,B.C.,"ENSENADA, B.C.",2,0,2,0,0,0,
29/09/2013,MOR.,"XOCHITEPEC, MOR.",0,0,0,0,0,113,
30/09/2013,D.F.,"AZCAPOTZALCO, D.F.",7,5,12,2,2,20,
30/09/2013,NAY.,"TEPIC, NAY.",1,0,1,0,0,0,
30/09/2013,MOR.,"XOCHITEPEC, MOR.",1,0,1,0,3,33,
30/09/2013,N.L.,"CADEREYTA JIMENEZ, N.L.",0,1,1,0,0,14,
30/09/2013,SON.,"CAJEME, SON.",0,0,0,0,0,20,
01/10/2013,D.F.,"AZCAPOTZALCO, D.F.",10,7,17,3,8,160,
01/10/2013,N.L.,"ANAHUAC, N.L.",4,10,14,3,0,0,
01/10/2013,SIN.,"ROSARIO, SIN.",0,4,4,0,1,0,
01/10/2013,B.C.,"TIJUANA, B.C.",2,2,4,0,0,0,
01/10/2013,B.C.,"ENSENADA, B.C.",2,2,4,0,0,0,
01/10/2013,YUC.,"CHOCHOLA, YUC.",1,1,2,0,0,0,
01/10/2013,CHIS.,"MAPASTEPEC, CHIS.",2,0,2,0,0,0,
01/10/2013,SON.,"CAJEME, SON.",1,0,1,0,0,0,
01/10/2013,NAY.,"TEPIC, NAY.",0,1,1,1,0,0,
01/10/2013,CHIS.,"ARRIAGA, CHIS.",0,1,1,0,0,39,
02/10/2013,D.F.,"AZCAPOTZALCO, D.F.",23,10,33,4,6,100,
02/10/2013,N.L.,"LAMPAZOS DE NARANJO, N.L.",4,6,10,1,0,40,
02/10/2013,ZAC.,"FRESNILLO, ZAC.",8,0,8,1,0,0,
02/10/2013,SIN.,"ROSARIO, SIN.",2,5,7,0,0,0,
02/10/2013,N.L.,"CADEREYTA JIMENEZ, N.L.",2,1,3,1,0,0,
02/10/2013,B.C.,"TIJUANA, B.C.",3,0,3,0,0,0,
02/10/2013,ZAC.,"ZAC., ZAC.",3,0,3,4,2,449,
02/10/2013,B.C.,"TECATE, B.C.",0,2,2,0,0,0,
02/10/2013,SON.,"CAJEME, SON.",1,1,2,1,0,0,
02/10/2013,ZAC.,"TLALTENANGO DE SANCHEZ ROMAN, ZAC.",2,0,2,9,4,142,
02/10/2013,B.C.,"ENSENADA, B.C.",1,0,1,0,0,0,
02/10/2013,NAY.,"ACAPONETA, NAY.",0,1,1,0,0,0,
02/10/2013,YUC.,"CHOCHOLA, YUC.",0,1,1,0,0,0,
02/10/2013,CHIS.,"MAPASTEPEC, CHIS.",1,0,1,1,0,0,
02/10/2013,CHIS.,"ARRIAGA, CHIS.",1,0,1,0,0,0,
03/10/2013,D.F.,"AZCAPOTZALCO, D.F.",14,1,15,5,0,380,
03/10/2013,SIN.,"ROSARIO, SIN.",3,7,10,0,1,0,
03/10/2013,ZAC.,"GUADALUPE, ZAC.",6,0,6,1,0,673,
03/10/2013,N.L.,"LAMPAZOS DE NARANJO, N.L.",0,4,4,3,0,125,
03/10/2013,N.L.,"CADEREYTA JIMENEZ, N.L.",3,0,3,0,0,50,
03/10/2013,B.C.,"TIJUANA, B.C.",2,0,2,0,0,0,
03/10/2013,ZAC.,"JEREZ, ZAC.",2,0,2,0,0,23,
03/10/2013,ZAC.,"FRESNILLO, ZAC.",0,2,2,0,1,0,
03/10/2013,NAY.,"TEPIC, NAY.",1,0,1,1,0,0,
03/10/2013,VER.,"CATEMACO, VER.",1,0,1,0,0,0,
03/10/2013,ZAC.,"VALPARAISO, ZAC.",1,0,1,1,0,0,
04/10/2013,D.F.,"AZCAPOTZALCO, D.F.",24,9,33,12,1,400,
04/10/2013,ZAC.,"FRESNILLO, ZAC.",6,3,9,4,0,0,
04/10/2013,ZAC.,"GUADALUPE, ZAC.",5,0,5,0,0,125,
04/10/2013,ZAC.,"JEREZ, ZAC.",4,1,5,2,0,30,
04/10/2013,N.L.,"LAMPAZOS DE NARANJO, N.L.",1,3,4,0,0,0,
04/10/2013,NAY.,"TEPIC, NAY.",3,0,3,0,0,0,
04/10/2013,SIN.,"ROSARIO, SIN.",2,1,3,0,3,0,
04/10/2013,ZAC.,"ZAC., ZAC.",2,0,2,3,0,490,
04/10/2013,B.C.,"TIJUANA, B.C.",1,1,2,0,0,0,
04/10/2013,NAY.,"ACAPONETA, NAY.",0,1,1,0,0,0,
04/10/2013,COAH.,"SALTILLO, COAH.",1,0,1,0,0,0,
04/10/2013,COAH.,"MÚZQUIZ, COAH.",0,1,1,0,0,0,
04/10/2013,ZAC.,"VALPARAISO, ZAC.",1,0,1,1,0,0,
04/10/2013,ZAC.,"APOZOL, ZAC.",1,0,1,0,0,200,
04/10/2013,B.C.,"TECATE, B.C.",1,0,1,0,0,0,
04/10/2013,CHIS.,"MAPASTEPEC, CHIS.",0,0,0,0,1,0,
04/10/2013,COAH.,"MONCLOVA, COAH.",0,0,0,1,0,40,
04/10/2013,N.L.,"CADEREYTA JIMENEZ, N.L.",0,0,0,2,0,900,
05/10/2013,N.L.,"LAMPAZOS DE NARANJO, N.L.",1,1,2,2,0,0,
06/10/2013,N.L.,"MIER Y NORIEGA, N.L.",1,0,1,0,0,0,
07/10/2013,D.F.,"LA MAGDALENA CONTRERAS, D.F.",9,4,13,2,1,250,
07/10/2013,CHIS.,"TAPACHULA, CHIS.",5,3,8,0,0,0,
07/10/2013,ZAC.,"ZAC., ZAC.",3,3,6,1,0,260,
07/10/2013,COAH.,"MONCLOVA, COAH.",4,1,5,0,1,88,
07/10/2013,AGS.,"AGS., AGS.",3,1,4,0,0,495,
07/10/2013,N.L.,"BUSTAMANTE, N.L.",1,2,3,0,0,50,
07/10/2013,COAH.,"SALTILLO, COAH.",3,0,3,0,0,100,
07/10/2013,COAH.,"MÚZQUIZ, COAH.",1,2,3,0,0,0,
07/10/2013,SIN.,"ESCUINAPA, SIN.",1,1,2,0,0,0,
07/10/2013,ZAC.,"JEREZ, ZAC.",1,0,1,1,0,23,
07/10/2013,ZAC.,"RIO GRANDE, ZAC.",1,0,1,1,0,0,
07/10/2013,ZAC.,"VALPARAISO, ZAC.",1,0,1,1,0,0,
07/10/2013,CHIS.,"ARRIAGA, CHIS.",1,0,1,0,0,0,
07/10/2013,N.L.,"PESQUERIA, N.L.",1,0,1,5,0,0,
07/10/2013,SON.,"HERMOSILLO, SON.",1,0,1,14,0,0,
07/10/2013,NAY.,"TEPIC, NAY.",1,0,1,0,0,0,
07/10/2013,TAMPS.,"VICTORIA, TAMPS.",1,0,1,0,0,285,
07/10/2013,ZAC.,"TLALTENANGO DE SANCHEZ ROMAN, ZAC.",0,0,0,6,0,10,
07/10/2013,ZAC.,"NOCHISTLAN DE MEJIA, ZAC.",0,0,0,0,0,100,
07/10/2013,SON.,"CAJEME, SON.",0,0,0,0,0,2170,
07/10/2013,COAH.,"NUEVA ROSITA, COAH.",0,0,0,0,0,19,
08/10/2013,D.F.,"LA MAGDALENA CONTRERAS, D.F.",9,1,10,3,0,350,
08/10/2013,YUC.,"UMAN, YUC.",4,1,5,0,0,0,
08/10/2013,ZAC.,"JEREZ, ZAC.",5,0,5,0,0,100,
08/10/2013,COAH.,"SALTILLO, COAH.",4,1,5,0,0,35,
08/10/2013,COAH.,"SABINAS, COAH.",4,1,5,0,0,190,
08/10/2013,ZAC.,"GUADALUPE, ZAC.",4,0,4,1,0,215,
08/10/2013,ZAC.,"FRESNILLO, ZAC.",3,1,4,0,2,0,
08/10/2013,AGS.,"AGS., AGS.",3,0,3,0,0,44,
08/10/2013,SON.,"HERMOSILLO, SON.",1,2,3,7,0,17,
08/10/2013,COAH.,"MÚZQUIZ, COAH.",3,0,3,10,0,50,
08/10/2013,COAH.,"NUEVA ROSITA, COAH.",1,2,3,0,0,0,
08/10/2013,N.L.,"PESQUERIA, N.L.",1,2,3,2,0,50,
08/10/2013,NAY.,"TEPIC, NAY.",1,1,2,0,0,0,
08/10/2013,CHIS.,"ARRIAGA, CHIS.",1,1,2,0,0,0,
08/10/2013,SIN.,"ESCUINAPA, SIN.",1,1,2,0,0,0,
08/10/2013,ZAC.,"ZAC., ZAC.",2,0,2,0,0,29,
08/10/2013,CHIH.,"NUEVO CASAS GRANDES, CHIH.",0,2,2,0,0,11,
08/10/2013,ZAC.,"TLALTENANGO DE SANCHEZ ROMAN, ZAC.",0,1,1,0,0,0,
08/10/2013,SON.,"CAJEME, SON.",1,0,1,0,0,180,
08/10/2013,TAMPS.,"VICTORIA, TAMPS.",1,0,1,0,0,285,
08/10/2013,CHIS.,"TAPACHULA, CHIS.",0,0,0,0,0,67,
08/10/2013,COAH.,"MONCLOVA, COAH.",0,0,0,0,0,90,
09/10/2013,D.F.,"LA MAGDALENA CONTRERAS, D.F.",27,6,33,5,2,120,
09/10/2013,COAH.,"SALTILLO, COAH.",7,0,7,11,0,488,
09/10/2013,SIN.,"ESCUINAPA, SIN.",4,2,6,0,0,0,
09/10/2013,COAH.,"SABINAS, COAH.",2,4,6,0,0,0,
09/10/2013,AGS.,"AGS., AGS.",5,1,6,0,0,212,
09/10/2013,ZAC.,"FRESNILLO, ZAC.",5,0,5,1,0,124,
09/10/2013,COAH.,"MONCLOVA, COAH.",4,1,5,3,1,434,
09/10/2013,OAX.,"CIUDAD IXTEPEC, OAX.",2,2,4,6,0,0,
09/10/2013,COAH.,"PIEDRAS NEGRAS, COAH.",3,1,4,1,0,50,
09/10/2013,CHIS.,"TAPACHULA, CHIS.",3,0,3,0,0,95,
09/10/2013,ZAC.,"GUADALUPE, ZAC.",3,0,3,3,0,270,
09/10/2013,ZAC.,"TLALTENANGO DE SANCHEZ ROMAN, ZAC.",2,1,3,0,0,184,
09/10/2013,ZAC.,"ZAC., ZAC.",2,0,2,9,0,11,
09/10/2013,YUC.,"UMAN, YUC.",2,0,2,0,0,0,
09/10/2013,N.L.,"VILLALDAMA, N.L.",2,0,2,0,0,0,
09/10/2013,SON.,"HERMOSILLO, SON.",2,0,2,6,0,112,
09/10/2013,CHIS.,"ARRIAGA, CHIS.",1,0,1,0,0,0,
09/10/2013,B.C.,"ENSENADA, B.C.",0,1,1,0,0,0,
09/10/2013,ZAC.,"JEREZ, ZAC.",0,0,0,8,0,140,
09/10/2013,N.L.,"PESQUERIA, N.L.",0,0,0,1,0,50,
10/10/2013,D.F.,"LA MAGDALENA CONTRERAS, D.F.",23,5,28,6,1,30,
10/10/2013,COAH.,"PIEDRAS NEGRAS, COAH.",8,8,16,0,0,265,
10/10/2013,COAH.,"SABINAS, COAH.",3,3,6,0,0,298,
10/10/2013,ZAC.,"FRESNILLO, ZAC.",4,1,5,2,1,138,
10/10/2013,SIN.,"ESCUINAPA, SIN.",2,3,5,0,0,0,
10/10/2013,COAH.,"SALTILLO, COAH.",4,0,4,0,0,311,
10/10/2013,OAX.,"CIUDAD IXTEPEC, OAX.",0,3,3,0,0,0,
10/10/2013,ZAC.,"VALPARAISO, ZAC.",2,0,2,2,0,0,
10/10/2013,NAY.,"TEPIC, NAY.",1,1,2,0,0,0,
10/10/2013,CHIS.,"TAPACHULA, CHIS.",1,0,1,0,0,0,
10/10/2013,CHIS.,"MAPASTEPEC, CHIS.",1,0,1,0,0,0,
10/10/2013,VER.,"XALAPA, VER.",1,0,1,0,0,0,
10/10/2013,ZAC.,"ZAC., ZAC.",0,1,1,1,0,17,
10/10/2013,ZAC.,"GUADALUPE, ZAC.",1,0,1,0,0,50,
10/10/2013,ZAC.,"TLALTENANGO DE SANCHEZ ROMAN, ZAC.",1,0,1,8,0,232,
10/10/2013,SON.,"CAJEME, SON.",1,0,1,0,0,0,
10/10/2013,COAH.,"MONCLOVA, COAH.",1,0,1,0,0,510,
10/10/2013,N.L.,"VILLALDAMA, N.L.",0,1,1,0,0,0,
10/10/2013,CHIS.,"REFORMA, CHIS.",0,0,0,0,1,50,
11/10/2013,D.F.,"LA MAGDALENA CONTRERAS, D.F.",19,1,20,2,0,180,
11/10/2013,COAH.,"NUEVA ROSITA, COAH.",6,8,14,11,0,178,
11/10/2013,COAH.,"PIEDRAS NEGRAS, COAH.",9,4,13,1,1,885,
11/10/2013,COAH.,"SALTILLO, COAH.",8,1,9,0,0,133,
11/10/2013,SIN.,"ESCUINAPA, SIN.",3,5,8,0,0,0,
11/10/2013,COAH.,"SABINAS, COAH.",2,2,4,3,0,72,
11/10/2013,N.L.,"VILLALDAMA, N.L.",0,4,4,2,0,250,
11/10/2013,ZAC.,"GUADALUPE, ZAC.",3,0,3,0,0,180,
11/10/2013,OAX.,"SANTA MARIA MIXTEQUILLA, OAX.",0,3,3,0,0,0,
11/10/2013,ZAC.,"JEREZ, ZAC.",1,1,2,1,0,90,
11/10/2013,ZAC.,"RIO GRANDE, ZAC.",2,0,2,0,0,127,
11/10/2013,COAH.,"MONCLOVA, COAH.",2,0,2,0,0,424,
11/10/2013,JAL.,"TOTOTLAN, JAL.",0,2,2,1,0,0,
11/10/2013,ZAC.,"GUADALUPE, ZAC.",1,1,2,0,0,40,
11/10/2013,ZAC.,"VALPARAISO, ZAC.",2,0,2,0,0,0,
11/10/2013,ZAC.,"TLALTENANGO DE SANCHEZ ROMAN, ZAC.",1,0,1,0,0,50,
11/10/2013,COAH.,"TORREÓN, COAH.",1,0,1,0,0,0,
11/10/2013,AGS.,"AGS., AGS.",1,0,1,13,0,24,
11/10/2013,CHIS.,"TAPACHULA, CHIS.",1,0,1,0,0,138,
11/10/2013,CHIS.,"CINTALAPA, CHIS.",1,0,1,0,0,0,
11/10/2013,TAMPS.,"VICTORIA, TAMPS.",1,0,1,2,1,115,
11/10/2013,ZAC.,"ZAC., ZAC.",0,1,1,0,0,23,
11/10/2013,ZAC.,"ZAC., ZAC.",0,0,0,0,0,307,
11/10/2013,N.L.,"MIER Y NORIEGA, N.L.",0,0,0,21,0,150,
12/10/2013,COAH.,"PIEDRAS NEGRAS, COAH.",9,12,21,2,0,738,
12/10/2013,OAX.,"SANTA MARIA MIXTEQUILLA, OAX.",0,5,5,0,0,36,
12/10/2013,SON.,"HERMOSILLO, SON.",2,1,3,0,0,40,
12/10/2013,SON.,"CAJEME, SON.",1,0,1,0,0,0,
12/10/2013,COAH.,"MÚZQUIZ, COAH.",1,0,1,1,0,0,
12/10/2013,B.C.,"TIJUANA, B.C.",1,0,1,0,0,0,
13/10/2013,ZAC.,"CAÑITAS DE FELIPE PESCADOR, ZAC.",1,0,1,0,0,0,
14/10/2013,D.F.,"COYOACAN, D.F.",10,4,14,2,0,3,
14/10/2013,SIN.,"CONCORDIA, SIN.",2,6,8,0,0,0,
14/10/2013,COAH.,"PIEDRAS NEGRAS, COAH.",5,3,8,0,0,342,
14/10/2013,ZAC.,"CAÑITAS DE FELIPE PESCADOR, ZAC.",1,3,4,4,0,110,
14/10/2013,COAH.,"MONCLOVA, COAH.",2,1,3,4,0,155,
14/10/2013,ZAC.,"TLALTENANGO DE SANCHEZ ROMAN, ZAC.",2,1,3,0,0,27,
14/10/2013,ZAC.,"JEREZ, ZAC.",3,0,3,0,0,30,
14/10/2013,COAH.,"SALTILLO, COAH.",2,0,2,0,0,444,
14/10/2013,NAY.,"HUAJICORI, NAY.",1,0,1,0,0,0,
14/10/2013,HGO.,"ZACUALTIPAN DE ANGELES, HGO.",1,0,1,0,0,0,
14/10/2013,HGO.,"TULANCINGO DE BRAVO, HGO.",1,0,1,0,0,1802,
14/10/2013,CHIS.,"TAPACHULA, CHIS.",1,0,1,0,0,48,
14/10/2013,ZAC.,"TAB., ZAC.",1,0,1,0,0,0,
14/10/2013,ZAC.,"GUADALUPE, ZAC.",0,0,0,0,0,1430,
15/10/2013,D.F.,"COYOACAN, D.F.",20,8,28,3,0,230,
15/10/2013,COAH.,"PIEDRAS NEGRAS, COAH.",3,9,12,1,0,417,
15/10/2013,ZAC.,"FRESNILLO, ZAC.",7,0,7,10,0,25,
15/10/2013,SIN.,"CONCORDIA, SIN.",5,1,6,0,0,0,
15/10/2013,JAL.,"TIZAPAN EL ALTO, JAL.",0,6,6,1,0,0,
15/10/2013,COAH.,"SABINAS, COAH.",2,3,5,0,0,85,
15/10/2013,ZAC.,"VALPARAISO, ZAC.",4,1,5,3,0,0,
15/10/2013,B.C.,"MEXICALI, B.C.",3,1,4,0,0,0,
15/10/2013,COAH.,"NUEVA ROSITA, COAH.",3,0,3,0,0,233,
15/10/2013,COAH.,"ACUÑA, COAH.",0,2,2,0,0,0,
15/10/2013,ZAC.,"GUADALUPE, ZAC.",2,0,2,0,1,1320,
15/10/2013,YUC.,"RIO LAGARTOS, YUC.",2,0,2,0,0,0,
15/10/2013,AGS.,"AGS., AGS.",2,0,2,2,0,20,
15/10/2013,B.C.,"TIJUANA, B.C.",1,0,1,0,0,0,
15/10/2013,COAH.,"TORREÓN, COAH.",0,1,1,0,0,0,
15/10/2013,VER.,"XALAPA, VER.",1,0,1,0,0,0,
15/10/2013,ZAC.,"ZAC., ZAC.",1,0,1,0,0,0,
15/10/2013,ZAC.,"JEREZ, ZAC.",0,1,1,0,0,0,
15/10/2013,CHIS.,"REFORMA, CHIS.",1,0,1,0,0,0,
15/10/2013,CAMP.,"CANDELARIA, CAMP.",1,0,1,1,0,2,
15/10/2013,HGO.,"ZACUALTIPAN DE ANGELES, HGO.",1,0,1,0,0,0,
15/10/2013,HGO.,"TULANCINGO DE BRAVO, HGO.",1,0,1,0,0,40,
15/10/2013,OAX.,"PINOTEPA DE DON LUIS, OAX.",1,0,1,1,0,0,
15/10/2013,TAMPS.,"VICTORIA, TAMPS.",0,1,1,0,1,0,
15/10/2013,TAMPS.,"XICOTENCATL, TAMPS.",1,0,1,1,0,58,
15/10/2013,ZAC.,"JALPA, ZAC.",0,0,0,0,0,53,
16/10/2013,D.F.,"COYOACAN, D.F.",20,10,30,4,0,90,
16/10/2013,ZAC.,"FRESNILLO, ZAC.",8,0,8,0,0,500,
16/10/2013,ZAC.,"RIO GRANDE, ZAC.",7,0,7,1,0,0,
16/10/2013,COAH.,"PIEDRAS NEGRAS, COAH.",2,4,6,2,0,164,
16/10/2013,B.C.,"MEXICALI, B.C.",2,4,6,0,0,0,
16/10/2013,HGO.,"TULANCINGO DE BRAVO, HGO.",5,0,5,0,0,0,
16/10/2013,AGS.,"AGS., AGS.",4,1,5,1,0,0,
16/10/2013,SIN.,"CONCORDIA, SIN.",2,3,5,0,0,0,
16/10/2013,SON.,"HERMOSILLO, SON.",0,3,3,1,0,780,
16/10/2013,B.C.,"TIJUANA, B.C.",0,3,3,0,0,0,
16/10/2013,ZAC.,"ZAC., ZAC.",2,1,3,0,0,345,
16/10/2013,NAY.,"IXTLAN DEL RIO, NAY.",2,0,2,1,0,0,
16/10/2013,OAX.,"JUCHITAN DE ZARAGOZA, OAX.",2,0,2,2,0,0,
16/10/2013,VER.,"XALAPA, VER.",2,0,2,0,0,0,
16/10/2013,CHIS.,"TAPACHULA, CHIS.",2,0,2,0,0,0,
16/10/2013,ZAC.,"JEREZ, ZAC.",2,0,2,2,0,0,
16/10/2013,HGO.,"ZACUALTIPAN DE ANGELES, HGO.",1,0,1,0,0,0,
16/10/2013,OAX.,"PINOTEPA DE DON LUIS, OAX.",1,0,1,1,0,0,
16/10/2013,YUC.,"RIO LAGARTOS, YUC.",1,0,1,0,0,0,
16/10/2013,SON.,"CAJEME, SON.",1,0,1,0,0,0,
16/10/2013,TAMPS.,"VICTORIA, TAMPS.",0,0,0,0,1,0,
17/10/2013,D.F.,"COYOACAN, D.F.",22,16,38,7,0,280,
17/10/2013,COAH.,"PIEDRAS NEGRAS, COAH.",3,4,7,0,0,410,
17/10/2013,AGS.,"AGS., AGS.",3,1,4,2,0,53,
17/10/2013,VER.,"XALAPA, VER.",3,0,3,0,0,25,
17/10/2013,B.C.,"TIJUANA, B.C.",2,1,3,0,0,0,
17/10/2013,HGO.,"TULANCINGO DE BRAVO, HGO.",2,0,2,0,2,0,
17/10/2013,ZAC.,"ZAC., ZAC.",1,0,1,0,0,100,
17/10/2013,ZAC.,"GUADALUPE, ZAC.",1,0,1,0,0,800,
17/10/2013,ZAC.,"TLALTENANGO DE SANCHEZ ROMAN, ZAC.",0,1,1,2,0,80,
17/10/2013,ZAC.,"FRESNILLO, ZAC.",1,0,1,1,0,0,
17/10/2013,COAH.,"NUEVA ROSITA, COAH.",0,1,1,0,0,0,
17/10/2013,NAY.,"HUAJICORI, NAY.",1,0,1,0,0,0,
17/10/2013,JAL.,"TIZAPAN EL ALTO, JAL.",1,0,1,0,0,0,
17/10/2013,COAH.,"ACUÑA, COAH.",0,0,0,0,0,103,
18/10/2013,D.F.,"COYOACAN, D.F.",31,13,44,4,2,796,
18/10/2013,COAH.,"PIEDRAS NEGRAS, COAH.",12,4,16,0,0,700,
18/10/2013,AGS.,"AGS., AGS.",5,0,5,79,0,0,
18/10/2013,ZAC.,"FRESNILLO, ZAC.",4,1,5,0,0,106,
18/10/2013,ZAC.,"VALPARAISO, ZAC.",3,1,4,2,0,0,
18/10/2013,B.C.,"MEXICALI, B.C.",3,0,3,0,0,0,
18/10/2013,HGO.,"TULANCINGO DE BRAVO, HGO.",2,0,2,0,0,0,
18/10/2013,ZAC.,"ZAC., ZAC.",2,0,2,0,0,150,
18/10/2013,ZAC.,"TLALTENANGO DE SANCHEZ ROMAN, ZAC.",2,0,2,0,0,30,
18/10/2013,N.L.,"MINA, N.L.",1,1,2,0,0,0,
18/10/2013,CHIS.,"REFORMA, CHIS.",1,0,1,0,0,0,
18/10/2013,OAX.,"SANTA MARIA GUIENAGATI, OAX.",1,0,1,6,0,0,
18/10/2013,CHIS.,"TAPACHULA, CHIS.",1,0,1,0,0,0,
18/10/2013,SIN.,"CONCORDIA, SIN.",1,0,1,0,5,0,
18/10/2013,JAL.,"TIZAPAN EL ALTO, JAL.",1,0,1,0,0,0,
18/10/2013,VER.,"XALAPA, VER.",1,0,1,0,0,0,
18/10/2013,ZAC.,"GUADALUPE, ZAC.",0,0,0,0,0,1030,
18/10/2013,COAH.,"ACUÑA, COAH.",0,0,0,0,0,139,
18/10/2013,N.L.,"GRAL. ZARAGOZA, N.L.",0,0,0,14,0,320,
19/10/2013,COAH.,"PIEDRAS NEGRAS, COAH.",8,8,16,0,0,330,
19/10/2013,VER.,"XALAPA, VER.",6,0,6,0,0,82,
19/10/2013,HGO.,"TULANCINGO DE BRAVO, HGO.",1,2,3,0,0,500,
19/10/2013,ZAC.,"TLALTENANGO DE SANCHEZ ROMAN, ZAC.",2,0,2,1,0,110,
19/10/2013,B.C.,"TECATE, B.C.",2,0,2,0,0,0,
19/10/2013,CHIS.,"TAPACHULA, CHIS.",1,0,1,0,0,0,
19/10/2013,ZAC.,"ZAC., ZAC.",0,0,0,0,0,318,
20/10/2013,B.C.,"TIJUANA, B.C.",1,0,1,0,0,0,
21/10/2013,D.F.,"BENITO JUAREZ, D.F.",9,3,12,0,4,40,
21/10/2013,SON.,"CAJEME, SON.",1,1,2,0,0,0,
21/10/2013,N.L.,"HGO., N.L.",2,0,2,0,0,0,
21/10/2013,ZAC.,"GUADALUPE, ZAC.",1,0,1,0,0,0,
21/10/2013,B.C.,"ENSENADA, B.C.",0,1,1,0,0,0,
21/10/2013,CHIS.,"TAPACHULA, CHIS.",1,0,1,0,0,0,
21/10/2013,HGO.,"ZACUALTIPAN DE ANGELES, HGO.",1,0,1,0,0,0,
21/10/2013,HGO.,"TULANCINGO DE BRAVO, HGO.",1,0,1,0,0,0,
21/10/2013,TAMPS.,"VICTORIA, TAMPS.",1,0,1,0,0,70,
21/10/2013,NAY.,"IXTLAN DEL RIO, NAY.",0,1,1,0,0,0,
21/10/2013,ZAC.,"TLALTENANGO DE SANCHEZ ROMAN, ZAC.",0,0,0,0,0,406,
22/10/2013,D.F.,"BENITO JUAREZ, D.F.",8,5,13,0,0,502,
22/10/2013,SON.,"HERMOSILLO, SON.",2,2,4,1,0,82,
22/10/2013,AGS.,"AGS., AGS.",2,1,3,6,0,80,
22/10/2013,COAH.,"ACUÑA, COAH.",0,2,2,0,0,0,
22/10/2013,HGO.,"TULANCINGO DE BRAVO, HGO.",1,0,1,0,0,0,
22/10/2013,ZAC.,"ZAC., ZAC.",1,0,1,0,0,17,
22/10/2013,ZAC.,"FRESNILLO, ZAC.",1,0,1,0,0,50,
22/10/2013,NAY.,"IXTLAN DEL RIO, NAY.",1,0,1,0,0,0,
22/10/2013,CHIS.,"TAPACHULA, CHIS.",1,0,1,0,0,0,
22/10/2013,B.C.,"ENSENADA, B.C.",1,0,1,0,0,0,
22/10/2013,CHIS.,"HUIXTLA, CHIS.",0,1,1,0,0,0,
22/10/2013,SON.,"CAJEME, SON.",0,1,1,0,0,0,
22/10/2013,ZAC.,"TLALTENANGO DE SANCHEZ ROMAN, ZAC.",0,0,0,0,0,56,
22/10/2013,N.L.,"ABASOLO, N.L.",0,0,0,4,0,0,
23/10/2013,D.F.,"BENITO JUAREZ, D.F.",15,11,26,3,1,120,
23/10/2013,COAH.,"PIEDRAS NEGRAS, COAH.",7,1,8,0,0,1230,
23/10/2013,AGS.,"AGS., AGS.",7,0,7,9,3,360,
23/10/2013,B.C.,"TIJUANA, B.C.",3,3,6,0,0,0,
23/10/2013,ZAC.,"ZAC., ZAC.",1,0,1,0,0,0,
23/10/2013,COAH.,"NUEVA ROSITA, COAH.",1,0,1,0,0,0,
23/10/2013,N.L.,"ABASOLO, N.L.",1,0,1,9,0,150,
23/10/2013,HGO.,"TULANCINGO DE BRAVO, HGO.",1,0,1,0,0,0,
23/10/2013,JAL.,"TAPALPA, JAL.",1,0,1,0,0,0,
23/10/2013,CHIS.,"TAPACHULA, CHIS.",1,0,1,2,0,20,
23/10/2013,ZAC.,"GUADALUPE, ZAC.",0,0,0,0,0,20,
23/10/2013,ZAC.,"TLALTENANGO DE SANCHEZ ROMAN, ZAC.",0,0,0,0,0,24,
23/10/2013,ZAC.,"JEREZ, ZAC.",0,0,0,0,0,20,
23/10/2013,ZAC.,"FRESNILLO, ZAC.",0,0,0,0,0,450,
23/10/2013,TAMPS.,"VICTORIA, TAMPS.",0,0,0,0,0,480,
24/10/2013,D.F.,"BENITO JUAREZ, D.F.",10,4,14,35,0,65,
24/10/2013,COAH.,"PIEDRAS NEGRAS, COAH.",0,4,4,0,0,313,
24/10/2013,HGO.,"TULANCINGO DE BRAVO, HGO.",0,3,3,0,0,0,
24/10/2013,N.L.,"GALEANA, N.L.",2,1,3,5,0,0,
24/10/2013,AGS.,"AGS., AGS.",1,0,1,2,0,140,
24/10/2013,NAY.,"IXTLAN DEL RIO, NAY.",0,1,1,0,0,0,
24/10/2013,B.C.,"TIJUANA, B.C.",0,1,1,0,0,0,
24/10/2013,ZAC.,"GUADALUPE, ZAC.",1,0,1,0,0,0,
24/10/2013,ZAC.,"FRESNILLO, ZAC.",1,0,1,5,0,190,
24/10/2013,ZAC.,"TLALTENANGO DE SANCHEZ ROMAN, ZAC.",0,0,0,0,0,58,
25/10/2013,D.F.,"BENITO JUAREZ, D.F.",23,9,32,0,4,40,
25/10/2013,COAH.,"MÚZQUIZ, COAH.",3,2,5,0,0,0,
25/10/2013,COAH.,"PIEDRAS NEGRAS, COAH.",1,3,4,0,0,47,
25/10/2013,N.L.,"ITURBIDE, N.L.",1,3,4,0,0,0,
25/10/2013,CHIS.,"HUIXTLA, CHIS.",2,0,2,0,0,0,
25/10/2013,ZAC.,"ZAC., ZAC.",0,1,1,0,0,50,
25/10/2013,ZAC.,"GUADALUPE, ZAC.",1,0,1,0,0,0,
25/10/2013,ZAC.,"FRESNILLO, ZAC.",1,0,1,0,0,0,
25/10/2013,CHIS.,"TAPACHULA, CHIS.",1,0,1,2,0,0,
25/10/2013,B.C.,"TIJUANA, B.C.",0,1,1,0,0,0,
25/10/2013,SON.,"CAJEME, SON.",0,1,1,0,0,13,
25/10/2013,ZAC.,"TLALTENANGO DE SANCHEZ ROMAN, ZAC.",0,0,0,0,0,85,
25/10/2013,ZAC.,"JEREZ, ZAC.",0,0,0,0,0,30,
25/10/2013,AGS.,"AGS., AGS.",0,0,0,0,0,125,
26/10/2013,HGO.,"TULANCINGO DE BRAVO, HGO.",6,2,8,0,0,0,
26/10/2013,N.L.,"ITURBIDE, N.L.",1,3,4,0,0,0,
26/10/2013,COAH.,"RAMOS ARIZPE, COAH.",3,1,4,0,0,0,
26/10/2013,COAH.,"ACUÑA, COAH.",1,2,3,0,0,89,
26/10/2013,CHIS.,"MOTOZINTLA, CHIS.",1,0,1,0,0,0,
26/10/2013,CHIS.,"HUIXTLA, CHIS.",0,1,1,0,0,0,
26/10/2013,B.C.,"TIJUANA, B.C.",1,0,1,0,0,0,
27/10/2013,N.L.,"ITURBIDE, N.L.",2,2,4,0,0,0,
27/10/2013,N.L.,"CARMEN, N.L.",0,0,0,7,0,150,
28/10/2013,D.F.,"ALVARO OBREGON, D.F.",16,0,16,0,0,125,
28/10/2013,N.L.,"LINARES, N.L.",3,0,3,0,0,0,
28/10/2013,CHIS.,"HUIXTLA, CHIS.",1,1,2,0,0,0,
28/10/2013,ZAC.,"JEREZ, ZAC.",0,1,1,1,0,80,
28/10/2013,ZAC.,"VALPARAISO, ZAC.",1,0,1,1,0,0,
28/10/2013,CHIS.,"EL PORVENIR, CHIS.",0,0,0,0,0,27,
28/10/2013,N.L.,"SALINAS VICTORIA, N.L.",0,0,0,16,0,200,
29/10/2013,D.F.,"ALVARO OBREGON, D.F.",20,6,26,3,6,480,
29/10/2013,COAH.,"RAMOS ARIZPE, COAH.",4,1,5,0,0,0,
29/10/2013,B.C.,"TIJUANA, B.C.",1,4,5,0,0,0,
29/10/2013,B.C.,"MEXICALI, B.C.",2,3,5,0,0,0,
29/10/2013,ZAC.,"VALPARAISO, ZAC.",1,1,2,1,0,26,
29/10/2013,CHIS.,"TAPACHULA, CHIS.",1,1,2,0,0,70,
29/10/2013,CHIS.,"EL PORVENIR, CHIS.",1,1,2,0,0,0,
29/10/2013,CHIS.,"HUIXTLA, CHIS.",1,1,2,0,0,0,
29/10/2013,SON.,"HERMOSILLO, SON.",1,1,2,0,0,0,
29/10/2013,B.C.,"ENSENADA, B.C.",0,2,2,0,0,0,
29/10/2013,COAH.,"ALLENDE, COAH.",1,0,1,0,0,116,
29/10/2013,CHIS.,"MOTOZINTLA, CHIS.",1,0,1,0,0,0,
29/10/2013,CHIS.,"TUXTLA CHICO, CHIS.",1,0,1,0,0,0,
29/10/2013,CHIS.,"OCOSINGO, CHIS.",0,1,1,0,0,0,
29/10/2013,ZAC.,"GUADALUPE, ZAC.",0,0,0,0,0,1220,
29/10/2013,N.L.,"SALINAS VICTORIA, N.L.",0,0,0,6,0,300,
29/10/2013,TAMPS.,"VICTORIA, TAMPS.",0,0,0,0,0,119,
30/10/2013,D.F.,"ALVARO OBREGON, D.F.",26,3,29,19,1,970,
30/10/2013,N.L.,"LINARES, N.L.",3,1,4,2,0,80,
30/10/2013,COAH.,"NUEVA ROSITA, COAH.",1,2,3,0,0,0,
30/10/2013,CHIS.,"JIQUIPILAS, CHIS.",0,2,2,0,0,0,
30/10/2013,B.C.,"TIJUANA, B.C.",0,2,2,0,0,0,
30/10/2013,COAH.,"RAMOS ARIZPE, COAH.",0,2,2,0,0,0,
30/10/2013,SON.,"CAJEME, SON.",0,1,1,0,0,0,
30/10/2013,CHIS.,"TAPACHULA, CHIS.",1,0,1,0,1,0,
30/10/2013,ZAC.,"TLALTENANGO DE SANCHEZ ROMAN, ZAC.",0,1,1,0,0,150,
30/10/2013,ZAC.,"JEREZ, ZAC.",1,0,1,0,0,0,
30/10/2013,ZAC.,"FRESNILLO, ZAC.",1,0,1,0,0,115,
30/10/2013,ZAC.,"VALPARAISO, ZAC.",1,0,1,0,0,0,
30/10/2013,SON.,"CAJEME, SON.",0,1,1,0,0,0,
30/10/2013,CHIS.,"HUIXTLA, CHIS.",0,0,0,1,0,33,
30/10/2013,N.L.,"SALINAS VICTORIA, N.L.",0,0,0,0,0,400,
31/10/2013,D.F.,"ALVARO OBREGON, D.F.",20,3,23,3,2,66,
31/10/2013,ZAC.,"FRESNILLO, ZAC.",2,7,9,0,0,0,
31/10/2013,N.L.,"HUALAHUISES, N.L.",4,0,4,0,0,0,
31/10/2013,B.C.,"TIJUANA, B.C.",3,1,4,0,0,0,
31/10/2013,CHIS.,"TAPACHULA, CHIS.",4,0,4,0,0,140,
31/10/2013,COAH.,"RAMOS ARIZPE, COAH.",2,0,2,0,0,0,
31/10/2013,SON.,"CAJEME, SON.",2,0,2,0,0,0,
31/10/2013,B.C.,"MEXICALI, B.C.",1,0,1,0,0,0,
31/10/2013,CHIS.,"HUIXTÁN, CHIS.",1,0,1,2,1,66,
31/10/2013,SON.,"HERMOSILLO, SON.",0,1,1,0,0,0,
31/10/2013,COAH.,"MÚZQUIZ, COAH.",1,0,1,6,0,120,
31/10/2013,CHIH.,"MADERA, CHIH.",0,1,1,0,0,0,
31/10/2013,ZAC.,"TLALTENANGO DE SANCHEZ ROMAN, ZAC.",1,0,1,0,0,268,
31/10/2013,ZAC.,"JALPA, ZAC.",1,0,1,0,0,0,
31/10/2013,ZAC.,"GUADALUPE, ZAC.",0,0,0,0,2,0,
01/11/2013,D.F.,"ALVARO OBREGON, D.F.",12,8,20,0,0,1000,
01/11/2013,B.C.,"TIJUANA, B.C.",1,2,3,0,0,0,
01/11/2013,COAH.,"RAMOS ARIZPE, COAH.",2,0,2,0,0,0,
01/11/2013,COAH.,"NUEVA ROSITA, COAH.",2,0,2,0,0,0,
01/11/2013,SON.,"HERMOSILLO, SON.",1,1,2,0,0,20,
01/11/2013,NAY.,"HUAJICORI, NAY.",1,0,1,0,0,0,
01/11/2013,ZAC.,"TLALTENANGO DE SANCHEZ ROMAN, ZAC.",0,0,0,1,0,487,
01/11/2013,COAH.,"MÚZQUIZ, COAH.",0,0,0,0,0,100,
01/11/2013,S.L.P.,"SAN LUIS POTOSI, S.L.P.",0,0,0,0,1,0,
02/11/2013,B.C.,"MEXICALI, B.C.",3,0,3,0,0,0,
02/11/2013,TAMPS.,"NUEVO LAREDO, TAMPS.",0,0,0,0,0,170,
02/11/2013,ZAC.,"GUADALUPE, ZAC.",0,0,0,0,0,400,
02/11/2013,SON.,"CAJEME, SON.",0,0,0,0,0,142,
04/11/2013,D.F.,"TLALPAN, D.F.",3,6,9,0,0,29,
04/11/2013,TAMPS.,"VICTORIA, TAMPS.",4,0,4,0,0,0,
04/11/2013,JAL.,"ACATLAN DE JUAREZ, JAL.",2,1,3,0,0,0,
05/11/2013,D.F.,"TLALPAN, D.F.",17,6,23,0,0,500,
05/11/2013,N.L.,"MARIN, N.L.",1,3,4,3,1,700,
05/11/2013,B.C.,"MEXICALI, B.C.",2,1,3,0,0,0,
05/11/2013,S.L.P.,"SAN LUIS POTOSI, S.L.P.",0,1,1,0,0,0,
05/11/2013,COAH.,"NUEVA ROSITA, COAH.",1,0,1,0,0,0,
05/11/2013,B.C.,"TIJUANA, B.C.",0,1,1,0,0,0,
05/11/2013,B.C.,"ENSENADA, B.C.",0,1,1,0,0,0,
05/11/2013,JAL.,"ACATLAN DE JUAREZ, JAL.",1,0,1,0,0,0,
06/11/2013,D.F.,"TLALPAN, D.F.",26,7,33,0,1,0,
06/11/2013,N.L.,"HIGUERAS, N.L.",2,2,4,25,0,0,
06/11/2013,CHIS.,"TUXTLA CHICO, CHIS.",1,1,2,0,0,0,
06/11/2013,B.C.,"TIJUANA, B.C.",1,1,2,0,0,0,
06/11/2013,B.C.,"MEXICALI, B.C.",1,1,2,0,0,0,
06/11/2013,YUC.,"SAN FELIPE, YUC.",0,1,1,0,0,0,
06/11/2013,NAY.,"JALA, NAY.",0,1,1,0,0,0,
06/11/2013,B.C.,"ENSENADA, B.C.",0,1,1,0,0,0,
06/11/2013,COL.,"COL., COL.",0,1,1,0,1,5,
07/11/2013,D.F.,"TLALPAN, D.F.",24,3,27,0,2,350,
07/11/2013,B.C.,"TIJUANA, B.C.",2,4,6,0,0,0,
07/11/2013,JAL.,"ACATLAN DE JUAREZ, JAL.",2,0,2,0,0,0,
07/11/2013,COAH.,"ARTEAGA, COAH.",1,0,1,0,0,305,
07/11/2013,B.C.,"MEXICALI, B.C.",1,0,1,0,0,0,
07/11/2013,JAL.,"ACATLAN DE JUAREZ, JAL.",1,0,1,0,0,0,
07/11/2013,COAH.,"ACUÑA, COAH.",0,0,0,2,0,90,
07/11/2013,TAB.,"CENTRO, TAB.",0,0,0,0,1,0,
08/11/2013,D.F.,"TLALPAN, D.F.",21,10,31,0,0,400,
08/11/2013,B.C.,"TECATE, B.C.",1,0,1,0,0,0,
08/11/2013,N.L.,"HIGUERAS, N.L.",0,0,0,10,0,570,
09/11/2013,B.C.,"TIJUANA, B.C.",2,0,2,0,0,0,
09/11/2013,N.L.,"GRAL. TERAN, N.L.",0,0,0,1,0,0,
10/11/2013,N.L.,"GRAL. TERAN, N.L.",0,1,1,0,0,0,
11/11/2013,GTO.,"IRAPUATO, GTO.",17,1,18,0,1,0,
11/11/2013,D.F.,"MILPA ALTA, D.F.",7,10,17,0,0,5,
11/11/2013,TAMPS.,"VICTORIA, TAMPS.",2,2,4,4,0,164,
11/11/2013,YUC.,"PANABA, YUC.",1,0,1,0,0,0,
11/11/2013,N.L.,"GRAL. TERAN, N.L.",0,1,1,0,0,0,
11/11/2013,B.C.,"TIJUANA, B.C.",0,1,1,0,0,0,
11/11/2013,N.L.,"GRAL. ZUAZUA, N.L.",0,0,0,2,0,100,
12/11/2013,D.F.,"MILPA ALTA, D.F.",13,2,15,0,1,0,
12/11/2013,HGO.,"TEPEJI DEL RIO DE OCAMPO, HGO.",2,1,3,0,0,0,
12/11/2013,HGO.,"PACHUCA DE SOTO, HGO.",1,2,3,0,0,220,
12/11/2013,YUC.,"PANABA, YUC.",1,1,2,0,0,0,
12/11/2013,B.C.,"TIJUANA, B.C.",1,1,2,0,0,0,
12/11/2013,CHIH.,"JANOS, CHIH.",1,0,1,0,0,0,
12/11/2013,PUE.,"PUE., PUE.",1,0,1,0,0,199,
13/11/2013,GTO.,"IRAPUATO, GTO.",15,5,20,0,0,0,
13/11/2013,D.F.,"MILPA ALTA, D.F.",8,2,10,0,0,150,
13/11/2013,PUE.,"PUE., PUE.",7,2,9,1,0,284,
13/11/2013,TAMPS.,"TAMPICO, TAMPS.",2,5,7,0,0,666,
13/11/2013,PUE.,"PUE., PUE.",4,2,6,2,0,179,
13/11/2013,N.L.,"CIENEGA DE FLORES, N.L.",1,1,2,2,0,1200,
13/11/2013,COAH.,"FRONTERA, COAH.",2,0,2,0,0,0,
13/11/2013,HGO.,"TEPEJI DEL RIO DE OCAMPO, HGO.",1,0,1,0,0,0,
13/11/2013,YUC.,"PANABA, YUC.",1,0,1,0,0,0,
13/11/2013,NAY.,"ROSAMORADA, NAY.",0,1,1,0,0,0,
13/11/2013,N.L.,"ALLENDE, N.L.",0,0,0,1,0,0,
14/11/2013,GTO.,"IRAPUATO, GTO.",12,9,21,0,0,0,
14/11/2013,D.F.,"MILPA ALTA, D.F.",6,5,11,0,0,150,
14/11/2013,HGO.,"TEPEJI DEL RIO DE OCAMPO, HGO.",4,3,7,0,0,0,
14/11/2013,HGO.,"PACHUCA DE SOTO, HGO.",3,0,3,0,0,0,
14/11/2013,HGO.,"ZIMAPAN, HGO.",1,0,1,0,0,0,
14/11/2013,COAH.,"CASTAÑOS, COAH.",1,0,1,0,0,0,
14/11/2013,COAH.,"MÚZQUIZ, COAH.",0,1,1,0,0,50,
14/11/2013,N.L.,"CIENEGA DE FLORES, N.L.",0,0,0,3,0,0,
15/11/2013,GTO.,"IRAPUATO, GTO.",21,5,26,0,0,0,
15/11/2013,D.F.,"MILPA ALTA, D.F.",5,9,14,0,0,120,
15/11/2013,PUE.,"PUE., PUE.",2,1,3,8,0,308,
15/11/2013,HGO.,"PACHUCA DE SOTO, HGO.",2,0,2,0,0,0,
15/11/2013,OAX.,"MIAHUATLAN DE PORFIRIO DIAZ, OAX.",2,0,2,1,0,43,
15/11/2013,B.C.,"TECATE, B.C.",1,0,1,0,0,0,
15/11/2013,B.C.,"ENSENADA, B.C.",1,0,1,0,0,0,
15/11/2013,COAH.,"CASTAÑOS, COAH.",0,1,1,0,0,73,
15/11/2013,COAH.,"ALLENDE, COAH.",0,1,1,0,0,0,
15/11/2013,TAMPS.,"VICTORIA, TAMPS.",0,0,0,11,1,200,
16/11/2013,GTO.,"IRAPUATO, GTO.",5,1,6,0,0,0,
16/11/2013,HGO.,"TEPEJI DEL RIO DE OCAMPO, HGO.",4,0,4,0,0,0,
16/11/2013,HGO.,"PACHUCA DE SOTO, HGO.",2,0,2,0,0,0,
16/11/2013,COAH.,"CASTAÑOS, COAH.",1,0,1,0,0,0,
16/11/2013,TAMPS.,"NUEVO LAREDO, TAMPS.",1,0,1,0,0,0,
16/11/2013,TAMPS.,"TAMPICO, TAMPS.",0,1,1,0,0,0,
16/11/2013,HGO.,"ZIMAPAN, HGO.",1,0,1,0,0,0,
16/11/2013,COAH.,"NUEVA ROSITA, COAH.",0,1,1,0,0,0,
18/11/2013,GTO.,"IRAPUATO, GTO.",19,3,22,0,0,145,
18/11/2013,HGO.,"PACHUCA DE SOTO, HGO.",3,0,3,0,0,0,
18/11/2013,HGO.,"TEPEJI DEL RIO DE OCAMPO, HGO.",2,0,2,0,0,200,
19/11/2013,GTO.,"IRAPUATO, GTO.",9,1,10,0,0,0,
19/11/2013,D.F.,"CUAUHTEMOC, D.F.",6,1,7,1,0,25,
19/11/2013,PUE.,"PUE., PUE.",3,0,3,0,0,74,
19/11/2013,HGO.,"TEPEJI DEL RIO DE OCAMPO, HGO.",2,0,2,0,0,0,
19/11/2013,NAY.,"JALA, NAY.",1,0,1,0,0,0,
19/11/2013,N.L.,"SAN PEDRO GARZA GARCIA, N.L.",0,0,0,4,0,0,
19/11/2013,COAH.,"ACUÑA, COAH.",0,0,0,1,0,80,
19/11/2013,TAMPS.,"NUEVO LAREDO, TAMPS.",0,0,0,0,0,150,
20/11/2013,D.F.,"CUAUHTEMOC, D.F.",10,4,14,0,0,21,
20/11/2013,PUE.,"PUE., PUE.",4,0,4,2,2,205,
20/11/2013,N.L.,"APODACA, N.L.",3,0,3,8,0,100,
21/11/2013,D.F.,"CUAUHTEMOC, D.F.",16,6,22,2,3,103,
21/11/2013,N.L.,"SAN PEDRO GARZA GARCIA, N.L.",1,2,3,3,0,213,
21/11/2013,TAMPS.,"TAMPICO, TAMPS.",2,0,2,2,0,1977,
21/11/2013,PUE.,"PUE., PUE.",2,0,2,1,0,154,
21/11/2013,HGO.,"PACHUCA DE SOTO, HGO.",0,1,1,0,0,0,
21/11/2013,NAY.,"JALA, NAY.",1,0,1,0,0,0,
21/11/2013,B.C.,"ENSENADA, B.C.",0,1,1,0,0,0,
21/11/2013,N.L.,"APODACA, N.L.",1,0,1,0,0,275,
21/11/2013,HGO.,"TEPEJI DEL RIO DE OCAMPO, HGO.",0,0,0,0,1,0,
22/11/2013,D.F.,"CUAUHTEMOC, D.F.",32,14,46,8,1,888,
22/11/2013,SON.,"NAVOJOA, SON.",6,1,7,2,1,0,
22/11/2013,TAMPS.,"VICTORIA, TAMPS.",6,0,6,4,0,60,
22/11/2013,SON.,"HERMOSILLO, SON.",1,2,3,0,0,0,
22/11/2013,SON.,"HUATABAMPO, SON.",3,0,3,0,0,76,
22/11/2013,HGO.,"TEPEJI DEL RIO DE OCAMPO, HGO.",2,0,2,0,0,0,
22/11/2013,SON.,"CAJEME, SON.",2,0,2,1,0,25,
22/11/2013,SON.,"ETCHOJOA, SON.",2,0,2,0,0,9,
22/11/2013,SON.,"URES, SON.",1,0,1,0,0,0,
22/11/2013,SON.,"GUAYMAS, SON.",0,1,1,0,0,0,
22/11/2013,SON.,"ALAMOS, SON.",1,0,1,0,0,0,
22/11/2013,PUE.,"PUE., PUE.",1,0,1,1,0,198,
22/11/2013,SON.,"AGUA PRIETA, SON.",0,1,1,0,0,13,
22/11/2013,HGO.,"PACHUCA DE SOTO, HGO.",1,0,1,0,0,220,
22/11/2013,N.L.,"SAN PEDRO GARZA GARCIA, N.L.",1,0,1,0,0,0,
22/11/2013,N.L.,"APODACA, N.L.",1,0,1,2,0,0,
23/11/2013,SON.,"GUAYMAS, SON.",3,1,4,0,0,620,
23/11/2013,SON.,"NAVOJOA, SON.",4,0,4,2,0,30,
23/11/2013,SON.,"CAJEME, SON.",1,1,2,0,0,0,
23/11/2013,HGO.,"PACHUCA DE SOTO, HGO.",1,1,2,0,1,400,
23/11/2013,COL.,"COL., COL.",1,0,1,0,0,0,
23/11/2013,SON.,"HUATABAMPO, SON.",1,0,1,0,0,0,
23/11/2013,HGO.,"TEPEJI DEL RIO DE OCAMPO, HGO.",1,0,1,0,0,0,
23/11/2013,SON.,"HERMOSILLO, SON.",0,0,0,0,0,61,
23/11/2013,N.L.,"SAN PEDRO GARZA GARCIA, N.L.",0,0,0,5,0,24,
23/11/2013,N.L.,"APODACA, N.L.",0,0,0,0,0,150,
23/11/2013,TAB.,"JALAPA, TAB.",0,0,0,3,0,37,
23/11/2013,PUE.,"PUE., PUE.",0,0,0,0,0,66,
23/11/2013,HGO.,"ZIMAPAN, HGO.",0,0,0,0,0,200,
24/11/2013,N.L.,"MONTERREY, N.L.",17,10,27,81,0,1114,
24/11/2013,N.L.,"GRAL. ESCOBEDO, N.L.",1,0,1,1,0,0,
25/11/2013,GTO.,"LEON, GTO.",25,10,35,0,0,0,
25/11/2013,N.L.,"MONTERREY, N.L.",4,8,12,0,0,1930,
25/11/2013,SON.,"CABORCA, SON.",5,6,11,2,0,0,
25/11/2013,SON.,"CAJEME, SON.",3,4,7,2,0,0,
25/11/2013,N.L.,"GRAL. ESCOBEDO, N.L.",2,2,4,2,0,50,
25/11/2013,D.F.,"CUAJIMALPA DE MOR., D.F.",2,1,3,0,0,0,
25/11/2013,SON.,"SANTA ANA, SON.",3,0,3,0,0,0,
25/11/2013,SON.,"HERMOSILLO, SON.",2,1,3,1,0,246,
25/11/2013,COAH.,"PIEDRAS NEGRAS, COAH.",0,3,3,0,0,232,
25/11/2013,SON.,"MAGDALENA, SON.",1,1,2,1,0,70,
25/11/2013,SON.,"ACONCHI, SON.",1,1,2,0,0,0,
25/11/2013,SON.,"AGUA PRIETA, SON.",0,1,1,0,0,0,
25/11/2013,SON.,"GUAYMAS, SON.",0,1,1,0,0,18,
25/11/2013,SON.,"YECORA, SON.",1,0,1,1,0,0,
25/11/2013,SON.,"HUATABAMPO, SON.",0,1,1,2,0,20,
25/11/2013,SON.,"NAVOJOA, SON.",1,0,1,0,0,50,
25/11/2013,B.C.,"TECATE, B.C.",0,1,1,0,0,0,
25/11/2013,B.C.,"ENSENADA, B.C.",0,1,1,0,0,0,
25/11/2013,TAB.,"JALAPA, TAB.",0,0,0,0,1,0,
25/11/2013,SON.,"EMPALME, SON.",0,0,0,1,0,14,
26/11/2013,GTO.,"LEON, GTO.",77,38,115,1,0,50,
26/11/2013,N.L.,"MONTERREY, N.L.",15,9,24,6,0,2688,
26/11/2013,D.F.,"CUAJIMALPA DE MOR., D.F.",14,2,16,0,0,213,
26/11/2013,COAH.,"PIEDRAS NEGRAS, COAH.",0,10,10,4,0,398,
26/11/2013,SON.,"GENERAL PLUTARCO ELIAS CALLES, SON.",6,2,8,3,0,3,
26/11/2013,CHIH.,"CHIH., CHIH.",2,3,5,8,0,33,
26/11/2013,COAH.,"SALTILLO, COAH.",2,3,5,0,0,5,
26/11/2013,SON.,"CABORCA, SON.",3,1,4,2,0,90,
26/11/2013,TAB.,"CARDENAS, TAB.",4,0,4,0,3,0,
26/11/2013,COL.,"MANZANILLO, COL.",3,0,3,0,2,39,
26/11/2013,SON.,"GUAYMAS, SON.",1,1,2,0,0,297,
26/11/2013,SON.,"HUATABAMPO, SON.",1,1,2,1,0,20,
26/11/2013,SON.,"NAVOJOA, SON.",2,0,2,0,0,70,
26/11/2013,SON.,"ALTAR, SON.",0,1,1,0,0,0,
26/11/2013,SON.,"PUERTO PEÑASCO, SON.",1,0,1,0,0,49,
26/11/2013,SON.,"MAGDALENA, SON.",1,0,1,1,0,60,
26/11/2013,SON.,"HERMOSILLO, SON.",1,0,1,1,0,225,
26/11/2013,SON.,"MOCTEZUMA, SON.",1,0,1,1,0,0,
26/11/2013,SON.,"YECORA, SON.",1,0,1,0,0,0,
26/11/2013,SON.,"CAJEME, SON.",0,1,1,0,0,0,
26/11/2013,SON.,"ALAMOS, SON.",0,1,1,0,0,0,
26/11/2013,N.L.,"GRAL. ESCOBEDO, N.L.",1,0,1,2,0,50,
26/11/2013,NAY.,"RUIZ, NAY.",1,0,1,0,0,0,
26/11/2013,PUE.,"PUE., PUE.",1,0,1,0,0,0,
26/11/2013,TAMPS.,"VICTORIA, TAMPS.",1,0,1,0,0,0,
26/11/2013,SON.,"EMPALME, SON.",0,0,0,1,0,0,
27/11/2013,GTO.,"LEON, GTO.",95,68,163,0,6,242,
27/11/2013,N.L.,"MONTERREY, N.L.",27,12,39,26,1,3050,
27/11/2013,D.F.,"CUAJIMALPA DE MOR., D.F.",24,7,31,0,0,70,
27/11/2013,COAH.,"PIEDRAS NEGRAS, COAH.",2,8,10,2,2,48,
27/11/2013,SON.,"HERMOSILLO, SON.",5,1,6,1,0,26,
27/11/2013,SON.,"NOGALES, SON.",3,1,4,4,0,123,
27/11/2013,NAY.,"COMPOSTELA, NAY.",2,2,4,0,0,0,
27/11/2013,SON.,"ALTAR, SON.",0,2,2,0,0,0,
27/11/2013,COAH.,"SALTILLO, COAH.",2,0,2,0,0,147,
27/11/2013,SON.,"CAJEME, SON.",1,1,2,0,1,0,
27/11/2013,SON.,"MAGDALENA, SON.",2,0,2,1,0,120,
27/11/2013,SON.,"CANANEA, SON.",0,1,1,0,0,0,
27/11/2013,N.L.,"GRAL. ESCOBEDO, N.L.",1,0,1,2,0,150,
27/11/2013,SON.,"GUAYMAS, SON.",1,0,1,0,0,240,
27/11/2013,SON.,"ALAMOS, SON.",1,0,1,0,0,0,
27/11/2013,SON.,"PITIQUITO, SON.",0,1,1,0,0,0,
27/11/2013,SON.,"GENERAL PLUTARCO ELIAS CALLES, SON.",1,0,1,0,0,0,
27/11/2013,TAMPS.,"ALTAMIRA, TAMPS.",0,0,0,0,0,5,
27/11/2013,SON.,"PUERTO PEÑASCO, SON.",0,0,0,0,1,5,
27/11/2013,PUE.,"PUE., PUE.",0,0,0,1,0,233,
28/11/2013,GTO.,"LEON, GTO.",122,68,190,0,7,1042,
28/11/2013,N.L.,"MONTERREY, N.L.",25,6,31,11,0,2697,
28/11/2013,D.F.,"CUAJIMALPA DE MOR., D.F.",20,1,21,0,0,0,
28/11/2013,COAH.,"PIEDRAS NEGRAS, COAH.",5,2,7,2,0,72,
28/11/2013,TAMPS.,"CIUDAD MADERO, TAMPS.",5,1,6,14,1,1319,
28/11/2013,SON.,"HERMOSILLO, SON.",3,0,3,17,0,160,
28/11/2013,COAH.,"SALTILLO, COAH.",1,1,2,1,0,184,
28/11/2013,N.L.,"GRAL. ESCOBEDO, N.L.",2,0,2,5,0,850,
28/11/2013,TAMPS.,"NUEVO LAREDO, TAMPS.",0,1,1,0,0,0,
28/11/2013,SON.,"AGUA PRIETA, SON.",0,1,1,0,0,0,
28/11/2013,SON.,"SANTA ANA, SON.",1,0,1,1,0,19,
28/11/2013,SON.,"GUAYMAS, SON.",1,0,1,1,0,5,
28/11/2013,SON.,"EMPALME, SON.",1,0,1,1,0,0,
28/11/2013,SON.,"CAJEME, SON.",0,1,1,0,0,0,
28/11/2013,SON.,"ALAMOS, SON.",1,0,1,0,0,0,
28/11/2013,SON.,"PUERTO PEÑASCO, SON.",0,0,0,0,0,4,
28/11/2013,SON.,"MAGDALENA, SON.",0,0,0,0,0,50,
29/11/2013,GTO.,"LEON, GTO.",97,95,192,0,5,433,
29/11/2013,N.L.,"MONTERREY, N.L.",27,11,38,21,0,1777,
29/11/2013,D.F.,"CUAJIMALPA DE MOR., D.F.",26,6,32,0,0,30,
29/11/2013,N.L.,"GRAL. ESCOBEDO, N.L.",3,1,4,222,0,100,
29/11/2013,COAH.,"PIEDRAS NEGRAS, COAH.",3,0,3,0,0,188,
29/11/2013,SON.,"HERMOSILLO, SON.",0,2,2,1,0,0,
29/11/2013,COAH.,"SALTILLO, COAH.",2,0,2,4,0,390,
29/11/2013,SON.,"CANANEA, SON.",1,0,1,0,0,94,
29/11/2013,SON.,"MAGDALENA, SON.",1,0,1,0,0,43,
29/11/2013,NAY.,"COMPOSTELA, NAY.",1,0,1,0,0,0,
29/11/2013,SON.,"MOCTEZUMA, SON.",0,1,1,0,0,0,
29/11/2013,SON.,"CUMPAS, SON.",1,0,1,0,0,0,
29/11/2013,SON.,"URES, SON.",1,0,1,0,0,0,
29/11/2013,SON.,"CAJEME, SON.",1,0,1,0,0,0,
29/11/2013,SON.,"NAVOJOA, SON.",1,0,1,0,0,0,
29/11/2013,SON.,"ALAMOS, SON.",1,0,1,0,0,20,
29/11/2013,TAMPS.,"NUEVO LAREDO, TAMPS.",1,0,1,1,0,174,
29/11/2013,TAMPS.,"VICTORIA, TAMPS.",1,0,1,0,1,80,
29/11/2013,SON.,"NOGALES, SON.",0,0,0,37,0,8,
29/11/2013,PUE.,"PUE., PUE.",0,0,0,0,0,84,
29/11/2013,TAMPS.,"EL MANTE, TAMPS.",0,0,0,6,0,37,
30/11/2013,N.L.,"MONTERREY, N.L.",12,12,24,89,0,2323,
30/11/2013,SON.,"CAJEME, SON.",2,0,2,1,0,0,
30/11/2013,SON.,"CABORCA, SON.",2,0,2,1,0,69,
30/11/2013,SON.,"ALTAR, SON.",1,1,2,0,0,0,
30/11/2013,COAH.,"PIEDRAS NEGRAS, COAH.",0,1,1,0,0,0,
30/11/2013,PUE.,"PUE., PUE.",1,0,1,0,0,0,
30/11/2013,SON.,"CANANEA, SON.",0,1,1,0,0,0,
30/11/2013,N.L.,"GRAL. ESCOBEDO, N.L.",0,0,0,4,0,0,
30/11/2013,SON.,"HERMOSILLO, SON.",0,0,0,3,0,183,
30/11/2013,SON.,"AGUA PRIETA, SON.",0,0,0,1,0,48,
01/12/2013,N.L.,"SAN NICOLAS DE LOS GARZA, N.L.",21,7,28,19,0,1415,
02/12/2013,D.F.,"CUAUHTEMOC, D.F.",20,3,23,0,1,0,
02/12/2013,N.L.,"SAN NICOLAS DE LOS GARZA, N.L.",15,6,21,8,0,1917,
02/12/2013,SON.,"NAVOJOA, SON.",5,1,6,2,0,99,
02/12/2013,SON.,"PUERTO PEÑASCO, SON.",1,4,5,1,0,74,
02/12/2013,SON.,"GENERAL PLUTARCO ELIAS CALLES, SON.",2,2,4,3,0,66,
02/12/2013,SON.,"CAJEME, SON.",1,2,3,0,1,80,
02/12/2013,SON.,"HUATABAMPO, SON.",2,1,3,1,0,0,
02/12/2013,COAH.,"PIEDRAS NEGRAS, COAH.",0,2,2,0,0,0,
02/12/2013,COAH.,"SALTILLO, COAH.",2,0,2,4,0,462,
02/12/2013,CHIS.,"OCOSINGO, CHIS.",0,1,1,0,0,0,
02/12/2013,COL.,"MANZANILLO, COL.",1,0,1,0,0,0,
02/12/2013,SON.,"NOGALES, SON.",1,0,1,1,1,0,
02/12/2013,COAH.,"MONCLOVA, COAH.",0,1,1,0,0,0,
02/12/2013,SON.,"GUAYMAS, SON.",0,0,0,1,0,0,
02/12/2013,SON.,"ETCHOJOA, SON.",0,0,0,1,0,40,
03/12/2013,D.F.,"CUAUHTEMOC, D.F.",38,4,42,1,0,0,
03/12/2013,N.L.,"SAN NICOLAS DE LOS GARZA, N.L.",13,10,23,13,0,2321,
03/12/2013,SON.,"ALTAR, SON.",1,2,3,0,0,0,
03/12/2013,COAH.,"PIEDRAS NEGRAS, COAH.",2,1,3,1,0,41,
03/12/2013,SON.,"NOGALES, SON.",0,2,2,0,0,0,
03/12/2013,SON.,"AGUA PRIETA, SON.",1,0,1,1,0,14,
03/12/2013,SON.,"PUERTO PEÑASCO, SON.",1,0,1,0,0,0,
03/12/2013,SON.,"PITIQUITO, SON.",0,1,1,0,0,0,
03/12/2013,NAY.,"RUIZ, NAY.",0,1,1,0,0,0,
03/12/2013,TAMPS.,"EL MANTE, TAMPS.",1,0,1,0,0,0,
03/12/2013,SON.,"HERMOSILLO, SON.",1,0,1,0,0,74,
03/12/2013,SON.,"URES, SON.",1,0,1,0,0,284,
03/12/2013,SON.,"EMPALME, SON.",1,0,1,0,0,2,
03/12/2013,SON.,"CAJEME, SON.",1,0,1,0,0,0,
03/12/2013,SON.,"NAVOJOA, SON.",1,0,1,0,0,0,
03/12/2013,COAH.,"SALTILLO, COAH.",1,0,1,5,0,206,
03/12/2013,SON.,"CANANEA, SON.",0,0,0,0,0,40,
03/12/2013,SON.,"MAGDALENA, SON.",0,0,0,3,0,0,
03/12/2013,TAMPS.,"VICTORIA, TAMPS.",0,0,0,0,4,0,
04/12/2013,D.F.,"CUAUHTEMOC, D.F.",28,15,43,1,3,10,
04/12/2013,N.L.,"SAN NICOLAS DE LOS GARZA, N.L.",11,5,16,25,0,1388,
04/12/2013,COAH.,"PIEDRAS NEGRAS, COAH.",2,3,5,2,0,126,
04/12/2013,COAH.,"FRONTERA, COAH.",2,3,5,1,0,0,
04/12/2013,SON.,"GENERAL PLUTARCO ELIAS CALLES, SON.",3,0,3,3,0,0,
04/12/2013,SON.,"NOGALES, SON.",2,0,2,0,0,19,
04/12/2013,SON.,"AGUA PRIETA, SON.",2,0,2,1,0,0,
04/12/2013,B.C.,"TIJUANA, B.C.",2,0,2,0,0,0,
04/12/2013,SON.,"HERMOSILLO, SON.",1,1,2,3,0,20,
04/12/2013,SON.,"PUERTO PEÑASCO, SON.",1,0,1,0,0,0,
04/12/2013,SON.,"PITIQUITO, SON.",0,1,1,0,0,0,
04/12/2013,CHIH.,"CASAS GRANDES, CHIH.",1,0,1,0,0,0,
04/12/2013,N.L.,"JUAREZ, N.L.",1,0,1,5,1,0,
04/12/2013,TAMPS.,"NUEVO LAREDO, TAMPS.",1,0,1,0,0,370,
04/12/2013,SON.,"ALAMOS, SON.",1,0,1,0,0,0,
04/12/2013,SON.,"CABORCA, SON.",0,0,0,1,0,0,
04/12/2013,TAMPS.,"ALTAMIRA, TAMPS.",0,0,0,0,0,101,
04/12/2013,SON.,"GUAYMAS, SON.",0,0,0,2,0,626,
05/12/2013,D.F.,"CUAUHTEMOC, D.F.",38,2,40,4,5,5,
05/12/2013,N.L.,"SAN NICOLAS DE LOS GARZA, N.L.",7,3,10,4,0,335,
05/12/2013,TAMPS.,"TAMPICO, TAMPS.",9,0,9,6,0,435,
05/12/2013,TAMPS.,"VICTORIA, TAMPS.",6,1,7,3,0,100,
05/12/2013,TAMPS.,"NUEVO LAREDO, TAMPS.",3,3,6,2,0,222,
05/12/2013,SON.,"NAVOJOA, SON.",2,1,3,1,0,0,
05/12/2013,CHIH.,"NUEVO CASAS GRANDES, CHIH.",3,0,3,0,0,0,
05/12/2013,COAH.,"SALTILLO, COAH.",2,0,2,0,0,52,
05/12/2013,COAH.,"FRONTERA, COAH.",1,1,2,0,1,0,
05/12/2013,SON.,"HERMOSILLO, SON.",1,0,1,26,0,151,
05/12/2013,SON.,"BANAMICHI, SON.",0,1,1,0,0,0,
05/12/2013,SON.,"HUATABAMPO, SON.",1,0,1,0,0,0,
05/12/2013,SON.,"ETCHOJOA, SON.",1,0,1,0,0,6,
05/12/2013,SON.,"CABORCA, SON.",1,0,1,0,0,0,
05/12/2013,OAX.,"CIUDAD IXTEPEC, OAX.",1,0,1,1,0,0,
05/12/2013,CHIS.,"PALENQUE, CHIS.",1,0,1,1,0,2,
05/12/2013,SON.,"GUAYMAS, SON.",0,0,0,10,0,515,
05/12/2013,SON.,"NOGALES, SON.",0,0,0,0,0,8,
05/12/2013,SON.,"GENERAL PLUTARCO ELIAS CALLES, SON.",0,0,0,0,0,87,
06/12/2013,D.F.,"CUAUHTEMOC, D.F.",40,4,44,2,0,7,
06/12/2013,NAY.,"RUIZ, NAY.",14,8,22,0,0,0,
06/12/2013,SON.,"NOGALES, SON.",6,2,8,0,2,21,
06/12/2013,COAH.,"FRONTERA, COAH.",2,4,6,0,0,0,
06/12/2013,TAMPS.,"CIUDAD MADERO, TAMPS.",4,1,5,3,0,183,
06/12/2013,SON.,"GENERAL PLUTARCO ELIAS CALLES, SON.",5,0,5,1,2,100,
06/12/2013,CHIS.,"PALENQUE, CHIS.",3,1,4,1,0,20,
06/12/2013,SON.,"BANAMICHI, SON.",0,3,3,0,0,0,
06/12/2013,SON.,"ETCHOJOA, SON.",1,2,3,0,0,0,
06/12/2013,PUE.,"PUE., PUE.",2,0,2,0,1,92,
06/12/2013,YUC.,"CHUMAYEL, YUC.",1,1,2,0,0,0,
06/12/2013,B.C.,"TECATE, B.C.",0,1,1,0,0,0,
06/12/2013,SON.,"GUAYMAS, SON.",0,1,1,0,0,585,
06/12/2013,SON.,"CAJEME, SON.",1,0,1,0,0,0,
06/12/2013,N.L.,"SAN NICOLAS DE LOS GARZA, N.L.",0,1,1,0,0,0,
06/12/2013,TAMPS.,"GONZALEZ, TAMPS.",1,0,1,1,0,0,
06/12/2013,TAB.,"CARDENAS, TAB.",1,0,1,0,0,0,
06/12/2013,COAH.,"SALTILLO, COAH.",0,0,0,0,0,38,
06/12/2013,SON.,"HERMOSILLO, SON.",0,0,0,8,0,24,
06/12/2013,SON.,"EMPALME, SON.",0,0,0,3,0,0,
06/12/2013,SON.,"CABORCA, SON.",0,0,0,1,3,2,
07/12/2013,D.F.,"CUAUHTEMOC, D.F.",15,2,17,0,2,600,
07/12/2013,TAMPS.,"NUEVO LAREDO, TAMPS.",11,5,16,13,0,1201,
07/12/2013,TAMPS.,"VICTORIA, TAMPS.",4,0,4,6,0,100,
07/12/2013,SON.,"NAVOJOA, SON.",3,1,4,0,0,18,
07/12/2013,SON.,"EMPALME, SON.",2,1,3,0,0,20,
07/12/2013,SON.,"ETCHOJOA, SON.",3,0,3,2,0,40,
07/12/2013,N.L.,"GUADALUPE, N.L.",1,0,1,1,0,50,
07/12/2013,SON.,"BANAMICHI, SON.",1,0,1,0,0,0,
07/12/2013,SON.,"GUAYMAS, SON.",1,0,1,0,0,0,
07/12/2013,SON.,"HUATABAMPO, SON.",0,1,1,0,0,0,
07/12/2013,COAH.,"MONCLOVA, COAH.",1,0,1,0,0,0,
07/12/2013,SON.,"CABORCA, SON.",0,1,1,0,0,0,
07/12/2013,N.L.,"SANTA CATARINA, N.L.",0,0,0,0,0,50,
07/12/2013,CHIS.,"PALENQUE, CHIS.",0,0,0,0,0,76,
07/12/2013,SON.,"HERMOSILLO, SON.",0,0,0,85,0,442,
07/12/2013,SON.,"CAJEME, SON.",0,0,0,0,0,1,
07/12/2013,SON.,"ALAMOS, SON.",0,0,0,0,0,40,
07/12/2013,PUE.,"PUE., PUE.",0,0,0,0,0,73,
08/12/2013,D.F.,"CUAUHTEMOC, D.F.",17,3,20,1,0,40,
08/12/2013,N.L.,"SANTA CATARINA, N.L.",3,0,3,0,0,0,
08/12/2013,TAMPS.,"CIUDAD MADERO, TAMPS.",1,0,1,2,0,43,
08/12/2013,B.C.,"ENSENADA, B.C.",1,0,1,0,0,0,
09/12/2013,D.F.,"CUAUHTEMOC, D.F.",17,0,17,0,1,0,
09/12/2013,SON.,"CABORCA, SON.",3,3,6,0,0,0,
09/12/2013,SON.,"HERMOSILLO, SON.",2,1,3,7,1,0,
09/12/2013,SON.,"NOGALES, SON.",1,0,1,0,0,0,
09/12/2013,SON.,"GENERAL PLUTARCO ELIAS CALLES, SON.",1,0,1,0,0,0,
09/12/2013,SON.,"MAGDALENA, SON.",1,0,1,2,0,0,
09/12/2013,COAH.,"MONCLOVA, COAH.",1,0,1,0,0,0,
09/12/2013,COL.,"COL., COL.",1,0,1,0,0,0,
09/12/2013,SON.,"URES, SON.",0,1,1,0,0,0,
09/12/2013,SON.,"GUAYMAS, SON.",0,1,1,0,0,0,
09/12/2013,SON.,"NAVOJOA, SON.",1,0,1,8,0,105,
09/12/2013,SON.,"PUERTO PEÑASCO, SON.",0,0,0,0,0,193,
09/12/2013,TAMPS.,"VICTORIA, TAMPS.",0,0,0,2,0,37,
10/12/2013,SON.,"HERMOSILLO, SON.",6,6,12,33,0,1450,
10/12/2013,D.F.,"CUAUHTEMOC, D.F.",9,0,9,0,7,450,
10/12/2013,SON.,"CAJEME, SON.",4,1,5,1,0,0,
10/12/2013,SON.,"NAVOJOA, SON.",1,2,3,1,0,10,
10/12/2013,COAH.,"MONCLOVA, COAH.",1,2,3,0,0,223,
10/12/2013,N.L.,"SANTA CATARINA, N.L.",2,0,2,25,0,200,
10/12/2013,SON.,"PUERTO PEÑASCO, SON.",2,0,2,0,0,62,
10/12/2013,TAB.,"CARDENAS, TAB.",1,0,1,0,0,0,
10/12/2013,SON.,"MOCTEZUMA, SON.",1,0,1,1,0,0,
10/12/2013,N.L.,"GUADALUPE, N.L.",0,1,1,11,0,280,
10/12/2013,COAH.,"SALTILLO, COAH.",1,0,1,4,0,243,
10/12/2013,SON.,"NOGALES, SON.",0,1,1,2,0,102,
10/12/2013,SON.,"AGUA PRIETA, SON.",0,1,1,0,0,6,
10/12/2013,SON.,"CABORCA, SON.",1,0,1,0,0,0,
10/12/2013,SON.,"CANANEA, SON.",1,0,1,1,0,20,
10/12/2013,SON.,"URES, SON.",0,0,0,0,0,11,
10/12/2013,SON.,"SANTA ANA, SON.",0,0,0,0,0,10,
10/12/2013,SON.,"GENERAL PLUTARCO ELIAS CALLES, SON.",0,0,0,0,0,60,
10/12/2013,SON.,"MAGDALENA, SON.",0,0,0,0,0,10,
11/12/2013,D.F.,"CUAUHTEMOC, D.F.",13,3,16,0,2,0,
11/12/2013,COAH.,"MONCLOVA, COAH.",2,1,3,0,0,439,
11/12/2013,COAH.,"SALTILLO, COAH.",3,0,3,3,0,403,
11/12/2013,TAMPS.,"NUEVO LAREDO, TAMPS.",1,1,2,36,0,347,
11/12/2013,CHIS.,"PALENQUE, CHIS.",2,0,2,0,0,113,
11/12/2013,N.L.,"GARCIA, N.L.",1,0,1,28,0,0,
11/12/2013,B.C.S.,"MULEGÉ, B.C.S.",0,1,1,0,0,0,
11/12/2013,CAMP.,"CARMEN, CAMP.",0,1,1,0,0,0,
11/12/2013,TAMPS.,"ALTAMIRA, TAMPS.",0,0,0,2,0,15,
11/12/2013,TAMPS.,"VICTORIA, TAMPS.",0,0,0,3,0,50,
11/12/2013,PUE.,"ATLIXCO, PUE.",0,0,0,0,0,326,
12/12/2013,D.F.,"CUAUHTEMOC, D.F.",10,3,13,0,3,800,
12/12/2013,COAH.,"MONCLOVA, COAH.",1,3,4,0,0,0,
12/12/2013,CAMP.,"CAMP., CAMP.",3,1,4,0,0,0,
12/12/2013,TAMPS.,"NUEVO LAREDO, TAMPS.",0,2,2,47,0,389,
12/12/2013,N.L.,"GARCIA, N.L.",2,0,2,4,0,0,
12/12/2013,PUE.,"ATLIXCO, PUE.",1,0,1,0,0,0,
12/12/2013,TAMPS.,"REYNOSA, TAMPS.",1,0,1,0,0,0,
12/12/2013,COAH.,"SALTILLO, COAH.",0,1,1,0,0,0,
12/12/2013,N.L.,"SANTIAGO, N.L.",0,0,0,11,0,400,
12/12/2013,COAH.,"ACUÑA, COAH.",0,0,0,1,0,160,
13/12/2013,D.F.,"CUAUHTEMOC, D.F.",10,1,11,0,0,250,
13/12/2013,TAMPS.,"NUEVO LAREDO, TAMPS.",6,0,6,0,0,635,
13/12/2013,TAMPS.,"REYNOSA, TAMPS.",1,3,4,0,0,0,
13/12/2013,TAMPS.,"TAMPICO, TAMPS.",4,0,4,1,0,213,
13/12/2013,N.L.,"GARCIA, N.L.",0,1,1,4,0,150,
13/12/2013,PUE.,"ATLIXCO, PUE.",1,0,1,0,0,57,
13/12/2013,TAMPS.,"CIUDAD MADERO, TAMPS.",0,0,0,0,1,19,
14/12/2013,D.F.,"CUAUHTEMOC, D.F.",6,2,8,0,0,20,
14/12/2013,PUE.,"ATLIXCO, PUE.",3,1,4,0,0,146,
14/12/2013,COAH.,"ACUÑA, COAH.",0,3,3,0,0,0,
14/12/2013,TAMPS.,"REYNOSA, TAMPS.",1,0,1,6,0,300,
14/12/2013,N.L.,"GARCIA, N.L.",1,0,1,22,0,100,
14/12/2013,N.L.,"SANTIAGO, N.L.",1,0,1,4,0,144,
14/12/2013,CHIS.,"PALENQUE, CHIS.",1,0,1,0,0,48,
14/12/2013,CHIH.,"CHIH., CHIH.",0,0,0,0,15,0,
15/12/2013,D.F.,"CUAUHTEMOC, D.F.",12,0,12,3,0,0,
15/12/2013,TAMPS.,"REYNOSA, TAMPS.",3,2,5,0,0,0,
15/12/2013,TAMPS.,"CIUDAD MADERO, TAMPS.",0,0,0,0,0,22,
15/12/2013,N.L.,"GARCIA, N.L.",0,0,0,28,0,0,
16/12/2013,SON.,"EMPALME, SON.",11,0,11,0,0,0,
16/12/2013,TAMPS.,"VICTORIA, TAMPS.",8,1,9,15,0,0,
16/12/2013,TAMPS.,"MATAMOROS, TAMPS.",2,4,6,1,0,20,
16/12/2013,D.F.,"CUAUHTEMOC, D.F.",5,0,5,0,0,0,
16/12/2013,COAH.,"MONCLOVA, COAH.",5,0,5,0,0,143,
16/12/2013,N.L.,"MONTEMOR., N.L.",0,2,2,0,0,0,
16/12/2013,COAH.,"SALTILLO, COAH.",1,0,1,0,0,418,
16/12/2013,SON.,"MOCTEZUMA, SON.",1,0,1,0,0,0,
17/12/2013,D.F.,"CUAUHTEMOC, D.F.",6,0,6,0,0,0,
17/12/2013,PUE.,"ATLIXCO, PUE.",3,2,5,0,0,0,
17/12/2013,N.L.,"MONTEMOR., N.L.",0,2,2,0,1,0,
17/12/2013,TAMPS.,"VICTORIA, TAMPS.",0,0,0,0,0,500,
17/12/2013,N.L.,"CADEREYTA JIMENEZ, N.L.",0,0,0,3,0,250,
18/12/2013,D.F.,"CUAUHTEMOC, D.F.",12,2,14,0,1,0,
18/12/2013,TAMPS.,"MATAMOROS, TAMPS.",7,7,14,0,0,175,
18/12/2013,N.L.,"MONTEMOR., N.L.",2,6,8,0,0,150,
18/12/2013,CHIH.,"OJINAGA, CHIH.",0,3,3,0,0,0,
18/12/2013,B.C.,"TIJUANA, B.C.",1,1,2,0,0,0,
18/12/2013,YUC.,"VALLADOLID, YUC.",0,1,1,0,0,0,
18/12/2013,PUE.,"ATLIXCO, PUE.",1,0,1,0,0,0,
18/12/2013,PUE.,"NICOLAS BRAVO, PUE.",0,0,0,0,0,58,
19/12/2013,D.F.,"CUAUHTEMOC, D.F.",21,1,22,1,1,7,
19/12/2013,TAMPS.,"TAMPICO, TAMPS.",3,1,4,2,0,189,
19/12/2013,CHIH.,"OJINAGA, CHIH.",0,3,3,0,0,0,
19/12/2013,CAMP.,"CAMP., CAMP.",0,1,1,0,0,0,
19/12/2013,PUE.,"ATLIXCO, PUE.",1,0,1,0,0,0,
19/12/2013,TAMPS.,"NUEVO LAREDO, TAMPS.",0,0,0,12,0,814,
20/12/2013,D.F.,"CUAUHTEMOC, D.F.",19,0,19,0,0,0,
20/12/2013,TAMPS.,"MATAMOROS, TAMPS.",8,6,14,0,3,0,
20/12/2013,CHIH.,"OJINAGA, CHIH.",3,4,7,0,0,0,
20/12/2013,TAMPS.,"NUEVO LAREDO, TAMPS.",1,2,3,10,0,495,
20/12/2013,N.L.,"CADEREYTA JIMENEZ, N.L.",0,2,2,0,0,245,
20/12/2013,PUE.,"ATLIXCO, PUE.",0,0,0,0,0,20,
21/12/2013,D.F.,"CUAUHTEMOC, D.F.",16,0,16,0,0,0,
22/12/2013,D.F.,"CUAUHTEMOC, D.F.",36,1,37,3,1,30,
22/12/2013,TAMPS.,"GONZALEZ, TAMPS.",3,0,3,0,0,35,
22/12/2013,TAMPS.,"NUEVO LAREDO, TAMPS.",1,0,1,0,0,173,
23/12/2013,COL.,"COL., COL.",1,0,1,0,0,0,
26/12/2013,GRO.,"CHILPANCINGO DE LOS BRAVO, GRO.",1,0,1,0,0,0,
27/12/2013,TAMPS.,"MATAMOROS, TAMPS.",6,2,8,2,0,618,
27/12/2013,TAMPS.,"NUEVO LAREDO, TAMPS.",6,1,7,12,0,950,
28/12/2013,PUE.,"ATLIXCO, PUE.",0,1,1,0,3,0,
28/12/2013,TAMPS.,"NUEVO LAREDO, TAMPS.",0,0,0,4,0,580,
29/12/2013,TAMPS.,"GONZALEZ, TAMPS.",3,0,3,8,0,222,
01/01/2014,TAMPS.,"MATAMOROS, TAMPS.",1,2,3,0,0,32,
02/01/2014,PUE.,"ATLIXCO, PUE.",2,0,2,0,0,0,
02/01/2014,TAMPS.,"NUEVO LAREDO, TAMPS.",1,0,1,1,0,209,
03/01/2014,PUE.,"PALMAR DE BRAVO, PUE.",3,0,3,0,0,0,
03/01/2014,TAMPS.,"NUEVO LAREDO, TAMPS.",2,1,3,5,0,1933,
04/01/2014,TAMPS.,"GONZALEZ, TAMPS.",2,4,6,2,0,4,
04/01/2014,TAMPS.,"NUEVO LAREDO, TAMPS.",1,1,2,51,0,836,
04/01/2014,PUE.,"ATLIXCO, PUE.",0,1,1,0,0,0,
04/01/2014,TAB.,"TENOSIQUE, TAB.",0,1,1,1,0,0,
07/01/2014,PUE.,"PUE., PUE.",8,0,8,0,2,292,
07/01/2014,Q. ROO,"OTHON P. BLANCO, Q. ROO",1,0,1,0,0,0,
08/01/2014,PUE.,"PUE., PUE.",6,0,6,4,1,383,
08/01/2014,CHIH.,"IGNACIO ZARAGOZA, CHIH.",1,0,1,0,0,0,
09/01/2014,PUE.,"PUE., PUE.",17,0,17,5,0,177,
09/01/2014,TAMPS.,"NUEVO LAREDO, TAMPS.",0,5,5,27,0,1471,
09/01/2014,TAMPS.,"NUEVO LAREDO, TAMPS.",1,1,2,5,0,1078,
09/01/2014,TAMPS.,"GONZALEZ, TAMPS.",1,1,2,0,0,66,
09/01/2014,CHIH.,"IGNACIO ZARAGOZA, CHIH.",1,0,1,0,0,0,
09/01/2014,Q. ROO,"OTHON P. BLANCO, Q. ROO",0,0,0,0,0,24,
10/01/2014,PUE.,"PUE., PUE.",24,2,26,21,0,948,
10/01/2014,CHIH.,"CHIH., CHIH.",0,3,3,0,0,0,
11/01/2014,PUE.,"PUE., PUE.",10,0,10,0,0,65,
11/01/2014,TAMPS.,"TAMPICO, TAMPS.",5,1,6,0,0,87,
11/01/2014,TAMPS.,"NUEVO LAREDO, TAMPS.",2,0,2,47,0,2244,
11/01/2014,YUC.,"OXKUTZCAB, YUC.",1,0,1,0,0,0,
12/01/2014,Q. ROO,"BENITO JUAREZ, Q. ROO",0,0,0,0,0,39,
13/01/2014,Q. ROO,"BENITO JUAREZ, Q. ROO",0,0,0,0,1,96,
13/01/2014,Q. ROO,"COZUMEL, Q. ROO",0,0,0,0,2,0,
14/01/2014,PUE.,"PUE., PUE.",12,0,12,4,0,283,
14/01/2014,Q. ROO,"BENITO JUAREZ, Q. ROO",4,0,4,0,1,245,
15/01/2014,Q. ROO,"BENITO JUAREZ, Q. ROO",2,0,2,0,1,259,
15/01/2014,CHIH.,"HGO. DEL PARRAL, CHIH.",2,0,2,0,0,2,
15/01/2014,PUE.,"PUE., PUE.",1,0,1,0,0,86,
15/01/2014,Q. ROO,"COZUMEL, Q. ROO",0,0,0,0,0,6,
15/01/2014,Q. ROO,"OTHON P. BLANCO, Q. ROO",0,0,0,0,0,25,
16/01/2014,Q. ROO,"BENITO JUAREZ, Q. ROO",3,0,3,0,0,259,
16/01/2014,TAMPS.,"CIUDAD MADERO, TAMPS.",1,1,2,0,0,1217,
16/01/2014,Q. ROO,"COZUMEL, Q. ROO",1,0,1,0,0,26,
16/01/2014,VER.,"COATZACOALCOS, VER.",0,1,1,0,0,0,
16/01/2014,PUE.,"PUE., PUE.",1,0,1,0,0,0,
16/01/2014,CAMP.,"CANDELARIA, CAMP.",0,1,1,0,0,0,
16/01/2014,TAMPS.,"TAMPICO, TAMPS.",1,0,1,0,0,71,
17/01/2014,TAMPS.,"CIUDAD MADERO, TAMPS.",6,3,9,9,0,225,
17/01/2014,TAMPS.,"NUEVO LAREDO, TAMPS.",1,2,3,7,0,1571,
17/01/2014,Q. ROO,"BENITO JUAREZ, Q. ROO",1,1,2,0,0,190,
17/01/2014,YUC.,"CHICHIMILA, YUC.",1,0,1,0,0,0,
17/01/2014,PUE.,"PUE., PUE.",0,1,1,0,0,0,
18/01/2014,VER.,"COATZACOALCOS, VER.",2,0,2,0,0,0,
18/01/2014,Q. ROO,"BENITO JUAREZ, Q. ROO",1,1,2,0,0,190,
18/01/2014,PUE.,"PUE., PUE.",0,1,1,0,0,130,
19/01/2014,TAMPS.,"CIUDAD MADERO, TAMPS.",2,0,2,0,0,8,
19/01/2014,TAMPS.,"GONZALEZ, TAMPS.",1,0,1,0,0,165,
19/01/2014,Q. ROO,"OTHON P. BLANCO, Q. ROO",0,0,0,0,2,20,
20/01/2014,TAMPS.,"GONZALEZ, TAMPS.",1,0,1,0,0,0,
20/01/2014,Q. ROO,"OTHON P. BLANCO, Q. ROO",1,0,1,0,0,69,
20/01/2014,COAH.,"MONCLOVA, COAH.",1,0,1,0,0,0,
20/01/2014,COAH.,"SALTILLO, COAH.",1,0,1,0,0,40,
20/01/2014,Q. ROO,"COZUMEL, Q. ROO",0,0,0,0,0,239,
20/01/2014,Q. ROO,"BENITO JUAREZ, Q. ROO",0,0,0,0,0,414,
21/01/2014,Q. ROO,"BENITO JUAREZ, Q. ROO",2,0,2,0,0,312,
21/01/2014,COAH.,"ACUÑA, COAH.",0,2,2,0,0,0,
21/01/2014,CHIH.,"ROSALES, CHIH.",1,0,1,0,0,0,
21/01/2014,TAB.,"NACAJUCA, TAB.",1,0,1,0,0,0,
21/01/2014,COAH.,"FRONTERA, COAH.",1,0,1,0,0,0,
21/01/2014,PUE.,"PUE., PUE.",0,0,0,0,2,0,
21/01/2014,COAH.,"SALTILLO, COAH.",0,0,0,1,0,207,
22/01/2014,COAH.,"SALTILLO, COAH.",2,1,3,0,0,52,
22/01/2014,PUE.,"TEHUACAN, PUE.",3,0,3,0,4,0,
22/01/2014,Q. ROO,"COZUMEL, Q. ROO",0,0,0,0,0,100,
22/01/2014,Q. ROO,"BENITO JUAREZ, Q. ROO",0,0,0,0,0,343,
22/01/2014,Q. ROO,"OTHON P. BLANCO, Q. ROO",0,0,0,0,0,44,
22/01/2014,PUE.,"PUE., PUE.",0,0,0,0,0,0,
23/01/2014,S.L.P.,"CIUDAD VALLES, S.L.P.",5,0,5,0,0,0,
23/01/2014,TAMPS.,"NUEVO LAREDO, TAMPS.",1,3,4,4,0,1133,
23/01/2014,COAH.,"SALTILLO, COAH.",0,2,2,0,1,194,
23/01/2014,CAMP.,"CANDELARIA, CAMP.",0,1,1,1,0,0,
23/01/2014,TAB.,"NACAJUCA, TAB.",1,0,1,1,0,0,
23/01/2014,PUE.,"TEHUACAN, PUE.",1,0,1,0,0,0,
23/01/2014,PUE.,"PUE., PUE.",1,0,1,0,0,0,
23/01/2014,Q. ROO,"BENITO JUAREZ, Q. ROO",1,0,1,0,0,310,
23/01/2014,COAH.,"ACUÑA, COAH.",1,0,1,0,0,0,
23/01/2014,Q. ROO,"OTHON P. BLANCO, Q. ROO",0,0,0,0,0,109,
23/01/2014,COAH.,"FRONTERA, COAH.",0,0,0,0,0,170,
24/01/2014,S.L.P.,"SAN LUIS POTOSI, S.L.P.",3,0,3,0,0,0,
24/01/2014,COAH.,"SALTILLO, COAH.",1,2,3,1,1,401,
24/01/2014,PUE.,"TEHUACAN, PUE.",2,0,2,4,2,0,
24/01/2014,COAH.,"FRONTERA, COAH.",2,0,2,1,1,397,
24/01/2014,PUE.,"PUE., PUE.",0,1,1,0,0,0,
24/01/2014,Q. ROO,"BENITO JUAREZ, Q. ROO",1,0,1,0,0,577,
24/01/2014,Q. ROO,"OTHON P. BLANCO, Q. ROO",1,0,1,1,0,9,
24/01/2014,TAMPS.,"NUEVO LAREDO, TAMPS.",1,0,1,10,0,1099,
24/01/2014,CAMP.,"CANDELARIA, CAMP.",0,1,1,0,0,0,
24/01/2014,CHIH.,"GÓMEZ FARÍAS, CHIH.",1,0,1,0,0,0,
25/01/2014,S.L.P.,"SAN LUIS POTOSI, S.L.P.",5,0,5,0,0,0,
25/01/2014,PUE.,"TEHUACAN, PUE.",2,1,3,0,0,45,
25/01/2014,TAMPS.,"NUEVO LAREDO, TAMPS.",0,1,1,11,0,342,
25/01/2014,TAMPS.,"GONZALEZ, TAMPS.",1,0,1,1,0,0,
26/01/2014,COAH.,"ZARAGOZA, COAH.",0,2,2,0,0,0,
26/01/2014,CAMP.,"CANDELARIA, CAMP.",0,1,1,0,0,0,
26/01/2014,COAH.,"MOR., COAH.",1,0,1,0,0,27,
26/01/2014,COAH.,"ACUÑA, COAH.",1,0,1,0,0,0,
27/01/2014,S.L.P.,"SAN LUIS POTOSI, S.L.P.",3,0,3,0,0,0,
27/01/2014,Q. ROO,"BENITO JUAREZ, Q. ROO",1,0,1,0,0,205,
27/01/2014,COAH.,"TORREÓN, COAH.",1,0,1,0,0,0,
27/01/2014,COAH.,"SALTILLO, COAH.",1,0,1,0,0,0,
28/01/2014,S.L.P.,"SAN LUIS POTOSI, S.L.P.",2,0,2,0,0,0,
28/01/2014,S.L.P.,"SALINAS, S.L.P.",1,1,2,0,0,0,
28/01/2014,CAMP.,"CANDELARIA, CAMP.",0,1,1,0,0,0,
28/01/2014,TAB.,"TENOSIQUE, TAB.",1,0,1,0,0,0,
28/01/2014,PUE.,"PUE., PUE.",1,0,1,0,0,0,
28/01/2014,COAH.,"MONCLOVA, COAH.",1,0,1,0,0,145,
29/01/2014,S.L.P.,"SAN LUIS POTOSI, S.L.P.",3,2,5,0,0,0,
29/01/2014,COAH.,"SALTILLO, COAH.",3,0,3,0,0,79,
29/01/2014,COAH.,"MONCLOVA, COAH.",2,0,2,0,0,0,
29/01/2014,TAB.,"NACAJUCA, TAB.",1,0,1,0,0,0,
29/01/2014,PUE.,"TEHUACAN, PUE.",1,0,1,0,0,3,
29/01/2014,Q. ROO,"BENITO JUAREZ, Q. ROO",1,0,1,0,0,577,
29/01/2014,COAH.,"ACUÑA, COAH.",0,1,1,0,0,0,
30/01/2014,COAH.,"SALTILLO, COAH.",3,0,3,0,0,80,
30/01/2014,S.L.P.,"SAN LUIS POTOSI, S.L.P.",2,0,2,0,0,0,
30/01/2014,TAMPS.,"CIUDAD MADERO, TAMPS.",1,0,1,0,0,0,
30/01/2014,PUE.,"PUE., PUE.",1,0,1,1,0,0,
30/01/2014,COAH.,"FRONTERA, COAH.",0,1,1,0,0,0,
30/01/2014,Q. ROO,"BACALAR, Q. ROO",1,0,1,0,0,0,
30/01/2014,TAB.,"NACAJUCA, TAB.",1,0,1,0,0,35,
30/01/2014,Q. ROO,"BENITO JUAREZ, Q. ROO",0,0,0,0,0,283,
31/01/2014,NAY.,"TEPIC, NAY.",2,0,2,0,0,0,
31/01/2014,PUE.,"PUE., PUE.",1,0,1,11,0,0,
31/01/2014,COAH.,"SALTILLO, COAH.",1,0,1,3,0,405,
31/01/2014,COAH.,"FRONTERA, COAH.",0,0,0,3,0,84,
01/02/2014,TAMPS.,"REYNOSA, TAMPS.",1,5,6,1,0,105,
01/02/2014,COAH.,"FRONTERA, COAH.",2,0,2,0,0,0,
01/02/2014,COAH.,"SALTILLO, COAH.",0,1,1,0,0,114,
01/02/2014,COAH.,"ACUÑA, COAH.",1,0,1,0,0,0,
01/02/2014,COAH.,"PIEDRAS NEGRAS, COAH.",1,0,1,0,0,0,
01/02/2014,COAH.,"TORREÓN, COAH.",1,0,1,0,0,0,
01/02/2014,PUE.,"TEHUACAN, PUE.",0,0,0,0,0,35,
02/02/2014,TAMPS.,"REYNOSA, TAMPS.",4,3,7,0,0,300,
02/02/2014,Q. ROO,"BACALAR, Q. ROO",0,2,2,0,5,40,
02/02/2014,Q. ROO,"SOLIDARIDAD, Q. ROO",0,1,1,0,0,53,
03/02/2014,COAH.,"PIEDRAS NEGRAS, COAH.",1,4,5,0,0,0,
03/02/2014,COAH.,"TORREÓN, COAH.",1,1,2,0,1,0,
04/02/2014,COAH.,"TORREÓN, COAH.",3,1,4,0,0,0,
04/02/2014,COAH.,"MÚZQUIZ, COAH.",2,2,4,2,0,49,
04/02/2014,VER.,"BOCA DEL RIO, VER.",2,1,3,0,1,0,
04/02/2014,PUE.,"TEHUACAN, PUE.",0,3,3,0,0,0,
04/02/2014,COAH.,"FRONTERA, COAH.",1,0,1,0,0,25,
04/02/2014,MICH.,"LAZARO CARDENAS, MICH.",0,1,1,0,0,0,
04/02/2014,PUE.,"PUE., PUE.",1,0,1,0,0,0,
04/02/2014,COAH.,"SALTILLO, COAH.",0,0,0,0,1,0,
05/02/2014,COAH.,"TORREÓN, COAH.",7,2,9,0,0,0,
05/02/2014,COAH.,"PIEDRAS NEGRAS, COAH.",2,4,6,3,0,315,
05/02/2014,VER.,"BOCA DEL RIO, VER.",3,1,4,0,0,0,
05/02/2014,COAH.,"MÚZQUIZ, COAH.",2,0,2,1,0,46,
05/02/2014,MICH.,"LAZARO CARDENAS, MICH.",2,0,2,0,0,0,
05/02/2014,S.L.P.,"TANQUIAN DE ESCOBEDO, S.L.P.",2,0,2,1,0,67,
05/02/2014,MEX.,"JUCHITEPEC, MEX.",1,0,1,0,0,0,
05/02/2014,PUE.,"TEHUACAN, PUE.",1,0,1,1,0,50,
05/02/2014,PUE.,"PUE., PUE.",1,0,1,0,0,0,
05/02/2014,COAH.,"SALTILLO, COAH.",0,1,1,0,0,133,
05/02/2014,COAH.,"MONCLOVA, COAH.",1,0,1,0,0,0,
06/02/2014,COAH.,"PIEDRAS NEGRAS, COAH.",2,6,8,0,0,181,
06/02/2014,VER.,"BOCA DEL RIO, VER.",2,5,7,0,0,0,
06/02/2014,COAH.,"TORREÓN, COAH.",7,0,7,0,1,100,
06/02/2014,CAMP.,"CAMP., CAMP.",2,2,4,0,0,0,
06/02/2014,S.L.P.,"SAN LUIS POTOSI, S.L.P.",2,0,2,0,0,0,
06/02/2014,PUE.,"PUE., PUE.",2,0,2,0,0,0,
06/02/2014,S.L.P.,"CIUDAD DEL MAIZ, S.L.P.",1,0,1,0,0,0,
06/02/2014,NAY.,"TEPIC, NAY.",1,0,1,0,0,0,
06/02/2014,MICH.,"LAZARO CARDENAS, MICH.",0,1,1,0,0,0,
06/02/2014,TAMPS.,"TAMPICO, TAMPS.",1,0,1,0,0,103,
06/02/2014,MEX.,"JUCHITEPEC, MEX.",1,0,1,0,0,0,
06/02/2014,COAH.,"SALTILLO, COAH.",0,1,1,1,1,319,
06/02/2014,COAH.,"MONCLOVA, COAH.",0,0,0,0,0,125,
07/02/2014,VER.,"BOCA DEL RIO, VER.",11,0,11,0,0,0,
07/02/2014,COAH.,"PIEDRAS NEGRAS, COAH.",5,2,7,0,0,14,
07/02/2014,COAH.,"TORREÓN, COAH.",2,2,4,0,0,35,
07/02/2014,COAH.,"SALTILLO, COAH.",3,1,4,0,0,106,
07/02/2014,COAH.,"MONCLOVA, COAH.",2,0,2,0,0,318,
07/02/2014,YUC.,"DZAN, YUC.",1,0,1,0,0,0,
07/02/2014,YUC.,"MANI, YUC.",0,1,1,0,0,0,
08/02/2014,VER.,"BOCA DEL RIO, VER.",4,0,4,0,0,0,
08/02/2014,MEX.,"JUCHITEPEC, MEX.",1,1,2,0,0,40,
08/02/2014,COAH.,"FRONTERA, COAH.",1,1,2,0,0,0,
08/02/2014,COAH.,"SALTILLO, COAH.",0,1,1,1,0,49,
08/02/2014,COAH.,"PIEDRAS NEGRAS, COAH.",0,1,1,0,0,0,
09/02/2014,COAH.,"ACUÑA, COAH.",1,1,2,0,0,0,
10/02/2014,N.L.,"MONTERREY, N.L.",3,11,14,14,0,7253,
10/02/2014,D.F.,"CUAUHTEMOC, D.F.",6,2,8,0,3,50,
10/02/2014,COAH.,"TORREÓN, COAH.",7,0,7,0,0,198,
10/02/2014,COAH.,"PIEDRAS NEGRAS, COAH.",4,2,6,7,1,394,
10/02/2014,VER.,"BOCA DEL RIO, VER.",3,1,4,0,0,0,
10/02/2014,MICH.,"LAZARO CARDENAS, MICH.",4,0,4,0,0,4,
10/02/2014,COAH.,"MÚZQUIZ, COAH.",3,0,3,2,0,14,
10/02/2014,COAH.,"MONCLOVA, COAH.",1,1,2,1,0,5,
10/02/2014,COAH.,"SALTILLO, COAH.",2,0,2,474,2,0,
10/02/2014,ZAC.,"TLALTENANGO DE SANCHEZ ROMAN, ZAC.",1,0,1,0,0,0,
10/02/2014,VER.,"ORIZABA, VER.",0,1,1,0,0,0,
11/02/2014,D.F.,"CUAUHTEMOC, D.F.",14,0,14,0,1,118,
11/02/2014,COAH.,"SALTILLO, COAH.",4,0,4,2,0,77,
11/02/2014,MICH.,"LAZARO CARDENAS, MICH.",0,3,3,14,0,73,
11/02/2014,VER.,"BOCA DEL RIO, VER.",1,2,3,0,0,0,
11/02/2014,NAY.,"TEPIC, NAY.",2,0,2,0,0,0,
11/02/2014,TAB.,"CARDENAS, TAB.",0,2,2,0,0,0,
11/02/2014,CAMP.,"CAMP., CAMP.",2,0,2,0,0,0,
11/02/2014,ZAC.,"FRESNILLO, ZAC.",1,1,2,0,0,0,
11/02/2014,COAH.,"MÚZQUIZ, COAH.",0,2,2,0,0,0,
11/02/2014,ZAC.,"TLALTENANGO DE SANCHEZ ROMAN, ZAC.",1,0,1,0,0,22,
11/02/2014,COAH.,"PIEDRAS NEGRAS, COAH.",1,0,1,3,0,69,
12/02/2014,D.F.,"CUAUHTEMOC, D.F.",18,5,23,0,0,138,
12/02/2014,MICH.,"LAZARO CARDENAS, MICH.",4,1,5,2,0,1,
12/02/2014,VER.,"BOCA DEL RIO, VER.",1,2,3,0,0,0,
12/02/2014,COAH.,"SALTILLO, COAH.",3,0,3,0,0,104,
12/02/2014,COAH.,"PIEDRAS NEGRAS, COAH.",2,1,3,0,0,0,
12/02/2014,COAH.,"MÚZQUIZ, COAH.",1,1,2,1,0,62,
12/02/2014,PUE.,"TEHUACAN, PUE.",1,0,1,0,0,0,
12/02/2014,NAY.,"ACAPONETA, NAY.",1,0,1,0,0,0,
12/02/2014,TAB.,"CARDENAS, TAB.",1,0,1,1,0,0,
12/02/2014,VER.,"TUXPAM, VER.",0,1,1,0,0,11,
12/02/2014,Q. ROO,"SOLIDARIDAD, Q. ROO",0,0,0,0,0,22,
12/02/2014,ZAC.,"TLALTENANGO DE SANCHEZ ROMAN, ZAC.",0,0,0,0,0,129,
13/02/2014,D.F.,"CUAUHTEMOC, D.F.",19,3,22,0,0,390,
13/02/2014,COAH.,"PIEDRAS NEGRAS, COAH.",4,3,7,0,0,240,
13/02/2014,CAMP.,"CAMP., CAMP.",1,0,1,0,0,0,
13/02/2014,PUE.,"TEHUACAN, PUE.",1,0,1,0,0,0,
13/02/2014,ZAC.,"TLALTENANGO DE SANCHEZ ROMAN, ZAC.",1,0,1,0,0,0,
13/02/2014,ZAC.,"JEREZ, ZAC.",1,0,1,0,0,0,
13/02/2014,COAH.,"SALTILLO, COAH.",0,1,1,0,0,30,
13/02/2014,COAH.,"MÚZQUIZ, COAH.",1,0,1,0,0,2,
13/02/2014,Q. ROO,"BACALAR, Q. ROO",0,0,0,0,0,0,
13/02/2014,Q. ROO,"SOLIDARIDAD, Q. ROO",0,0,0,0,0,22,
13/02/2014,COAH.,"FRONTERA, COAH.",0,0,0,0,0,44,
14/02/2014,D.F.,"CUAUHTEMOC, D.F.",12,2,14,0,0,110,
14/02/2014,COAH.,"PIEDRAS NEGRAS, COAH.",0,5,5,0,0,0,
14/02/2014,COAH.,"SALTILLO, COAH.",2,1,3,0,0,49,
14/02/2014,VER.,"TUXPAM, VER.",1,1,2,0,0,50,
14/02/2014,MICH.,"LAZARO CARDENAS, MICH.",0,1,1,0,0,0,
14/02/2014,TAMPS.,"TAMPICO, TAMPS.",1,0,1,0,0,151,
14/02/2014,Q. ROO,"BACALAR, Q. ROO",0,0,0,0,0,50,
14/02/2014,Q. ROO,"SOLIDARIDAD, Q. ROO",0,0,0,0,0,20,
15/02/2014,JAL.,"LA HUERTA, JAL.",1,1,2,0,0,0,
15/02/2014,VER.,"TUXPAM, VER.",1,0,1,1,0,11,
15/02/2014,COAH.,"PIEDRAS NEGRAS, COAH.",0,1,1,0,0,105,
16/02/2014,TAB.,"NACAJUCA, TAB.",0,1,1,0,0,0,
17/02/2014,D.F.,"CUAUHTEMOC, D.F.",14,1,15,0,0,512,
17/02/2014,COAH.,"PIEDRAS NEGRAS, COAH.",4,1,5,0,0,180,
17/02/2014,MICH.,"LAZARO CARDENAS, MICH.",1,2,3,1,0,0,
17/02/2014,B.C.S.,"MULEGÉ, B.C.S.",1,1,2,0,0,0,
17/02/2014,VER.,"MARTINEZ DE LA TORRE, VER.",2,0,2,0,0,0,
17/02/2014,COAH.,"SALTILLO, COAH.",2,0,2,0,0,0,
17/02/2014,COAH.,"MÚZQUIZ, COAH.",1,1,2,0,0,44,
17/02/2014,NAY.,"ACAPONETA, NAY.",1,0,1,0,0,0,
17/02/2014,VER.,"XALAPA, VER.",1,0,1,0,0,0,
17/02/2014,CHIH.,"NUEVO CASAS GRANDES, CHIH.",1,0,1,0,0,0,
17/02/2014,COAH.,"ACUÑA, COAH.",1,0,1,0,0,0,
17/02/2014,COAH.,"FRONTERA, COAH.",0,0,0,0,0,83,
18/02/2014,D.F.,"CUAUHTEMOC, D.F.",8,1,9,0,0,320,
18/02/2014,COAH.,"MÚZQUIZ, COAH.",2,2,4,0,0,69,
18/02/2014,HGO.,"METEPEC, HGO.",1,1,2,0,0,0,
18/02/2014,MICH.,"LAZARO CARDENAS, MICH.",2,0,2,1,0,0,
18/02/2014,ZAC.,"APOZOL, ZAC.",2,0,2,0,0,0,
18/02/2014,VER.,"TUXPAM, VER.",0,1,1,3,0,82,
18/02/2014,VER.,"MARTINEZ DE LA TORRE, VER.",0,1,1,0,0,0,
18/02/2014,ZAC.,"TLALTENANGO DE SANCHEZ ROMAN, ZAC.",1,0,1,0,0,0,
18/02/2014,COAH.,"SALTILLO, COAH.",1,0,1,0,0,0,
18/02/2014,ZAC.,"JEREZ, ZAC.",0,0,0,1,0,27,
19/02/2014,D.F.,"CUAUHTEMOC, D.F.",16,5,21,0,1,158,
19/02/2014,COAH.,"PIEDRAS NEGRAS, COAH.",3,4,7,0,0,0,
19/02/2014,VER.,"MARTINEZ DE LA TORRE, VER.",3,0,3,0,0,0,
19/02/2014,COAH.,"FRONTERA, COAH.",1,0,1,0,0,16,
19/02/2014,VER.,"XALAPA, VER.",0,0,0,0,0,16,
19/02/2014,COAH.,"SALTILLO, COAH.",0,0,0,10,0,0,
20/02/2014,D.F.,"CUAUHTEMOC, D.F.",11,4,15,0,0,20,
20/02/2014,CHIH.,"JUÁREZ, CHIH.",4,1,5,0,0,0,
20/02/2014,MICH.,"LAZARO CARDENAS, MICH.",1,1,2,0,0,0,
20/02/2014,VER.,"XALAPA, VER.",1,0,1,0,0,0,
20/02/2014,VER.,"MARTINEZ DE LA TORRE, VER.",1,0,1,0,0,0,
20/02/2014,NAY.,"TEPIC, NAY.",1,0,1,1,0,0,
20/02/2014,TAB.,"HUIMANGUILLO, TAB.",1,0,1,0,0,0,
20/02/2014,CAMP.,"CAMP., CAMP.",1,0,1,0,0,0,
20/02/2014,ZAC.,"TLALTENANGO DE SANCHEZ ROMAN, ZAC.",0,0,0,0,0,109,
21/02/2014,D.F.,"CUAUHTEMOC, D.F.",13,4,17,0,1,180,
21/02/2014,COAH.,"SALTILLO, COAH.",3,1,4,0,0,98,
21/02/2014,VER.,"MARTINEZ DE LA TORRE, VER.",1,1,2,0,0,0,
21/02/2014,MICH.,"LAZARO CARDENAS, MICH.",1,1,2,2,0,0,
21/02/2014,CAMP.,"CALAKMUL, CAMP.",1,0,1,0,0,0,
21/02/2014,ZAC.,"JEREZ, ZAC.",0,1,1,0,0,0,
21/02/2014,COAH.,"TORREÓN, COAH.",0,1,1,0,0,130,
21/02/2014,NAY.,"TEPIC, NAY.",1,0,1,0,0,0,
21/02/2014,PUE.,"PUE., PUE.",1,0,1,0,0,0,
21/02/2014,ZAC.,"TLALTENANGO DE SANCHEZ ROMAN, ZAC.",0,0,0,0,0,85,
21/02/2014,VER.,"TUXPAM, VER.",0,0,0,0,0,493,
21/02/2014,Q. ROO,"COZUMEL, Q. ROO",0,0,0,0,0,619,
21/02/2014,Q. ROO,"COZUMEL, Q. ROO",0,0,0,0,0,619,
22/02/2014,COAH.,"PIEDRAS NEGRAS, COAH.",1,1,2,0,0,0,
24/02/2014,D.F.,"MIGUEL HGO., D.F.",6,1,7,1,0,250,
24/02/2014,VER.,"MARTINEZ DE LA TORRE, VER.",1,1,2,0,0,0,
24/02/2014,S.L.P.,"CIUDAD VALLES, S.L.P.",2,0,2,1,0,22,
24/02/2014,MICH.,"LAZARO CARDENAS, MICH.",1,0,1,0,1,0,
24/02/2014,CAMP.,"CALAKMUL, CAMP.",0,1,1,0,0,0,
24/02/2014,TAMPS.,"XICOTENCATL, TAMPS.",1,0,1,1,0,0,
25/02/2014,CHIH.,"CHIH., CHIH.",29,16,45,5,0,0,
25/02/2014,D.F.,"MIGUEL HGO., D.F.",5,3,8,0,0,263,
25/02/2014,PUE.,"PUE., PUE.",3,2,5,3,0,28,
25/02/2014,MICH.,"LAZARO CARDENAS, MICH.",2,0,2,2,0,2,
25/02/2014,S.L.P.,"CIUDAD VALLES, S.L.P.",1,0,1,3,0,39,
25/02/2014,VER.,"XALAPA, VER.",1,0,1,0,0,0,
25/02/2014,VER.,"MARTINEZ DE LA TORRE, VER.",0,1,1,0,0,0,
25/02/2014,HGO.,"METEPEC, HGO.",1,0,1,0,0,0,
25/02/2014,ZAC.,"JEREZ, ZAC.",0,0,0,0,0,11,
26/02/2014,D.F.,"MIGUEL HGO., D.F.",23,3,26,2,0,400,
26/02/2014,CHIH.,"JUÁREZ, CHIH.",9,12,21,7,1,18,
26/02/2014,S.L.P.,"CIUDAD VALLES, S.L.P.",5,0,5,4,0,84,
26/02/2014,PUE.,"PUE., PUE.",2,0,2,2,0,24,
26/02/2014,S.L.P.,"TANQUIAN DE ESCOBEDO, S.L.P.",2,0,2,2,0,0,
26/02/2014,VER.,"XALAPA, VER.",1,0,1,0,1,0,
26/02/2014,VER.,"MARTINEZ DE LA TORRE, VER.",0,1,1,0,0,0,
26/02/2014,S.L.P.,"CIUDAD DEL MAIZ, S.L.P.",1,0,1,0,0,0,
26/02/2014,ZAC.,"JEREZ, ZAC.",0,0,0,0,2,0,
26/02/2014,COAH.,"SALTILLO, COAH.",0,0,0,0,0,382,
27/02/2014,D.F.,"MIGUEL HGO., D.F.",16,2,18,2,0,330,
27/02/2014,CHIH.,"JUÁREZ, CHIH.",8,5,13,0,1,49,
27/02/2014,COAH.,"PIEDRAS NEGRAS, COAH.",3,1,4,0,0,0,
27/02/2014,HGO.,"SAN BARTOLO TUTOTEPEC, HGO.",2,0,2,0,0,0,
27/02/2014,CAMP.,"CAMP., CAMP.",1,0,1,0,0,0,
27/02/2014,S.L.P.,"CIUDAD VALLES, S.L.P.",0,1,1,0,0,0,
27/02/2014,VER.,"MARTINEZ DE LA TORRE, VER.",0,1,1,0,0,0,
27/02/2014,MICH.,"LAZARO CARDENAS, MICH.",1,0,1,0,0,0,
27/02/2014,COAH.,"SALTILLO, COAH.",1,0,1,0,0,382,
27/02/2014,COAH.,"FRONTERA, COAH.",1,0,1,0,0,0,
27/02/2014,TAMPS.,"TAMPICO, TAMPS.",1,0,1,0,0,0,
27/02/2014,PUE.,"PUE., PUE.",0,0,0,0,1,73,
28/02/2014,D.F.,"MIGUEL HGO., D.F.",27,8,35,2,0,350,
28/02/2014,CHIH.,"JUÁREZ, CHIH.",6,15,21,0,0,213,
28/02/2014,COAH.,"SALTILLO, COAH.",2,2,4,0,0,19,
28/02/2014,HGO.,"SAN BARTOLO TUTOTEPEC, HGO.",2,1,3,0,0,0,
28/02/2014,COAH.,"PIEDRAS NEGRAS, COAH.",0,3,3,0,0,124,
28/02/2014,CHIH.,"HGO. DEL PARRAL, CHIH.",1,0,1,0,0,0,
28/02/2014,S.L.P.,"CIUDAD VALLES, S.L.P.",0,1,1,0,1,0,
28/02/2014,COAH.,"FRONTERA, COAH.",1,0,1,0,0,246,
28/02/2014,CAMP.,"CAMP., CAMP.",1,0,1,0,0,0,
28/02/2014,VER.,"ALAMO, VER.",1,0,1,1,0,27,
28/02/2014,VER.,"MARTINEZ DE LA TORRE, VER.",1,0,1,0,0,0,
28/02/2014,VER.,"MARTINEZ DE LA TORRE, VER.",1,0,1,0,0,0,
28/02/2014,ZAC.,"TLALTENANGO DE SANCHEZ ROMAN, ZAC.",0,0,0,0,0,136,
01/03/2014,VER.,"COATZACOALCOS, VER.",1,0,1,0,0,0,
03/03/2014,D.F.,"MIGUEL HGO., D.F.",14,3,17,2,0,125,
03/03/2014,VER.,"XALAPA, VER.",3,1,4,0,0,0,
03/03/2014,CHIS.,"OCOSINGO, CHIS.",1,1,2,0,0,0,
03/03/2014,VER.,"PAPANTLA, VER.",2,0,2,0,0,0,
03/03/2014,S.L.P.,"CIUDAD VALLES, S.L.P.",0,1,1,0,0,31,
03/03/2014,MICH.,"LAZARO CARDENAS, MICH.",1,0,1,0,0,0,
03/03/2014,NAY.,"COMPOSTELA, NAY.",1,0,1,0,0,0,
03/03/2014,VER.,"POZA RICA DE HGO., VER.",1,0,1,0,0,0,
04/03/2014,D.F.,"MIGUEL HGO., D.F.",20,3,23,0,7,200,
04/03/2014,SON.,"CAJEME, SON.",3,0,3,0,0,4,
04/03/2014,TAMPS.,"EL MANTE, TAMPS.",2,1,3,1,0,100,
04/03/2014,VER.,"PAPANTLA, VER.",1,0,1,0,0,0,
04/03/2014,HGO.,"HUEJUTLA DE REYES, HGO.",1,0,1,0,0,0,
04/03/2014,VER.,"MARTINEZ DE LA TORRE, VER.",0,1,1,0,0,0,
04/03/2014,N.L.,"MONTERREY, N.L.",1,0,1,3,0,318,
04/03/2014,S.L.P.,"CIUDAD VALLES, S.L.P.",0,1,1,2,1,14,
04/03/2014,B.C.S.,"MULEGÉ, B.C.S.",1,0,1,0,0,0,
04/03/2014,N.L.,"SAN NICOLAS DE LOS GARZA, N.L.",0,0,0,0,0,900,
04/03/2014,TAMPS.,"EL MANTE, TAMPS.",0,0,0,0,0,0,
05/03/2014,D.F.,"MIGUEL HGO., D.F.",12,0,12,2,27,250,
05/03/2014,N.L.,"SAN NICOLAS DE LOS GARZA, N.L.",3,1,4,1,0,0,
05/03/2014,N.L.,"MONTERREY, N.L.",1,1,2,18,0,3633,
05/03/2014,VER.,"PAPANTLA, VER.",2,0,2,0,0,0,
05/03/2014,MICH.,"LAZARO CARDENAS, MICH.",1,1,2,0,0,2,
05/03/2014,SON.,"CAJEME, SON.",1,0,1,0,0,0,
05/03/2014,VER.,"POZA RICA DE HGO., VER.",1,0,1,0,0,0,
05/03/2014,VER.,"XALAPA, VER.",1,0,1,0,0,0,
06/03/2014,D.F.,"MIGUEL HGO., D.F.",18,0,18,1,15,250,
06/03/2014,N.L.,"SAN NICOLAS DE LOS GARZA, N.L.",8,1,9,6,0,535,
06/03/2014,N.L.,"MONTERREY, N.L.",5,3,8,49,0,2550,
06/03/2014,MICH.,"LAZARO CARDENAS, MICH.",4,0,4,1,0,0,
06/03/2014,SON.,"CAJEME, SON.",1,0,1,3,0,0,
06/03/2014,VER.,"ZONGOLICA, VER.",1,0,1,0,0,0,
06/03/2014,VER.,"POZA RICA DE HGO., VER.",1,0,1,0,0,0,
06/03/2014,S.L.P.,"CIUDAD VALLES, S.L.P.",0,0,0,0,1,0,
07/03/2014,D.F.,"MIGUEL HGO., D.F.",20,2,22,4,11,125,
07/03/2014,TAMPS.,"MATAMOROS, TAMPS.",3,2,5,1,0,61,
07/03/2014,SON.,"HERMOSILLO, SON.",0,2,2,0,0,0,
07/03/2014,SON.,"CAJEME, SON.",2,0,2,1,0,0,
07/03/2014,ZAC.,"VALPARAISO, ZAC.",2,0,2,0,0,0,
07/03/2014,VER.,"POZA RICA DE HGO., VER.",2,0,2,0,0,0,
07/03/2014,VER.,"PAPANTLA, VER.",2,0,2,0,0,0,
07/03/2014,TAMPS.,"EL MANTE, TAMPS.",1,0,1,1,0,8,
07/03/2014,HGO.,"HUEJUTLA DE REYES, HGO.",1,0,1,0,0,0,
07/03/2014,ZAC.,"ZAC., ZAC.",1,0,1,1,0,0,
07/03/2014,VER.,"TUXPAM, VER.",1,0,1,0,0,226,
07/03/2014,VER.,"ALAMO, VER.",1,0,1,2,0,19,
07/03/2014,Q. ROO,"ISLA MUJERES, Q. ROO",0,0,0,0,0,20,
08/03/2014,N.L.,"MONTERREY, N.L.",3,7,10,23,0,8149,
08/03/2014,N.L.,"SAN NICOLAS DE LOS GARZA, N.L.",1,3,4,2,0,234,
08/03/2014,VER.,"TUXPAM, VER.",1,0,1,0,0,226,
08/03/2014,VER.,"ALAMO, VER.",1,0,1,2,0,19,
08/03/2014,PUE.,"TEHUACAN, PUE.",1,0,1,0,0,17,
09/03/2014,VER.,"ZONGOLICA, VER.",2,2,4,0,0,0,
09/03/2014,N.L.,"SAN NICOLAS DE LOS GARZA, N.L.",0,0,0,1,0,0,
09/03/2014,N.L.,"MONTERREY, N.L.",0,0,0,2,0,6370,
10/03/2014,D.F.,"IZTACALCO, D.F.",11,5,16,1,5,20,
10/03/2014,N.L.,"MONTERREY, N.L.",3,11,14,11,0,7203,
10/03/2014,VER.,"ZONGOLICA, VER.",2,3,5,0,0,0,
10/03/2014,VER.,"VER., VER.",3,1,4,0,2,9,
10/03/2014,ZAC.,"VALPARAISO, ZAC.",4,0,4,5,0,0,
10/03/2014,VER.,"PAPANTLA, VER.",2,0,2,0,0,0,
10/03/2014,VER.,"POZA RICA DE HGO., VER.",1,0,1,0,0,0,
10/03/2014,VER.,"SAN RAFAEL, VER.",1,0,1,0,0,0,
10/03/2014,ZAC.,"JEREZ, ZAC.",1,0,1,0,0,0,
10/03/2014,N.L.,"SAN NICOLAS DE LOS GARZA, N.L.",0,1,1,3,0,50,
10/03/2014,ZAC.,"ZAC., ZAC.",0,0,0,0,0,416,
11/03/2014,N.L.,"MONTERREY, N.L.",12,2,14,80,0,7187,
11/03/2014,VER.,"VER., VER.",9,3,12,0,1,11,
11/03/2014,D.F.,"IZTACALCO, D.F.",5,1,6,2,15,250,
11/03/2014,CAMP.,"CARMEN, CAMP.",0,2,2,0,0,0,
11/03/2014,VER.,"PAPANTLA, VER.",2,0,2,0,0,0,
11/03/2014,VER.,"SAN RAFAEL, VER.",1,1,2,0,0,0,
11/03/2014,B.C.,"TECATE, B.C.",0,1,1,0,0,0,
11/03/2014,N.L.,"SAN NICOLAS DE LOS GARZA, N.L.",1,0,1,0,0,37,
11/03/2014,TAB.,"CUNDUACAN, TAB.",0,0,0,0,0,44,
11/03/2014,ZAC.,"ZAC., ZAC.",0,0,0,0,0,250,
12/03/2014,D.F.,"IZTACALCO, D.F.",14,6,20,2,3,170,
12/03/2014,B.C.,"MEXICALI, B.C.",3,4,7,0,0,0,
12/03/2014,VER.,"VER., VER.",5,1,6,0,3,15,
12/03/2014,N.L.,"MONTERREY, N.L.",4,1,5,15,0,1940,
12/03/2014,VER.,"ALAMO, VER.",1,1,2,0,0,0,
12/03/2014,SON.,"CAJEME, SON.",1,1,2,1,0,22,
12/03/2014,N.L.,"SAN NICOLAS DE LOS GARZA, N.L.",2,0,2,1,0,100,
12/03/2014,VER.,"POZA RICA DE HGO., VER.",1,0,1,0,0,0,
12/03/2014,VER.,"COATZINTLA, VER.",1,0,1,0,0,0,
12/03/2014,PUE.,"TEPEXI DE RODRIGUEZ, PUE.",1,0,1,1,0,0,
12/03/2014,SON.,"HERMOSILLO, SON.",1,0,1,1,0,5,
12/03/2014,B.C.,"ENSENADA, B.C.",1,0,1,0,0,0,
12/03/2014,TAMPS.,"TAMPICO, TAMPS.",1,0,1,1,0,35,
12/03/2014,VER.,"SAN RAFAEL, VER.",0,1,1,0,0,0,
12/03/2014,ZAC.,"TLALTENANGO DE SANCHEZ ROMAN, ZAC.",0,0,0,0,0,241,
12/03/2014,CHIH.,"HGO. DEL PARRAL, CHIH.",0,0,0,1,0,0,
13/03/2014,D.F.,"IZTACALCO, D.F.",27,6,33,0,2,120,
13/03/2014,VER.,"VER., VER.",4,0,4,0,0,200,
13/03/2014,VER.,"SAN RAFAEL, VER.",2,1,3,0,0,0,
13/03/2014,COAH.,"ACUÑA, COAH.",0,3,3,0,0,0,
13/03/2014,MICH.,"LAZARO CARDENAS, MICH.",3,0,3,2,0,0,
13/03/2014,B.C.,"TECATE, B.C.",1,1,2,0,0,0,
13/03/2014,VER.,"POZA RICA DE HGO., VER.",1,0,1,0,0,0,
13/03/2014,ZAC.,"TLALTENANGO DE SANCHEZ ROMAN, ZAC.",1,0,1,0,0,53,
13/03/2014,VER.,"POZA RICA DE HGO., VER.",0,0,0,0,0,54,
13/03/2014,ZAC.,"ZAC., ZAC.",0,0,0,0,0,200,
13/03/2014,PUE.,"TEPEXI DE RODRIGUEZ, PUE.",0,0,0,0,3,0,
14/03/2014,D.F.,"IZTACALCO, D.F.",22,4,26,3,2,380,
14/03/2014,B.C.,"MEXICALI, B.C.",8,6,14,0,0,0,
14/03/2014,VER.,"VER., VER.",5,2,7,3,1,92,
14/03/2014,B.C.,"TIJUANA, B.C.",5,2,7,0,0,0,
14/03/2014,N.L.,"MONTERREY, N.L.",5,2,7,17,0,1470,
14/03/2014,TAMPS.,"MATAMOROS, TAMPS.",1,3,4,0,0,300,
14/03/2014,VER.,"SAN RAFAEL, VER.",3,1,4,0,0,0,
14/03/2014,CHIH.,"SAUCILLO, CHIH.",3,0,3,0,0,0,
14/03/2014,SON.,"CAJEME, SON.",2,1,3,1,0,0,
14/03/2014,ZAC.,"JEREZ, ZAC.",1,0,1,0,0,0,
14/03/2014,VER.,"XALAPA, VER.",0,1,1,0,1,113,
14/03/2014,N.L.,"SAN NICOLAS DE LOS GARZA, N.L.",1,0,1,0,0,200,
14/03/2014,MICH.,"LAZARO CARDENAS, MICH.",1,0,1,0,0,0,
14/03/2014,COAH.,"ACUÑA, COAH.",0,1,1,0,0,0,
14/03/2014,ZAC.,"TLALTENANGO DE SANCHEZ ROMAN, ZAC.",0,0,0,0,0,101,
15/03/2014,N.L.,"MONTERREY, N.L.",4,1,5,74,0,650,
15/03/2014,TAMPS.,"MATAMOROS, TAMPS.",1,2,3,0,0,0,
15/03/2014,B.C.,"TIJUANA, B.C.",1,2,3,0,0,0,
15/03/2014,VER.,"VER., VER.",2,0,2,1,0,8,
15/03/2014,B.C.,"MEXICALI, B.C.",2,0,2,0,0,0,
15/03/2014,SON.,"HERMOSILLO, SON.",1,0,1,1,0,0,
15/03/2014,MICH.,"LAZARO CARDENAS, MICH.",0,1,1,0,0,0,
15/03/2014,TAMPS.,"EL MANTE, TAMPS.",0,0,0,1,0,30,
16/03/2014,N.L.,"MONTERREY, N.L.",2,0,2,3,0,25,
16/03/2014,VER.,"VER., VER.",2,0,2,0,0,57,
16/03/2014,B.C.,"TIJUANA, B.C.",0,1,1,0,0,0,
17/03/2014,TAB.,"CENTLA, TAB.",2,0,2,0,1,0,
17/03/2014,TAB.,"TENOSIQUE, TAB.",2,0,2,0,0,0,
17/03/2014,N.L.,"MONTERREY, N.L.",1,0,1,5,0,0,
17/03/2014,CHIH.,"HGO. DEL PARRAL, CHIH.",1,0,1,0,0,0,
18/03/2014,B.C.,"MEXICALI, B.C.",7,2,9,0,0,0,
18/03/2014,D.F.,"IZTAPALAPA, D.F.",8,0,8,1,0,10,
18/03/2014,N.L.,"MONTERREY, N.L.",6,1,7,30,0,135,
18/03/2014,VER.,"IGNACIO DE LA LLAVE, VER.",0,5,5,0,0,0,
18/03/2014,B.C.,"TIJUANA, B.C.",4,1,5,0,0,0,
18/03/2014,VER.,"VER., VER.",2,0,2,1,0,10,
18/03/2014,B.C.,"ENSENADA, B.C.",1,1,2,0,0,0,
18/03/2014,HGO.,"ACAXOCHITLAN, HGO.",1,0,1,0,0,0,
18/03/2014,N.L.,"SAN NICOLAS DE LOS GARZA, N.L.",0,1,1,0,0,0,
18/03/2014,CHIH.,"HGO. DEL PARRAL, CHIH.",1,0,1,1,0,0,
18/03/2014,SON.,"HERMOSILLO, SON.",0,1,1,0,0,0,
18/03/2014,TAB.,"CENTLA, TAB.",0,0,0,0,0,31,
18/03/2014,ZAC.,"TLALTENANGO DE SANCHEZ ROMAN, ZAC.",0,0,0,0,0,253,
19/03/2014,D.F.,"IZTACALCO, D.F.",14,6,20,0,3,4,
19/03/2014,VER.,"IGNACIO DE LA LLAVE, VER.",2,3,5,0,0,0,
19/03/2014,N.L.,"MONTERREY, N.L.",3,1,4,49,0,940,
19/03/2014,N.L.,"SAN NICOLAS DE LOS GARZA, N.L.",2,1,3,0,0,112,
19/03/2014,VER.,"VER., VER.",2,0,2,2,0,54,
19/03/2014,JAL.,"CASIMIRO CASTILLO, JAL.",0,1,1,0,0,0,
19/03/2014,ZAC.,"SOMBRERETE, ZAC.",1,0,1,0,0,0,
19/03/2014,CHIH.,"HGO. DEL PARRAL, CHIH.",0,1,1,0,0,0,
19/03/2014,MICH.,"LAZARO CARDENAS, MICH.",1,0,1,0,0,0,
20/03/2014,D.F.,"IZTACALCO, D.F.",14,9,23,2,0,12,
20/03/2014,N.L.,"MONTERREY, N.L.",6,3,9,0,0,100,
20/03/2014,TAMPS.,"MATAMOROS, TAMPS.",4,4,8,0,0,673,
20/03/2014,VER.,"SAN RAFAEL, VER.",1,6,7,0,0,0,
20/03/2014,B.C.,"MEXICALI, B.C.",3,2,5,0,0,0,
20/03/2014,ZAC.,"SOMBRERETE, ZAC.",4,1,5,3,0,0,
20/03/2014,N.L.,"SAN NICOLAS DE LOS GARZA, N.L.",0,5,5,2,0,66,
20/03/2014,VER.,"VER., VER.",2,2,4,5,0,0,
20/03/2014,SON.,"HERMOSILLO, SON.",3,0,3,1,0,0,
20/03/2014,ZAC.,"VALPARAISO, ZAC.",2,0,2,0,0,0,
20/03/2014,YUC.,"TIZIMIN, YUC.",0,1,1,0,0,0,
20/03/2014,JAL.,"GUADALAJARA, JAL.",1,0,1,0,0,0,
20/03/2014,CHIH.,"HGO. DEL PARRAL, CHIH.",0,1,1,0,0,0,
20/03/2014,VER.,"IGNACIO DE LA LLAVE, VER.",0,0,0,0,0,55,
21/03/2014,N.L.,"SAN NICOLAS DE LOS GARZA, N.L.",22,1,23,6,0,93,
21/03/2014,D.F.,"IZTAPALAPA, D.F.",14,1,15,3,2,53,
21/03/2014,VER.,"VER., VER.",3,1,4,0,0,243,
21/03/2014,QRO.,"QUERETARO, QRO.",4,0,4,0,0,0,
21/03/2014,CHIH.,"HGO. DEL PARRAL, CHIH.",2,1,3,1,0,0,
21/03/2014,JAL.,"GUADALAJARA, JAL.",2,1,3,1,0,0,
21/03/2014,VER.,"TUXPAM, VER.",0,1,1,0,0,0,
21/03/2014,TAB.,"CENTLA, TAB.",1,0,1,0,3,71,
21/03/2014,CHIH.,"JUÁREZ, CHIH.",1,0,1,0,1,0,
21/03/2014,COAH.,"ACUÑA, COAH.",0,1,1,0,0,0,
21/03/2014,N.L.,"MONTERREY, N.L.",0,0,0,14,1,677,
22/03/2014,QRO.,"QUERETARO, QRO.",13,6,19,0,6,0,
22/03/2014,TAMPS.,"MATAMOROS, TAMPS.",4,4,8,0,0,673,
22/03/2014,N.L.,"MONTERREY, N.L.",2,0,2,5,0,100,
22/03/2014,TAMPS.,"MATAMOROS, TAMPS.",1,1,2,0,0,0,
22/03/2014,QRO.,"AMEALCO DE BONFIL, QRO.",0,2,2,0,3,0,
22/03/2014,ZAC.,"SOMBRERETE, ZAC.",1,0,1,0,0,0,
22/03/2014,TAB.,"CENTLA, TAB.",0,0,0,0,0,26,
22/03/2014,N.L.,"SAN NICOLAS DE LOS GARZA, N.L.",0,0,0,4,0,71,
22/03/2014,N.L.,"SAN NICOLAS DE LOS GARZA, N.L.",0,0,0,4,0,71,
23/03/2014,QRO.,"AMEALCO DE BONFIL, QRO.",7,8,15,0,6,0,
23/03/2014,QRO.,"QUERETARO, QRO.",5,1,6,0,1,0,
23/03/2014,N.L.,"SAN NICOLAS DE LOS GARZA, N.L.",0,0,0,1,0,19,
23/03/2014,N.L.,"MONTERREY, N.L.",0,0,0,43,0,840,
24/03/2014,QRO.,"QUERETARO, QRO.",9,12,21,0,0,0,
24/03/2014,D.F.,"IZTAPALAPA, D.F.",12,4,16,0,0,0,
24/03/2014,MEX.,"TECAMAC, MEX.",10,3,13,0,0,0,
24/03/2014,MEX.,"CHICOLOAPAN, MEX.",8,4,12,0,0,0,
24/03/2014,N.L.,"MONTERREY, N.L.",4,2,6,12,0,220,
24/03/2014,ZAC.,"SOMBRERETE, ZAC.",4,0,4,1,0,0,
24/03/2014,MEX.,"ZUMPANGO, MEX.",2,2,4,0,0,0,
24/03/2014,N.L.,"SAN NICOLAS DE LOS GARZA, N.L.",2,1,3,12,0,1365,
24/03/2014,CHIH.,"BUENAVENTURA, CHIH.",1,1,2,0,0,0,
24/03/2014,CHIS.,"TUXTLA GUTIÉRREZ, CHIS.",0,1,1,0,0,0,
24/03/2014,ZAC.,"VALPARAISO, ZAC.",0,1,1,0,0,0,
24/03/2014,NAY.,"SAN PEDRO LAGUNILLAS, NAY.",1,0,1,0,0,12,
24/03/2014,MICH.,"LAZARO CARDENAS, MICH.",1,0,1,1,0,0,
24/03/2014,JAL.,"GUADALAJARA, JAL.",1,0,1,1,0,0,
24/03/2014,COAH.,"ACUÑA, COAH.",0,1,1,0,0,0,
24/03/2014,QRO.,"TEQUISQUIAPAN, QRO.",1,0,1,0,2,0,
24/03/2014,ZAC.,"JEREZ, ZAC.",0,0,0,0,0,8,
24/03/2014,VER.,"POZA RICA DE HGO., VER.",0,0,0,0,1,0,
25/03/2014,QRO.,"QUERETARO, QRO.",19,3,22,0,0,0,
25/03/2014,D.F.,"IZTAPALAPA, D.F.",12,7,19,0,0,128,
25/03/2014,MEX.,"TECAMAC, MEX.",9,3,12,0,10,0,
25/03/2014,MEX.,"ZUMPANGO, MEX.",8,0,8,0,0,0,
25/03/2014,ZAC.,"SOMBRERETE, ZAC.",6,1,7,2,0,0,
25/03/2014,MEX.,"CHICOLOAPAN, MEX.",2,1,3,0,0,0,
25/03/2014,CHIS.,"TUXTLA GUTIÉRREZ, CHIS.",1,1,2,5,4,460,
25/03/2014,VER.,"TANTOYUCA, VER.",1,1,2,0,0,0,
25/03/2014,CHIS.,"TUXTLA GUTIÉRREZ, CHIS.",1,1,2,5,4,460,
25/03/2014,QRO.,"TEQUISQUIAPAN, QRO.",1,0,1,0,0,0,
25/03/2014,PUE.,"PUE., PUE.",0,0,0,0,0,0,
25/03/2014,N.L.,"SAN NICOLAS DE LOS GARZA, N.L.",0,0,0,0,0,86,
25/03/2014,N.L.,"SANTA CATARINA, N.L.",0,0,0,0,0,50,
25/03/2014,SON.,"HERMOSILLO, SON.",0,0,0,0,0,136,
26/03/2014,D.F.,"IZTAPALAPA, D.F.",20,5,25,0,5,350,
26/03/2014,MEX.,"TECAMAC, MEX.",14,7,21,0,0,0,
26/03/2014,QRO.,"QUERETARO, QRO.",11,8,19,0,0,0,
26/03/2014,MEX.,"CHICOLOAPAN, MEX.",13,3,16,0,4,0,
26/03/2014,MEX.,"ZUMPANGO, MEX.",7,3,10,1,1,103,
26/03/2014,B.C.,"TIJUANA, B.C.",3,2,5,0,0,0,
26/03/2014,SON.,"HERMOSILLO, SON.",3,1,4,17,0,15,
26/03/2014,B.C.,"TECATE, B.C.",1,3,4,0,0,0,
26/03/2014,B.C.,"MEXICALI, B.C.",2,1,3,0,0,0,
26/03/2014,TAMPS.,"TAMPICO, TAMPS.",1,1,2,0,0,71,
26/03/2014,ZAC.,"SOMBRERETE, ZAC.",2,0,2,0,0,0,
26/03/2014,QRO.,"COLON, QRO.",1,1,2,0,4,0,
26/03/2014,N.L.,"SAN NICOLAS DE LOS GARZA, N.L.",1,1,2,2,0,250,
26/03/2014,N.L.,"MONTERREY, N.L.",2,0,2,1,0,750,
26/03/2014,CHIS.,"TUXTLA GUTIÉRREZ, CHIS.",0,1,1,3,0,703,
26/03/2014,AGS.,"AGS., AGS.",1,0,1,2,0,0,
26/03/2014,OAX.,"MATIAS ROMERO AVENDAÑO, OAX.",0,1,1,0,0,44,
26/03/2014,ZAC.,"VALPARAISO, ZAC.",1,0,1,0,0,0,
26/03/2014,MICH.,"LAZARO CARDENAS, MICH.",1,0,1,0,1,0,
26/03/2014,OAX.,"MATIAS ROMERO AVENDAÑO, OAX.",0,1,1,0,0,44,
26/03/2014,OAX.,"LOMA BONITA, OAX.",1,0,1,2,0,147,
26/03/2014,OAX.,"OAX. DE JUAREZ, OAX.",1,0,1,1,0,148,
27/03/2014,MEX.,"TECAMAC, MEX.",25,6,31,0,1,0,
27/03/2014,AGS.,"AGS., AGS.",28,1,29,7,0,208,
27/03/2014,MEX.,"CHICOLOAPAN, MEX.",14,6,20,0,2,0,
27/03/2014,D.F.,"IZTAPALAPA, D.F.",13,4,17,0,0,0,
27/03/2014,QRO.,"QUERETARO, QRO.",11,4,15,0,0,0,
27/03/2014,QRO.,"COLON, QRO.",9,1,10,0,0,0,
27/03/2014,MEX.,"ZUMPANGO, MEX.",7,1,8,0,0,49,
27/03/2014,COAH.,"SALTILLO, COAH.",2,4,6,0,0,0,
27/03/2014,SON.,"HERMOSILLO, SON.",4,0,4,0,0,27,
27/03/2014,YUC.,"PANABA, YUC.",1,1,2,0,0,0,
27/03/2014,ZAC.,"ZAC., ZAC.",1,1,2,14,0,1302,
27/03/2014,YUC.,"PANABA, YUC.",1,1,2,0,0,0,
27/03/2014,MICH.,"LAZARO CARDENAS, MICH.",2,0,2,1,0,0,
27/03/2014,OAX.,"OAX. DE JUAREZ, OAX.",2,0,2,2,0,0,
27/03/2014,OAX.,"MATIAS ROMERO AVENDAÑO, OAX.",0,1,1,0,0,0,
27/03/2014,SON.,"HERMOSILLO, SON.",0,1,1,0,0,0,
27/03/2014,OAX.,"OAX. DE JUAREZ, OAX.",1,0,1,0,0,0,
27/03/2014,TAMPS.,"TAMPICO, TAMPS.",0,0,0,0,0,60,
28/03/2014,D.F.,"IZTAPALAPA, D.F.",35,1,36,0,0,12,
28/03/2014,MEX.,"TECAMAC, MEX.",25,4,29,0,3,0,
28/03/2014,MEX.,"CHICOLOAPAN, MEX.",19,4,23,0,1,46,
28/03/2014,AGS.,"AGS., AGS.",13,3,16,7,0,100,
28/03/2014,QRO.,"QUERETARO, QRO.",9,7,16,0,0,0,
28/03/2014,B.C.,"TIJUANA, B.C.",5,4,9,0,0,0,
28/03/2014,B.C.,"TIJUANA, B.C.",6,1,7,0,0,0,
28/03/2014,QRO.,"EZEQUIEL MONTES, QRO.",4,3,7,0,2,0,
28/03/2014,MEX.,"ZUMPANGO, MEX.",6,1,7,0,2,124,
28/03/2014,CHIH.,"OJINAGA, CHIH.",3,2,5,0,0,0,
28/03/2014,CHIS.,"TUXTLA GUTIÉRREZ, CHIS.",3,2,5,5,0,1876,
28/03/2014,ZAC.,"SOMBRERETE, ZAC.",2,1,3,0,0,0,
28/03/2014,JAL.,"GUADALAJARA, JAL.",0,3,3,0,0,0,
28/03/2014,VER.,"TANTOYUCA, VER.",2,1,3,0,0,0,
28/03/2014,PUE.,"PUE., PUE.",3,0,3,0,0,0,
28/03/2014,B.C.,"MEXICALI, B.C.",0,2,2,0,0,0,
28/03/2014,N.L.,"MONTERREY, N.L.",2,0,2,69,0,978,
28/03/2014,CHIH.,"PRAXEDIS G. GRO., CHIH.",0,1,1,0,0,0,
28/03/2014,ZAC.,"JEREZ, ZAC.",1,0,1,0,0,0,
28/03/2014,NAY.,"SAN PEDRO LAGUNILLAS, NAY.",0,1,1,0,0,0,
28/03/2014,VER.,"PANUCO, VER.",0,1,1,0,0,0,
28/03/2014,OAX.,"OAX. DE JUAREZ, OAX.",1,0,1,0,0,1,
28/03/2014,COAH.,"SALTILLO, COAH.",0,1,1,0,0,0,
28/03/2014,N.L.,"SAN NICOLAS DE LOS GARZA, N.L.",0,0,0,0,0,50,
29/03/2014,MEX.,"TECAMAC, MEX.",22,7,29,0,0,0,
29/03/2014,MEX.,"CHICOLOAPAN, MEX.",16,9,25,0,1,111,
29/03/2014,QRO.,"SAN JUAN DEL RIO, QRO.",6,6,12,0,3,0,
29/03/2014,SON.,"HERMOSILLO, SON.",0,3,3,0,0,0,
29/03/2014,CHIS.,"TUXTLA GUTIÉRREZ, CHIS.",1,2,3,3,0,1491,
29/03/2014,MEX.,"ZUMPANGO, MEX.",2,1,3,0,0,0,
29/03/2014,TAMPS.,"MATAMOROS, TAMPS.",0,1,1,0,0,0,
29/03/2014,OAX.,"OAX. DE JUAREZ, OAX.",1,0,1,1,0,0,
29/03/2014,OAX.,"LOMA BONITA, OAX.",0,1,1,4,0,0,
29/03/2014,OAX.,"SANTIAGO JUXTLAHUACA, OAX.",1,0,1,1,0,0,
29/03/2014,CHIS.,"YAJALÓN, CHIS.",0,1,1,0,0,0,
29/03/2014,N.L.,"SAN NICOLAS DE LOS GARZA, N.L.",1,0,1,0,0,0,
29/03/2014,N.L.,"MONTERREY, N.L.",0,0,0,23,0,384,
30/03/2014,QRO.,"SAN JUAN DEL RIO, QRO.",8,9,17,0,1,0,
30/03/2014,B.C.,"MEXICALI, B.C.",7,0,7,0,0,0,
30/03/2014,OAX.,"OAX. DE JUAREZ, OAX.",4,1,5,1,0,1,
30/03/2014,OAX.,"HEROICA CIUDAD DE HUAJUAPAN DE LEON, OAX.",2,0,2,1,0,6,
30/03/2014,B.C.,"TIJUANA, B.C.",0,1,1,0,0,0,
30/03/2014,B.C.,"ENSENADA, B.C.",0,1,1,0,0,0,
30/03/2014,N.L.,"MONTERREY, N.L.",0,0,0,0,0,250,
31/03/2014,D.F.,"TLAHUAC, D.F.",17,3,20,0,0,160,
31/03/2014,MEX.,"NICOLAS ROMERO, MEX.",12,2,14,0,0,0,
31/03/2014,QRO.,"SAN JUAN DEL RIO, QRO.",2,11,13,0,0,0,
31/03/2014,MEX.,"TULTITLAN, MEX.",10,2,12,5,0,114,
31/03/2014,ZAC.,"SOMBRERETE, ZAC.",8,0,8,0,0,0,
31/03/2014,QRO.,"QUERETARO, QRO.",3,4,7,0,4,0,
31/03/2014,MEX.,"COACALCO DE BERRIOZABAL, MEX.",5,2,7,0,0,136,
31/03/2014,AGS.,"AGS., AGS.",6,0,6,10,0,137,
31/03/2014,MEX.,"ATIZAPAN DE ZARAGOZA, MEX.",5,1,6,1,0,74,
31/03/2014,B.C.,"TIJUANA, B.C.",2,3,5,0,0,0,
31/03/2014,HGO.,"MIXQUIAHUALA DE JUAREZ, HGO.",4,0,4,0,0,0,
31/03/2014,OAX.,"OAX. DE JUAREZ, OAX.",2,1,3,2,0,0,
31/03/2014,CHIS.,"OCOSINGO, CHIS.",1,1,2,0,0,0,
31/03/2014,JAL.,"TLAQUEPAQUE, JAL.",1,1,2,0,0,0,
31/03/2014,TAMPS.,"REYNOSA, TAMPS.",1,1,2,0,0,0,
31/03/2014,N.L.,"MONTERREY, N.L.",2,0,2,8,0,230,
31/03/2014,OAX.,"OCOTLAN DE MOR., OAX.",1,0,1,0,0,0,
31/03/2014,SON.,"HERMOSILLO, SON.",0,1,1,0,0,0,
31/03/2014,OAX.,"CIUDAD IXTEPEC, OAX.",1,0,1,0,0,0,
31/03/2014,OAX.,"OCOTLAN DE MOR., OAX.",1,0,1,0,0,0,
31/03/2014,VER.,"VER., VER.",1,0,1,0,0,0,
31/03/2014,VER.,"PANUCO, VER.",0,0,0,0,0,161,
31/03/2014,OAX.,"OAX. DE JUAREZ, OAX.",0,0,0,0,2,0,
01/04/2014,MEX.,"ATIZAPAN, MEX.",33,5,38,0,3,560,
01/04/2014,D.F.,"TLAHUAC, D.F.",22,4,26,1,2,8,
01/04/2014,MEX.,"TULTITLAN, MEX.",7,3,10,0,0,254,
01/04/2014,QRO.,"PEDRO ESCOBEDO, QRO.",6,2,8,0,0,0,
01/04/2014,AGS.,"AGS., AGS.",4,3,7,3,0,46,
01/04/2014,MEX.,"NICOLAS ROMERO, MEX.",6,1,7,0,1,60,
01/04/2014,JAL.,"TLAQUEPAQUE, JAL.",5,0,5,0,0,0,
01/04/2014,B.C.,"MEXICALI, B.C.",4,1,5,0,0,0,
01/04/2014,MEX.,"COACALCO DE BERRIOZABAL, MEX.",4,1,5,0,0,0,
01/04/2014,OAX.,"OAX. DE JUAREZ, OAX.",2,0,2,0,0,0,
01/04/2014,N.L.,"GUADALUPE, N.L.",2,0,2,0,0,0,
01/04/2014,QRO.,"PEÑAMILLER, QRO.",1,1,2,0,0,0,
01/04/2014,B.C.,"ENSENADA, B.C.",1,1,2,0,0,0,
01/04/2014,HGO.,"MIXQUIAHUALA DE JUAREZ, HGO.",1,0,1,0,0,0,
01/04/2014,OAX.,"OCOTLAN DE MOR., OAX.",1,0,1,0,0,0,
01/04/2014,OAX.,"HEROICA CIUDAD DE HUAJUAPAN DE LEON, OAX.",0,1,1,0,0,0,
01/04/2014,CHIS.,"TUXTLA GUTIÉRREZ, CHIS.",0,1,1,2,1,531,
01/04/2014,B.C.,"ENSENADA, B.C.",0,1,1,0,0,0,
01/04/2014,N.L.,"SANTA CATARINA, N.L.",0,0,0,0,0,53,
02/04/2014,MEX.,"ATIZAPAN, MEX.",23,5,28,0,3,412,
02/04/2014,D.F.,"TLAHUAC, D.F.",24,3,27,0,13,158,
02/04/2014,MEX.,"COACALCO DE BERRIOZABAL, MEX.",10,4,14,0,0,0,
02/04/2014,MEX.,"TULTITLAN, MEX.",8,1,9,1,1,25,
02/04/2014,N.L.,"SANTA CATARINA, N.L.",2,4,6,2,0,219,
02/04/2014,JAL.,"TLAQUEPAQUE, JAL.",4,1,5,0,0,0,
02/04/2014,MEX.,"NICOLAS ROMERO, MEX.",4,1,5,0,1,0,
02/04/2014,N.L.,"GUADALUPE, N.L.",2,3,5,0,0,400,
02/04/2014,PUE.,"IZUCAR DE MATAMOROS, PUE.",1,4,5,0,0,0,
02/04/2014,HGO.,"MIXQUIAHUALA DE JUAREZ, HGO.",4,0,4,0,0,0,
02/04/2014,B.C.,"MEXICALI, B.C.",0,3,3,0,0,0,
02/04/2014,QRO.,"HUIMILPAN, QRO.",2,1,3,0,0,0,
02/04/2014,QRO.,"SAN JOAQUIN, QRO.",1,2,3,0,3,0,
02/04/2014,B.C.,"ENSENADA, B.C.",0,2,2,0,0,0,
02/04/2014,CHIS.,"TUXTLA GUTIÉRREZ, CHIS.",1,0,1,1,0,383,
02/04/2014,OAX.,"OAX. DE JUAREZ, OAX.",0,1,1,0,0,0,
02/04/2014,OAX.,"CIUDAD IXTEPEC, OAX.",1,0,1,0,0,0,
02/04/2014,ZAC.,"VALPARAISO, ZAC.",1,0,1,1,0,0,
03/04/2014,MEX.,"ATIZAPAN DE ZARAGOZA, MEX.",22,9,31,7,0,709,
03/04/2014,D.F.,"TLAHUAC, D.F.",22,5,27,0,2,55,
03/04/2014,QRO.,"QUERETARO, QRO.",16,9,25,0,3,0,
03/04/2014,MEX.,"TULTITLAN, MEX.",9,3,12,1,1,58,
03/04/2014,MEX.,"COACALCO DE BERRIOZABAL, MEX.",8,0,8,0,0,31,
03/04/2014,B.C.,"MEXICALI, B.C.",6,1,7,0,0,0,
03/04/2014,AGS.,"AGS., AGS.",5,1,6,5,0,104,
03/04/2014,MEX.,"NICOLAS ROMERO, MEX.",6,0,6,0,1,120,
03/04/2014,OAX.,"LOMA BONITA, OAX.",4,1,5,2,0,3,
03/04/2014,N.L.,"GUADALUPE, N.L.",1,2,3,0,1,1050,
03/04/2014,HGO.,"MIXQUIAHUALA DE JUAREZ, HGO.",2,1,3,0,3,0,
03/04/2014,OAX.,"OAX. DE JUAREZ, OAX.",3,0,3,1,0,56,
03/04/2014,N.L.,"SANTA CATARINA, N.L.",1,0,1,3,0,113,
03/04/2014,PUE.,"IZUCAR DE MATAMOROS, PUE.",0,1,1,0,0,0,
03/04/2014,CHIS.,"TUZANTÁN, CHIS.",0,1,1,0,0,0,
03/04/2014,OAX.,"OCOTLAN DE MOR., OAX.",1,0,1,0,0,0,
03/04/2014,CHIS.,"TUXTLA GUTIÉRREZ, CHIS.",0,0,0,0,0,97,
04/04/2014,D.F.,"TLAHUAC, D.F.",27,3,30,0,1,65,
04/04/2014,MEX.,"ATIZAPAN, MEX.",22,6,28,12,0,185,
04/04/2014,DGO.,"DGO., DGO.",23,3,26,0,0,0,
04/04/2014,QRO.,"QUERETARO, QRO.",14,10,24,0,1,0,
04/04/2014,MEX.,"TULTITLAN, MEX.",11,6,17,0,1,193,
04/04/2014,B.C.,"MEXICALI, B.C.",4,2,6,0,0,0,
04/04/2014,MEX.,"NICOLAS ROMERO, MEX.",5,0,5,6,0,7,
04/04/2014,HGO.,"MIXQUIAHUALA DE JUAREZ, HGO.",5,0,5,0,0,0,
04/04/2014,N.L.,"GUADALUPE, N.L.",4,1,5,7,3,350,
04/04/2014,MEX.,"COACALCO DE BERRIOZABAL, MEX.",4,1,5,0,2,21,
04/04/2014,AGS.,"AGS., AGS.",4,0,4,3,0,240,
04/04/2014,QRO.,"QUERETARO, QRO.",0,4,4,0,3,0,
04/04/2014,OAX.,"SAN JUAN BAUTISTA TUXTEPEC, OAX.",3,0,3,4,0,171,
04/04/2014,CHIH.,"DELICIAS, CHIH.",1,2,3,0,0,0,
04/04/2014,OAX.,"TEZOATLAN DE SEGURA Y LUNA, OAX.",2,0,2,0,0,0,
04/04/2014,JAL.,"TLAQUEPAQUE, JAL.",2,0,2,0,0,0,
04/04/2014,VER.,"TANTOYUCA, VER.",0,2,2,0,0,0,
04/04/2014,VER.,"PANUCO, VER.",1,1,2,0,0,9,
04/04/2014,OAX.,"OAX. DE JUAREZ, OAX.",1,0,1,1,0,8,
04/04/2014,OAX.,"CIUDAD IXTEPEC, OAX.",0,1,1,2,0,0,
04/04/2014,B.C.,"TIJUANA, B.C.",0,1,1,0,0,0,
04/04/2014,N.L.,"SANTA CATARINA, N.L.",0,1,1,40,0,0,
04/04/2014,CHIS.,"TUZANTÁN, CHIS.",1,0,1,0,0,0,
04/04/2014,ZAC.,"MONTE ESCOBEDO, ZAC.",1,0,1,1,0,0,
04/04/2014,NAY.,"SAN PEDRO LAGUNILLAS, NAY.",1,0,1,0,0,0,
04/04/2014,SON.,"HERMOSILLO, SON.",0,1,1,0,0,0,
04/04/2014,CHIS.,"TUXTLA GUTIÉRREZ, CHIS.",0,1,1,0,0,124,
05/04/2014,MEX.,"NICOLAS ROMERO, MEX.",14,4,18,8,0,723,
05/04/2014,MEX.,"COACALCO DE BERRIOZABAL, MEX.",12,3,15,0,4,0,
05/04/2014,MEX.,"TULTITLAN, MEX.",13,2,15,4,0,229,
05/04/2014,JAL.,"TOMATLAN, JAL.",7,8,15,0,0,0,
05/04/2014,MEX.,"NICOLAS ROMERO, MEX.",7,5,12,5,0,111,
05/04/2014,TAMPS.,"MATAMOROS, TAMPS.",2,4,6,0,0,0,
05/04/2014,B.C.,"MEXICALI, B.C.",2,3,5,0,0,0,
05/04/2014,B.C.,"TIJUANA, B.C.",2,2,4,0,0,0,
05/04/2014,CHIH.,"DELICIAS, CHIH.",3,0,3,0,0,0,
05/04/2014,CHIS.,"TUXTLA GUTIÉRREZ, CHIS.",0,2,2,1,0,321,
05/04/2014,CHIS.,"YAJALÓN, CHIS.",1,1,2,0,0,0,
05/04/2014,B.C.,"TECATE, B.C.",0,1,1,0,0,0,
05/04/2014,PUE.,"IZUCAR DE MATAMOROS, PUE.",1,0,1,0,0,0,
05/04/2014,N.L.,"GUADALUPE, N.L.",0,1,1,0,0,500,
05/04/2014,N.L.,"SANTA CATARINA, N.L.",1,0,1,0,0,0,
05/04/2014,DGO.,"DGO., DGO.",1,0,1,0,0,0,
05/04/2014,OAX.,"OAX. DE JUAREZ, OAX.",0,0,0,0,1,0,
06/04/2014,N.L.,"SANTA CATARINA, N.L.",0,2,2,48,0,1500,
06/04/2014,N.L.,"GUADALUPE, N.L.",1,0,1,0,0,400,
06/04/2014,TAMPS.,"GONZALEZ, TAMPS.",1,0,1,0,0,0,
06/04/2014,CHIS.,"TONALÁ, CHIS.",1,0,1,0,0,0,
06/04/2014,CHIS.,"TUZANTÁN, CHIS.",0,0,0,0,0,210,
07/04/2014,DGO.,"DGO., DGO.",55,12,67,17,9,0,
07/04/2014,MEX.,"TLALNEPANTLA DE BAZ, MEX.",14,3,17,2,0,558,
07/04/2014,MEX.,"NAUCALPAN DE JUAREZ, MEX.",9,2,11,3,0,150,
07/04/2014,MEX.,"CUAUTITLAN IZCALLI, MEX.",6,1,7,0,1,0,
07/04/2014,D.F.,"MILPA ALTA, D.F.",3,3,6,0,0,130,
07/04/2014,MEX.,"CUAUTITLAN, MEX.",3,1,4,0,0,0,
07/04/2014,JAL.,"TLAQUEPAQUE, JAL.",1,2,3,0,0,0,
07/04/2014,AGS.,"AGS., AGS.",3,0,3,4,0,280,
07/04/2014,B.C.,"TIJUANA, B.C.",2,1,3,0,0,0,
07/04/2014,OAX.,"OAX. DE JUAREZ, OAX.",2,0,2,1,1,14,
07/04/2014,HGO.,"CHILCUAUTLA, HGO.",1,0,1,0,0,0,
07/04/2014,OAX.,"NEJAPA DE MADERO, OAX.",0,1,1,0,0,0,
07/04/2014,OAX.,"OAX. DE JUAREZ, OAX.",1,0,1,0,0,0,
07/04/2014,ZAC.,"ZAC., ZAC.",1,0,1,0,0,60,
07/04/2014,N.L.,"GUADALUPE, N.L.",1,0,1,4,0,200,
07/04/2014,N.L.,"SANTA CATARINA, N.L.",1,0,1,5,0,150,
07/04/2014,B.C.,"ENSENADA, B.C.",0,1,1,0,0,0,
07/04/2014,OAX.,"SANTA MARIA PETAPA, OAX.",0,0,0,4,1,0,
07/04/2014,ZAC.,"MONTE ESCOBEDO, ZAC.",0,0,0,0,0,76,
08/04/2014,DGO.,"DGO., DGO.",48,15,63,28,8,0,
08/04/2014,D.F.,"MILPA ALTA, D.F.",15,7,22,0,0,150,
08/04/2014,GTO.,"ACAMBARO, GTO.",14,4,18,0,0,0,
08/04/2014,MEX.,"TLALNEPANTLA DE BAZ, MEX.",12,2,14,2,0,558,
08/04/2014,MEX.,"NAUCALPAN DE JUAREZ, MEX.",12,1,13,13,6,488,
08/04/2014,B.C.,"ENSENADA, B.C.",4,3,7,0,0,0,
08/04/2014,JAL.,"TLAQUEPAQUE, JAL.",7,0,7,0,1,0,
08/04/2014,GTO.,"ACAMBARO, GTO.",0,6,6,0,0,0,
08/04/2014,OAX.,"OAX. DE JUAREZ, OAX.",3,0,3,4,0,98,
08/04/2014,AGS.,"AGS., AGS.",2,1,3,1,0,11,
08/04/2014,MEX.,"CUAUTITLAN IZCALLI, MEX.",2,1,3,0,0,0,
08/04/2014,CHIH.,"DELICIAS, CHIH.",3,0,3,0,0,0,
08/04/2014,B.C.,"MEXICALI, B.C.",0,2,2,0,0,0,
08/04/2014,OAX.,"SAN FRANCISCO SOLA, OAX.",1,0,1,0,0,0,
08/04/2014,OAX.,"SANTA MARIA DEL TULE, OAX.",1,0,1,0,0,0,
08/04/2014,ZAC.,"MONTE ESCOBEDO, ZAC.",1,0,1,0,0,0,
08/04/2014,N.L.,"GUADALUPE, N.L.",1,0,1,0,0,350,
08/04/2014,CHIS.,"TUZANTÁN, CHIS.",1,0,1,0,0,100,
08/04/2014,CHIH.,"CASAS GRANDES, CHIH.",0,1,1,0,0,0,
08/04/2014,MEX.,"CUAUTITLAN, MEX.",0,0,0,0,0,134,
08/04/2014,N.L.,"SANTA CATARINA, N.L.",0,0,0,3,0,2670,
08/04/2014,SON.,"CAJEME, SON.",0,0,0,0,1,0,
09/04/2014,DGO.,"DGO., DGO.",63,24,87,10,8,0,
09/04/2014,MEX.,"CUAUTITLAN IZCALLI, MEX.",9,3,12,2,2,46,
09/04/2014,GTO.,"ACAMBARO, GTO.",8,2,10,0,1,0,
09/04/2014,D.F.,"MILPA ALTA, D.F.",7,1,8,0,0,0,
09/04/2014,MEX.,"CUAUTITLAN, MEX.",5,0,5,0,2,0,
09/04/2014,SON.,"CAJEME, SON.",2,2,4,0,0,157,
09/04/2014,JAL.,"TLAQUEPAQUE, JAL.",2,0,2,0,2,0,
09/04/2014,AGS.,"AGS., AGS.",1,1,2,1,0,6,
09/04/2014,OAX.,"OAX. DE JUAREZ, OAX.",1,0,1,7,0,122,
09/04/2014,OAX.,"HEROICA CIUDAD DE HUAJUAPAN DE LEON, OAX.",1,0,1,0,0,0,
09/04/2014,OAX.,"PINOTEPA DE DON LUIS, OAX.",0,1,1,0,0,0,
09/04/2014,OAX.,"SANTA MARIA COLOTEPEC, OAX.",1,0,1,0,0,0,
09/04/2014,YUC.,"TEMAX, YUC.",0,1,1,0,0,0,
09/04/2014,PUE.,"IZUCAR DE MATAMOROS, PUE.",1,0,1,0,0,0,
09/04/2014,SON.,"HERMOSILLO, SON.",0,0,0,40,0,0,
10/04/2014,DGO.,"DGO., DGO.",45,10,55,27,2,0,
10/04/2014,MEX.,"NAUCALPAN DE JUAREZ, MEX.",20,2,22,6,0,38,
10/04/2014,D.F.,"MILPA ALTA, D.F.",17,2,19,0,0,0,
10/04/2014,MEX.,"TLALNEPANTLA DE BAZ, MEX.",12,3,15,4,4,116,
10/04/2014,MEX.,"CUAUTITLAN IZCALLI, MEX.",12,0,12,1,0,162,
10/04/2014,MEX.,"CUAUTITLAN, MEX.",8,1,9,0,0,38,
10/04/2014,B.C.,"ENSENADA, B.C.",1,4,5,0,0,0,
10/04/2014,OAX.,"MIAHUATLAN DE PORFIRIO DIAZ, OAX.",2,2,4,0,0,0,
10/04/2014,CHIH.,"DELICIAS, CHIH.",3,1,4,0,1,0,
10/04/2014,B.C.,"MEXICALI, B.C.",4,0,4,0,0,0,
10/04/2014,JAL.,"TLAQUEPAQUE, JAL.",2,1,3,0,0,0,
10/04/2014,OAX.,"SANTA MARIA PETAPA, OAX.",2,0,2,0,0,0,
10/04/2014,AGS.,"AGS., AGS.",2,0,2,3,0,29,
10/04/2014,OAX.,"OAX. DE JUAREZ, OAX.",2,0,2,1,1,13,
10/04/2014,OAX.,"SANTA MARIA COLOTEPEC, OAX.",1,1,2,0,0,0,
10/04/2014,SON.,"CAJEME, SON.",1,1,2,0,1,0,
10/04/2014,N.L.,"SANTA CATARINA, N.L.",1,1,2,7,0,4341,
10/04/2014,GTO.,"ACAMBARO, GTO.",1,1,2,0,0,0,
10/04/2014,YUC.,"DZILAM GONZALEZ, YUC.",1,0,1,0,0,0,
10/04/2014,OAX.,"SANTA MARIA DEL TULE, OAX.",0,1,1,0,0,0,
10/04/2014,VER.,"TANTOYUCA, VER.",0,1,1,0,0,0,
10/04/2014,ZAC.,"LORETO, ZAC.",1,0,1,1,0,0,
10/04/2014,VER.,"TLAPACOYAN, VER.",1,0,1,0,0,0,
10/04/2014,OAX.,"HEROICA CIUDAD DE TLAXIACO, OAX.",1,0,1,0,0,0,
10/04/2014,PUE.,"IZUCAR DE MATAMOROS, PUE.",1,0,1,0,0,0,
10/04/2014,S.L.P.,"CIUDAD VALLES, S.L.P.",0,0,0,1,1,22,
10/04/2014,SON.,"HERMOSILLO, SON.",0,0,0,25,0,0,
10/04/2014,N.L.,"GUADALUPE, N.L.",0,0,0,1,1,1000,
11/04/2014,DGO.,"DGO., DGO.",58,19,77,37,3,16,
11/04/2014,D.F.,"MILPA ALTA, D.F.",30,13,43,0,0,60,
11/04/2014,MEX.,"TLALNEPANTLA DE BAZ, MEX.",14,5,19,5,2,494,
11/04/2014,MEX.,"CUAUTITLAN IZCALLI, MEX.",13,3,16,3,3,290,
11/04/2014,MEX.,"CUAUTITLAN, MEX.",6,7,13,2,6,91,
11/04/2014,TAMPS.,"MATAMOROS, TAMPS.",1,10,11,0,0,300,
11/04/2014,MEX.,"NAUCALPAN DE JUAREZ, MEX.",8,2,10,4,7,50,
11/04/2014,B.C.,"MEXICALI, B.C.",6,4,10,0,0,0,
11/04/2014,GTO.,"ACAMBARO, GTO.",5,2,7,0,2,0,
11/04/2014,HGO.,"CHILCUAUTLA, HGO.",5,1,6,0,0,0,
11/04/2014,N.L.,"GUADALUPE, N.L.",3,2,5,1,0,50,
11/04/2014,OAX.,"MIAHUATLAN DE PORFIRIO DIAZ, OAX.",2,1,3,0,0,48,
11/04/2014,OAX.,"PINOTEPA DE DON LUIS, OAX.",2,0,2,0,0,0,
11/04/2014,OAX.,"VILLA SOLA DE VEGA, OAX.",0,2,2,0,0,0,
11/04/2014,SON.,"HERMOSILLO, SON.",0,1,1,2,0,48,
11/04/2014,ZAC.,"LORETO, ZAC.",1,0,1,1,0,0,
11/04/2014,AGS.,"AGS., AGS.",1,0,1,1,0,6,
11/04/2014,JAL.,"TLAQUEPAQUE, JAL.",1,0,1,0,1,0,
11/04/2014,YUC.,"DZILAM GONZALEZ, YUC.",1,0,1,0,0,0,
11/04/2014,CAMP.,"PALIZADA, CAMP.",0,1,1,0,0,0,
11/04/2014,OAX.,"SANTA MARIA COLOTEPEC, OAX.",0,1,1,0,0,0,
11/04/2014,OAX.,"NEJAPA DE MADERO, OAX.",1,0,1,0,0,0,
11/04/2014,N.L.,"SANTA CATARINA, N.L.",0,0,0,2,0,5645,
11/04/2014,ZAC.,"MONTE ESCOBEDO, ZAC.",0,0,0,5,0,0,
11/04/2014,S.L.P.,"CIUDAD VALLES, S.L.P.",0,0,0,4,2,84,
11/04/2014,PUE.,"IZUCAR DE MATAMOROS, PUE.",0,0,0,5,0,0,
12/04/2014,DGO.,"DGO., DGO.",22,8,30,3,7,0,
12/04/2014,MEX.,"TLALNEPANTLA DE BAZ, MEX.",21,8,29,10,0,366,
12/04/2014,MEX.,"CUAUTITLAN IZCALLI, MEX.",21,2,23,7,0,595,
12/04/2014,MEX.,"NAUCALPAN DE JUAREZ, MEX.",8,3,11,5,0,520,
12/04/2014,MEX.,"CUAUTITLAN, MEX.",3,3,6,1,0,97,
12/04/2014,OAX.,"SANTA MARIA COLOTEPEC, OAX.",3,2,5,0,0,0,
12/04/2014,OAX.,"OAX. DE JUAREZ, OAX.",2,1,3,0,0,0,
12/04/2014,PUE.,"TEPANCO DE LOPEZ, PUE.",2,0,2,1,0,0,
12/04/2014,N.L.,"SANTA CATARINA, N.L.",2,0,2,0,0,5000,
12/04/2014,SON.,"HERMOSILLO, SON.",0,1,1,0,0,0,
12/04/2014,SON.,"CAJEME, SON.",1,0,1,0,0,0,
12/04/2014,VER.,"COATZACOALCOS, VER.",1,0,1,0,0,0,
13/04/2014,N.L.,"GUADALUPE, N.L.",9,1,10,2,0,150,
13/04/2014,B.C.,"MEXICALI, B.C.",3,0,3,0,0,0,
13/04/2014,N.L.,"GUADALUPE, N.L.",1,1,2,2,0,400,
13/04/2014,N.L.,"SANTA CATARINA, N.L.",0,0,0,15,0,3607,
14/04/2014,DGO.,"DGO., DGO.",31,22,53,0,6,0,
14/04/2014,MEX.,"ECATEPEC DE MOR., MEX.",8,3,11,0,0,0,
14/04/2014,B.C.,"MEXICALI, B.C.",5,3,8,0,0,0,
14/04/2014,JAL.,"ZAPOPAN, JAL.",8,0,8,0,0,0,
14/04/2014,MEX.,"NAUCALPAN DE JUAREZ, MEX.",4,2,6,2,0,641,
14/04/2014,B.C.,"TIJUANA, B.C.",3,2,5,0,0,0,
14/04/2014,OAX.,"SANTIAGO PINOTEPA NACIONAL, OAX.",3,0,3,0,0,0,
14/04/2014,SON.,"HERMOSILLO, SON.",3,0,3,28,0,42,
14/04/2014,JAL.,"ZAPOPAN, JAL.",2,0,2,0,0,0,
14/04/2014,OAX.,"HEROICA CIUDAD DE HUAJUAPAN DE LEON, OAX.",2,0,2,1,0,4,
14/04/2014,N.L.,"SANTA CATARINA, N.L.",1,1,2,12,0,5369,
14/04/2014,AGS.,"AGS., AGS.",2,0,2,2,0,68,
14/04/2014,OAX.,"OAX. DE JUAREZ, OAX.",1,0,1,1,0,3,
14/04/2014,OAX.,"SANTA MARIA DEL TULE, OAX.",0,1,1,0,0,0,
14/04/2014,OAX.,"SANTO DOMINGO INGENIO, OAX.",1,0,1,0,0,29,
14/04/2014,OAX.,"MIAHUATLAN DE PORFIRIO DIAZ, OAX.",1,0,1,0,0,0,
14/04/2014,SON.,"CAJEME, SON.",1,0,1,1,0,1,
14/04/2014,N.L.,"GUADALUPE, N.L.",0,0,0,0,0,1050,
15/04/2014,MEX.,"ECATEPEC DE MOR., MEX.",13,5,18,0,5,0,
15/04/2014,MEX.,"NAUCALPAN DE JUAREZ, MEX.",7,2,9,0,0,10,
15/04/2014,CHIS.,"ACACOYAGUA, CHIS.",3,1,4,0,0,0,
15/04/2014,YUC.,"SOTUTA, YUC.",0,3,3,0,0,0,
15/04/2014,S.L.P.,"CIUDAD VALLES, S.L.P.",2,0,2,0,0,8,
15/04/2014,OAX.,"MIAHUATLAN DE PORFIRIO DIAZ, OAX.",1,0,1,0,0,0,
15/04/2014,AGS.,"AGS., AGS.",1,0,1,0,0,70,
15/04/2014,OAX.,"OAX. DE JUAREZ, OAX.",1,0,1,0,0,12,
15/04/2014,CHIS.,"REFORMA, CHIS.",0,1,1,0,0,0,
15/04/2014,NAY.,"SAN PEDRO LAGUNILLAS, NAY.",1,0,1,2,0,0,
15/04/2014,B.C.,"TIJUANA, B.C.",1,0,1,0,0,0,
15/04/2014,N.L.,"SANTA CATARINA, N.L.",0,1,1,72,0,7680,
16/04/2014,DGO.,"DGO., DGO.",38,15,53,22,0,0,
16/04/2014,DGO.,"DGO., DGO.",35,8,43,45,1,0,
16/04/2014,MEX.,"ECATEPEC DE MOR., MEX.",18,1,19,0,10,785,
16/04/2014,JAL.,"ZAPOPAN, JAL.",4,1,5,0,0,0,
16/04/2014,SON.,"CAJEME, SON.",2,0,2,0,0,15,
16/04/2014,YUC.,"SOTUTA, YUC.",1,1,2,0,0,0,
16/04/2014,OAX.,"MIAHUATLAN DE PORFIRIO DIAZ, OAX.",1,1,2,0,0,0,
16/04/2014,OAX.,"SANTO DOMINGO ARMENTA, OAX.",1,1,2,0,0,0,
16/04/2014,N.L.,"APODACA, N.L.",0,1,1,25,0,700,
16/04/2014,TAMPS.,"TAMPICO, TAMPS.",0,1,1,10,0,315,
16/04/2014,S.L.P.,"CIUDAD VALLES, S.L.P.",1,0,1,0,1,0,
16/04/2014,OAX.,"PINOTEPA DE DON LUIS, OAX.",1,0,1,0,0,0,
16/04/2014,MEX.,"NAUCALPAN DE JUAREZ, MEX.",1,0,1,164,0,0,
16/04/2014,SON.,"HERMOSILLO, SON.",0,0,0,35,0,0,
16/04/2014,N.L.,"GRAL. ESCOBEDO, N.L.",0,0,0,3,0,322,
17/04/2014,MEX.,"ECATEPEC DE MOR., MEX.",16,4,20,0,1,0,
17/04/2014,DGO.,"DGO., DGO.",9,4,13,0,5,0,
17/04/2014,MEX.,"NAUCALPAN DE JUAREZ, MEX.",5,0,5,3,0,0,
17/04/2014,CHIS.,"ACACOYAGUA, CHIS.",2,1,3,0,0,250,
18/04/2014,MEX.,"ECATEPEC DE MOR., MEX.",10,5,15,0,1,0,
18/04/2014,DGO.,"DGO., DGO.",10,2,12,22,1,0,
18/04/2014,CHIS.,"ACACOYAGUA, CHIS.",3,2,5,0,0,154,
18/04/2014,MEX.,"NAUCALPAN DE JUAREZ, MEX.",0,4,4,0,0,0,
18/04/2014,N.L.,"GRAL. ESCOBEDO, N.L.",1,0,1,30,0,650,
18/04/2014,N.L.,"APODACA, N.L.",0,0,0,78,0,0,
19/04/2014,MEX.,"ECATEPEC DE MOR., MEX.",13,2,15,0,0,0,
19/04/2014,DGO.,"DGO., DGO.",7,4,11,1,0,0,
19/04/2014,N.L.,"APODACA, N.L.",2,2,4,2,0,100,
19/04/2014,MEX.,"NAUCALPAN DE JUAREZ, MEX.",1,2,3,0,0,215,
19/04/2014,N.L.,"GRAL. ESCOBEDO, N.L.",1,0,1,0,0,50,
19/04/2014,B.C.,"TIJUANA, B.C.",1,0,1,0,0,0,
19/04/2014,B.C.,"ENSENADA, B.C.",0,1,1,0,0,0,
20/04/2014,N.L.,"GRAL. ESCOBEDO, N.L.",0,2,2,2,0,800,
20/04/2014,N.L.,"APODACA, N.L.",0,0,0,0,0,100,
21/04/2014,DGO.,"DGO., DGO.",32,12,44,19,2,0,
21/04/2014,MEX.,"NEZAHUALCOYOTL, MEX.",39,4,43,0,14,483,
21/04/2014,SIN.,"AHOME, SIN.",7,4,11,0,0,0,
21/04/2014,MEX.,"CHIMALHUACAN, MEX.",8,3,11,0,0,548,
21/04/2014,MEX.,"NAUCALPAN DE JUAREZ, MEX.",3,5,8,0,0,52,
21/04/2014,MEX.,"OCOYOACAC, MEX.",5,0,5,0,0,68,
21/04/2014,N.L.,"APODACA, N.L.",2,3,5,5,0,200,
21/04/2014,OAX.,"PINOTEPA DE DON LUIS, OAX.",4,0,4,0,0,0,
21/04/2014,MEX.,"HUIXQUILUCAN, MEX.",3,1,4,0,0,0,
21/04/2014,OAX.,"ZIMATLAN DE ALVAREZ, OAX.",1,1,2,0,0,0,
21/04/2014,TAB.,"TENOSIQUE, TAB.",2,0,2,0,0,0,
21/04/2014,JAL.,"ZAPOPAN, JAL.",2,0,2,0,0,0,
21/04/2014,B.C.,"TIJUANA, B.C.",2,0,2,0,0,0,
21/04/2014,OAX.,"MIAHUATLAN DE PORFIRIO DIAZ, OAX.",1,0,1,0,0,0,
21/04/2014,TAB.,"PARAISO, TAB.",0,1,1,0,0,0,
21/04/2014,OAX.,"OAX. DE JUAREZ, OAX.",1,0,1,0,1,0,
21/04/2014,CHIS.,"HUEHUETÁN, CHIS.",1,0,1,1,0,0,
21/04/2014,S.L.P.,"CIUDAD VALLES, S.L.P.",1,0,1,0,0,70,
21/04/2014,OAX.,"EL ESPINAL, OAX.",1,0,1,5,0,0,
21/04/2014,N.L.,"GRAL. ESCOBEDO, N.L.",1,0,1,2,0,200,
21/04/2014,SON.,"HERMOSILLO, SON.",0,0,0,0,0,53,
22/04/2014,MEX.,"NEZAHUALCOYOTL, MEX.",56,7,63,0,8,300,
22/04/2014,DGO.,"DGO., DGO.",26,6,32,39,3,0,
22/04/2014,MEX.,"CHIMALHUACAN, MEX.",15,4,19,0,0,0,
22/04/2014,MEX.,"ECATEPEC DE MOR., MEX.",15,2,17,0,4,0,
22/04/2014,SIN.,"AHOME, SIN.",14,1,15,0,7,0,
22/04/2014,MEX.,"HUIXQUILUCAN, MEX.",5,7,12,153,6,153,
22/04/2014,MEX.,"OCOYOACAC, MEX.",7,0,7,3,0,17,
22/04/2014,N.L.,"APODACA, N.L.",2,2,4,23,0,300,
22/04/2014,SIN.,"SALVADOR ALVARADO, SIN.",2,2,4,0,0,0,
22/04/2014,B.C.,"ENSENADA, B.C.",2,1,3,0,0,0,
22/04/2014,CHIS.,"HUEHUETÁN, CHIS.",1,1,2,1,0,38,
22/04/2014,OAX.,"TLACOLULA DE MATAMOROS, OAX.",2,0,2,0,0,0,
22/04/2014,B.C.,"MEXICALI, B.C.",0,2,2,0,0,0,
22/04/2014,CHIS.,"SUCHIATE, CHIS.",1,0,1,0,0,0,
22/04/2014,SON.,"CAJEME, SON.",1,0,1,0,0,0,
22/04/2014,MEX.,"NAUCALPAN DE JUAREZ, MEX.",0,1,1,1,0,466,
22/04/2014,NAY.,"SAN BLAS, NAY.",1,0,1,0,0,0,
22/04/2014,CHIS.,"REFORMA, CHIS.",0,1,1,0,0,0,
22/04/2014,OAX.,"OAX. DE JUAREZ, OAX.",0,1,1,0,1,0,
22/04/2014,OAX.,"HEROICA CIUDAD DE HUAJUAPAN DE LEON, OAX.",1,0,1,0,0,0,
22/04/2014,OAX.,"EL ESPINAL, OAX.",0,1,1,0,0,19,
22/04/2014,B.C.,"TIJUANA, B.C.",1,0,1,0,0,0,
22/04/2014,CHIH.,"CHIH., CHIH.",1,0,1,0,0,0,
22/04/2014,CHIH.,"AHUMADA, CHIH.",1,0,1,0,0,0,
22/04/2014,PUE.,"IZUCAR DE MATAMOROS, PUE.",0,0,0,0,0,9,
23/04/2014,MEX.,"NEZAHUALCOYOTL, MEX.",56,3,59,0,7,327,
23/04/2014,SIN.,"AHOME, SIN.",31,13,44,0,4,0,
23/04/2014,DGO.,"DGO., DGO.",28,6,34,3,3,0,
23/04/2014,MEX.,"ECATEPEC DE MOR., MEX.",18,1,19,0,10,0,
23/04/2014,SIN.,"SALVADOR ALVARADO, SIN.",3,5,8,0,0,0,
23/04/2014,MEX.,"OCOYOACAC, MEX.",6,1,7,0,0,146,
23/04/2014,OAX.,"OAX. DE JUAREZ, OAX.",3,3,6,1,0,0,
23/04/2014,MEX.,"HUIXQUILUCAN, MEX.",4,1,5,0,0,6,
23/04/2014,JAL.,"ZAPOPAN, JAL.",4,0,4,0,0,0,
23/04/2014,OAX.,"EL ESPINAL, OAX.",0,4,4,4,0,0,
23/04/2014,MEX.,"CHIMALHUACAN, MEX.",4,0,4,0,0,0,
23/04/2014,B.C.,"ENSENADA, B.C.",2,2,4,0,0,0,
23/04/2014,N.L.,"APODACA, N.L.",1,2,3,40,0,316,
23/04/2014,CHIS.,"HUEHUETÁN, CHIS.",2,1,3,0,0,295,
23/04/2014,MEX.,"NAUCALPAN DE JUAREZ, MEX.",2,0,2,0,0,64,
23/04/2014,OAX.,"OAX. DE JUAREZ, OAX.",1,1,2,0,0,0,
23/04/2014,B.C.,"MEXICALI, B.C.",1,1,2,0,0,0,
23/04/2014,OAX.,"PINOTEPA DE DON LUIS, OAX.",0,1,1,0,0,0,
23/04/2014,SON.,"HERMOSILLO, SON.",1,0,1,0,0,0,
23/04/2014,SON.,"CAJEME, SON.",1,0,1,0,0,0,
23/04/2014,CHIS.,"SUCHIATE, CHIS.",0,1,1,0,0,0,
23/04/2014,S.L.P.,"CIUDAD VALLES, S.L.P.",1,0,1,1,0,70,
23/04/2014,B.C.,"TECATE, B.C.",0,1,1,0,0,0,
23/04/2014,CHIS.,"REFORMA, CHIS.",1,0,1,0,0,0,
23/04/2014,COAH.,"RAMOS ARIZPE, COAH.",1,0,1,0,0,12,
24/04/2014,MEX.,"NEZAHUALCOYOTL, MEX.",49,5,54,0,4,193,
24/04/2014,DGO.,"DGO., DGO.",29,7,36,0,4,0,
24/04/2014,SIN.,"AHOME, SIN.",22,3,25,0,8,0,
24/04/2014,MEX.,"ECATEPEC DE MOR., MEX.",13,3,16,0,0,0,
24/04/2014,MEX.,"OCOYOACAC, MEX.",9,2,11,3,0,143,
24/04/2014,MEX.,"CHIMALHUACAN, MEX.",9,0,9,0,0,0,
24/04/2014,JAL.,"ZAPOPAN, JAL.",3,5,8,0,0,0,
24/04/2014,MEX.,"HUIXQUILUCAN, MEX.",6,2,8,2,0,200,
24/04/2014,MEX.,"NAUCALPAN DE JUAREZ, MEX.",4,1,5,0,2,16,
24/04/2014,SIN.,"SALVADOR ALVARADO, SIN.",1,2,3,0,0,0,
24/04/2014,OAX.,"ZIMATLAN DE ALVAREZ, OAX.",2,0,2,0,0,0,
24/04/2014,CHIS.,"SUCHIATE, CHIS.",1,0,1,0,0,0,
25/04/2014,DGO.,"DGO., DGO.",40,8,48,15,2,0,
25/04/2014,MEX.,"NEZAHUALCOYOTL, MEX.",41,2,43,0,6,0,
25/04/2014,SIN.,"AHOME, SIN.",30,10,40,0,6,0,
25/04/2014,TAMPS.,"MATAMOROS, TAMPS.",5,4,9,0,0,0,
25/04/2014,MEX.,"OCOYOACAC, MEX.",6,2,8,0,0,0,
25/04/2014,MEX.,"HUIXQUILUCAN, MEX.",7,0,7,0,0,100,
25/04/2014,JAL.,"ZAPOPAN, JAL.",4,1,5,0,0,0,
25/04/2014,MEX.,"ECATEPEC DE MOR., MEX.",3,2,5,0,3,0,
25/04/2014,B.C.,"TIJUANA, B.C.",1,3,4,0,0,0,
25/04/2014,MEX.,"CHIMALHUACAN, MEX.",3,1,4,0,5,0,
25/04/2014,CHIH.,"AHUMADA, CHIH.",2,2,4,1,0,0,
25/04/2014,OAX.,"OAX. DE JUAREZ, OAX.",2,1,3,2,0,0,
25/04/2014,SIN.,"SALVADOR ALVARADO, SIN.",3,0,3,0,1,0,
25/04/2014,OAX.,"ZIMATLAN DE ALVAREZ, OAX.",2,0,2,4,0,185,
25/04/2014,B.C.,"MEXICALI, B.C.",0,2,2,0,0,0,
25/04/2014,S.L.P.,"CIUDAD VALLES, S.L.P.",1,1,2,0,0,0,
25/04/2014,MEX.,"NAUCALPAN DE JUAREZ, MEX.",2,0,2,0,0,18,
25/04/2014,CAMP.,"PALIZADA, CAMP.",0,2,2,0,0,0,
25/04/2014,N.L.,"APODACA, N.L.",1,1,2,34,2,217,
25/04/2014,OAX.,"SANTIAGO LAOLLAGA, OAX.",1,0,1,0,0,23,
25/04/2014,OAX.,"EL ESPINAL, OAX.",0,1,1,3,0,0,
25/04/2014,OAX.,"PINOTEPA DE DON LUIS, OAX.",1,0,1,0,0,0,
25/04/2014,SON.,"HERMOSILLO, SON.",1,0,1,38,0,0,
25/04/2014,N.L.,"GRAL. ESCOBEDO, N.L.",0,1,1,17,0,150,
25/04/2014,ZAC.,"MONTE ESCOBEDO, ZAC.",0,1,1,0,0,0,
26/04/2014,MEX.,"NEZAHUALCOYOTL, MEX.",42,10,52,0,12,0,
26/04/2014,DGO.,"DGO., DGO.",17,5,22,3,6,0,
26/04/2014,MEX.,"ECATEPEC DE MOR., MEX.",15,3,18,0,2,0,
26/04/2014,TAMPS.,"MATAMOROS, TAMPS.",2,9,11,0,0,0,
26/04/2014,MEX.,"OCOYOACAC, MEX.",7,0,7,1,0,0,
26/04/2014,B.C.,"ENSENADA, B.C.",4,2,6,0,0,0,
26/04/2014,TAMPS.,"REYNOSA, TAMPS.",0,4,4,0,0,0,
26/04/2014,MEX.,"NAUCALPAN DE JUAREZ, MEX.",2,1,3,1,0,46,
26/04/2014,N.L.,"GRAL. ESCOBEDO, N.L.",3,0,3,4,0,0,
26/04/2014,CHIS.,"HUEHUETÁN, CHIS.",1,1,2,0,0,60,
26/04/2014,MEX.,"HUIXQUILUCAN, MEX.",0,2,2,0,0,0,
26/04/2014,MEX.,"CHIMALHUACAN, MEX.",2,0,2,0,1,0,
26/04/2014,B.C.,"MEXICALI, B.C.",1,1,2,0,0,0,
26/04/2014,CHIS.,"REFORMA, CHIS.",1,0,1,1,0,25,
26/04/2014,B.C.S.,"COMONDÚ, B.C.S.",1,0,1,0,0,0,
26/04/2014,B.C.,"TECATE, B.C.",0,1,1,0,0,0,
26/04/2014,N.L.,"APODACA, N.L.",1,0,1,4,0,0,
26/04/2014,CHIS.,"MAPASTEPEC, CHIS.",0,0,0,0,0,24,
27/04/2014,N.L.,"GRAL. ESCOBEDO, N.L.",1,0,1,2,0,200,
27/04/2014,N.L.,"APODACA, N.L.",1,0,1,4,0,100,
27/04/2014,N.L.,"GRAL. ESCOBEDO, N.L.",0,0,0,4,0,2100,
28/04/2014,D.F.,"XOCHIMILCO, D.F.",30,22,52,2,0,200,
28/04/2014,DGO.,"DGO., DGO.",33,10,43,4,0,0,
28/04/2014,SIN.,"AHOME, SIN.",17,8,25,0,2,0,
28/04/2014,MEX.,"NAUCALPAN DE JUAREZ, MEX.",18,4,22,11,0,593,
28/04/2014,MEX.,"ECATEPEC DE MOR., MEX.",15,4,19,0,0,0,
28/04/2014,MEX.,"TEOLOYUCAN, MEX.",7,1,8,1,0,0,
28/04/2014,MEX.,"ALMOLOYA DE JUAREZ, MEX.",6,0,6,0,0,0,
28/04/2014,OAX.,"OAX. DE JUAREZ, OAX.",2,2,4,1,0,56,
28/04/2014,SIN.,"SALVADOR ALVARADO, SIN.",2,1,3,0,0,0,
28/04/2014,OAX.,"PINOTEPA DE DON LUIS, OAX.",2,0,2,2,0,0,
28/04/2014,OAX.,"LOMA BONITA, OAX.",0,1,1,0,0,0,
28/04/2014,MEX.,"VALLE DE BRAVO, MEX.",0,1,1,0,0,0,
28/04/2014,SON.,"CAJEME, SON.",1,0,1,0,0,0,
28/04/2014,OAX.,"CIUDAD IXTEPEC, OAX.",1,0,1,1,0,0,
28/04/2014,SIN.,"GUASAVE, SIN.",1,0,1,0,0,0,
28/04/2014,CHIS.,"MAPASTEPEC, CHIS.",0,0,0,0,0,63,
29/04/2014,D.F.,"XOCHIMILCO, D.F.",42,7,49,0,0,150,
29/04/2014,DGO.,"DGO., DGO.",34,8,42,12,8,0,
29/04/2014,MEX.,"ECATEPEC DE MOR., MEX.",30,0,30,0,5,0,
29/04/2014,SIN.,"AHOME, SIN.",23,6,29,0,6,0,
29/04/2014,MEX.,"ALMOLOYA DE JUAREZ, MEX.",15,1,16,0,0,0,
29/04/2014,MEX.,"TEOLOYUCAN, MEX.",8,3,11,0,0,0,
29/04/2014,SIN.,"SALVADOR ALVARADO, SIN.",6,5,11,0,0,0,
29/04/2014,B.C.,"ENSENADA, B.C.",5,4,9,0,1,0,
29/04/2014,OAX.,"MIAHUATLAN DE PORFIRIO DIAZ, OAX.",4,2,6,0,0,0,
29/04/2014,MEX.,"NAUCALPAN DE JUAREZ, MEX.",6,0,6,3,0,286,
29/04/2014,SIN.,"GUASAVE, SIN.",3,2,5,0,0,0,
29/04/2014,OAX.,"SANTA MARIA HUAZOLOTITLAN, OAX.",1,3,4,0,0,0,
29/04/2014,S.L.P.,"CIUDAD VALLES, S.L.P.",1,2,3,0,0,0,
29/04/2014,B.C.,"MEXICALI, B.C.",2,1,3,0,0,0,
29/04/2014,MEX.,"HUEHUETOCA, MEX.",3,0,3,0,0,0,
29/04/2014,OAX.,"OAX. DE JUAREZ, OAX.",2,0,2,2,0,0,
29/04/2014,OAX.,"HEROICA CIUDAD DE HUAJUAPAN DE LEON, OAX.",2,0,2,22,0,0,
29/04/2014,MEX.,"VALLE DE BRAVO, MEX.",1,1,2,1,0,0,
29/04/2014,N.L.,"GRAL. ESCOBEDO, N.L.",2,0,2,2,0,100,
29/04/2014,N.L.,"APODACA, N.L.",1,1,2,9,0,70,
29/04/2014,SON.,"CAJEME, SON.",1,0,1,0,0,0,
29/04/2014,OAX.,"PINOTEPA DE DON LUIS, OAX.",0,1,1,0,0,0,
29/04/2014,OAX.,"SANTA MARIA HUATULCO, OAX.",0,1,1,0,0,0,
29/04/2014,SIN.,"ANGOSTURA, SIN.",0,1,1,0,0,0,
30/04/2014,DGO.,"DGO., DGO.",49,10,59,27,8,0,
30/04/2014,D.F.,"XOCHIMILCO, D.F.",32,4,36,0,0,50,
30/04/2014,SIN.,"AHOME, SIN.",28,3,31,0,8,0,
30/04/2014,MEX.,"ALMOLOYA DE JUAREZ, MEX.",16,2,18,0,0,0,
30/04/2014,MEX.,"ECATEPEC DE MOR., MEX.",14,2,16,0,2,0,
30/04/2014,MEX.,"VALLE DE BRAVO, MEX.",3,6,9,2,0,41,
30/04/2014,MEX.,"TEOLOYUCAN, MEX.",6,3,9,0,0,0,
30/04/2014,SIN.,"GUASAVE, SIN.",5,2,7,0,0,0,
30/04/2014,MEX.,"NAUCALPAN DE JUAREZ, MEX.",4,1,5,0,0,0,
30/04/2014,SIN.,"ANGOSTURA, SIN.",0,4,4,0,0,0,
30/04/2014,SIN.,"SALVADOR ALVARADO, SIN.",2,0,2,0,0,0,
30/04/2014,B.C.,"ENSENADA, B.C.",1,1,2,0,0,0,
30/04/2014,OAX.,"OAX. DE JUAREZ, OAX.",0,2,2,0,1,0,
30/04/2014,MEX.,"HUEHUETOCA, MEX.",1,1,2,3,0,0,
30/04/2014,ZAC.,"MONTE ESCOBEDO, ZAC.",0,1,1,0,0,0,
30/04/2014,OAX.,"SAN PEDRO MIXTEPEC, OAX.",0,1,1,0,0,0,
30/04/2014,OAX.,"SANTA MARIA HUATULCO, OAX.",0,1,1,0,0,0,
30/04/2014,N.L.,"GRAL. ESCOBEDO, N.L.",0,0,0,183,0,3850,
30/04/2014,N.L.,"APODACA, N.L.",0,0,0,21,0,382,
30/04/2014,CHIS.,"MAPASTEPEC, CHIS.",0,0,0,0,0,70,
30/04/2014,N.L.,"CADEREYTA JIMENEZ, N.L.",0,0,0,85,0,0,
01/05/2014,SIN.,"AHOME, SIN.",14,3,17,0,11,0,
01/05/2014,SIN.,"GUASAVE, SIN.",3,2,5,0,0,0,
01/05/2014,MEX.,"NAUCALPAN DE JUAREZ, MEX.",4,0,4,8,0,73,
01/05/2014,SON.,"CAJEME, SON.",2,0,2,1,1,32,
01/05/2014,SIN.,"SALVADOR ALVARADO, SIN.",2,0,2,0,0,0,
01/05/2014,SIN.,"ANGOSTURA, SIN.",1,1,2,0,1,0,
01/05/2014,OAX.,"HEROICA CIUDAD DE HUAJUAPAN DE LEON, OAX.",1,0,1,1,0,128,
01/05/2014,OAX.,"SANTA MARIA HUATULCO, OAX.",0,1,1,0,0,0,
01/05/2014,B.C.,"TIJUANA, B.C.",0,1,1,0,0,0,
01/05/2014,ZAC.,"SAIN ALTO, ZAC.",1,0,1,0,0,0,
01/05/2014,B.C.,"ENSENADA, B.C.",0,0,0,0,1,0,
02/05/2014,D.F.,"XOCHIMILCO, D.F.",39,10,49,0,3,1800,
02/05/2014,SIN.,"AHOME, SIN.",24,22,46,0,9,0,
02/05/2014,MEX.,"ECATEPEC DE MOR., MEX.",29,4,33,0,1,0,
02/05/2014,MEX.,"ALMOLOYA DE JUAREZ, MEX.",26,0,26,0,0,0,
02/05/2014,DGO.,"DGO., DGO.",12,6,18,1,0,0,
02/05/2014,SIN.,"GUASAVE, SIN.",10,5,15,0,7,0,
02/05/2014,DGO.,"DGO., DGO.",10,2,12,11,0,0,
02/05/2014,MEX.,"HUEHUETOCA, MEX.",9,3,12,0,0,0,
02/05/2014,MEX.,"VALLE DE BRAVO, MEX.",6,4,10,2,0,348,
02/05/2014,MEX.,"TEOLOYUCAN, MEX.",4,4,8,0,0,5,
02/05/2014,SIN.,"SALVADOR ALVARADO, SIN.",3,3,6,0,0,0,
02/05/2014,SIN.,"ANGOSTURA, SIN.",0,6,6,0,0,0,
02/05/2014,OAX.,"PINOTEPA DE DON LUIS, OAX.",5,1,6,0,0,0,
02/05/2014,OAX.,"MIAHUATLAN DE PORFIRIO DIAZ, OAX.",4,1,5,5,0,0,
02/05/2014,OAX.,"SANTA MARIA HUATULCO, OAX.",1,2,3,2,0,0,
02/05/2014,CHIS.,"SAN CRISTOBAL DE LAS CASAS, CHIS.",1,2,3,0,0,0,
02/05/2014,SON.,"HERMOSILLO, SON.",2,0,2,17,0,28,
02/05/2014,N.L.,"CADEREYTA JIMENEZ, N.L.",0,2,2,28,0,50,
02/05/2014,MEX.,"NAUCALPAN DE JUAREZ, MEX.",2,0,2,0,1,61,
02/05/2014,COAH.,"ACUÑA, COAH.",0,1,1,0,0,0,
02/05/2014,OAX.,"OAX. DE JUAREZ, OAX.",0,1,1,1,0,24,
02/05/2014,OAX.,"SANTA CRUZ XOXOCOTLAN, OAX.",1,0,1,0,0,0,
02/05/2014,NAY.,"SAN BLAS, NAY.",1,0,1,1,0,0,
02/05/2014,N.L.,"SAN PEDRO GARZA GARCIA, N.L.",0,1,1,55,0,3200,
02/05/2014,OAX.,"HEROICA CIUDAD DE EJUTLA DE CRESPO, OAX.",1,0,1,0,0,0,
02/05/2014,TAMPS.,"MIQUIHUANA, TAMPS.",0,1,1,0,0,0,
02/05/2014,VER.,"POZA RICA DE HGO., VER.",0,0,0,0,1,0,
02/05/2014,VER.,"COATZINTLA, VER.",0,0,0,0,0,367,
03/05/2014,MEX.,"ALMOLOYA DE JUAREZ, MEX.",15,3,18,0,0,0,
03/05/2014,MEX.,"TEOLOYUCAN, MEX.",11,7,18,3,2,115,
03/05/2014,MEX.,"ECATEPEC DE MOR., MEX.",17,0,17,0,0,0,
03/05/2014,DGO.,"DGO., DGO.",9,5,14,0,0,0,
03/05/2014,CHIS.,"SAN CRISTOBAL DE LAS CASAS, CHIS.",3,2,5,0,0,0,
03/05/2014,MEX.,"HUEHUETOCA, MEX.",4,0,4,0,0,0,
03/05/2014,OAX.,"OAX. DE JUAREZ, OAX.",3,0,3,0,0,21,
03/05/2014,MEX.,"NAUCALPAN DE JUAREZ, MEX.",2,0,2,0,0,0,
03/05/2014,OAX.,"PINOTEPA DE DON LUIS, OAX.",1,0,1,0,0,0,
03/05/2014,SON.,"GUAYMAS, SON.",0,1,1,2,0,0,
03/05/2014,MEX.,"VALLE DE BRAVO, MEX.",1,0,1,0,0,0,
04/05/2014,TAMPS.,"MATAMOROS, TAMPS.",4,5,9,1,0,2,
04/05/2014,CHIS.,"SAN CRISTOBAL DE LAS CASAS, CHIS.",2,3,5,0,0,0,
04/05/2014,N.L.,"SAN PEDRO GARZA GARCIA, N.L.",0,1,1,35,0,2400,
04/05/2014,N.L.,"CADEREYTA JIMENEZ, N.L.",1,0,1,4,0,67,
05/05/2014,DGO.,"DGO., DGO.",21,4,25,27,0,0,
05/05/2014,SIN.,"AHOME, SIN.",6,3,9,0,0,0,
05/05/2014,SIN.,"GUASAVE, SIN.",1,2,3,0,0,0,
05/05/2014,MEX.,"NAUCALPAN DE JUAREZ, MEX.",3,0,3,2,0,0,
05/05/2014,CHIS.,"SAN CRISTOBAL DE LAS CASAS, CHIS.",2,0,2,1,0,0,
05/05/2014,N.L.,"SAN PEDRO GARZA GARCIA, N.L.",1,0,1,14,0,4650,
05/05/2014,N.L.,"CADEREYTA JIMENEZ, N.L.",1,0,1,0,0,0,
05/05/2014,B.C.,"ENSENADA, B.C.",0,1,1,0,0,0,
05/05/2014,SIN.,"ANGOSTURA, SIN.",0,1,1,0,0,0,
06/05/2014,DGO.,"DGO., DGO.",29,3,32,11,2,0,
06/05/2014,D.F.,"TLALPAN, D.F.",24,3,27,0,5,0,
06/05/2014,MEX.,"TEXCOCO, MEX.",15,3,18,0,0,0,
06/05/2014,SIN.,"AHOME, SIN.",9,3,12,0,10,0,
06/05/2014,CHIS.,"SAN CRISTOBAL DE LAS CASAS, CHIS.",3,1,4,1,0,0,
06/05/2014,B.C.,"TIJUANA, B.C.",2,2,4,0,0,0,
06/05/2014,B.C.,"MEXICALI, B.C.",0,4,4,0,0,0,
06/05/2014,SIN.,"GUASAVE, SIN.",2,1,3,0,0,0,
06/05/2014,OAX.,"MIAHUATLAN DE PORFIRIO DIAZ, OAX.",1,1,2,5,0,34,
06/05/2014,N.L.,"SAN PEDRO GARZA GARCIA, N.L.",1,1,2,0,0,0,
06/05/2014,OAX.,"CIUDAD IXTEPEC, OAX.",0,2,2,6,0,0,
06/05/2014,OAX.,"OAX. DE JUAREZ, OAX.",1,1,2,1,0,0,
06/05/2014,OAX.,"SAN MARCOS ARTEAGA, OAX.",2,0,2,0,0,0,
06/05/2014,MEX.,"IXTAPALUCA, MEX.",2,0,2,0,0,0,
06/05/2014,SIN.,"ANGOSTURA, SIN.",0,1,1,0,0,0,
06/05/2014,S.L.P.,"CIUDAD VALLES, S.L.P.",0,1,1,0,1,0,
06/05/2014,SON.,"CAJEME, SON.",1,0,1,1,0,0,
06/05/2014,JAL.,"GUADALAJARA, JAL.",0,1,1,0,0,0,
06/05/2014,OAX.,"SANTIAGO JUXTLAHUACA, OAX.",0,1,1,0,0,0,
06/05/2014,OAX.,"HEROICA CIUDAD DE HUAJUAPAN DE LEON, OAX.",1,0,1,0,0,0,
07/05/2014,D.F.,"TLALPAN, D.F.",25,6,31,0,4,0,
07/05/2014,SIN.,"AHOME, SIN.",9,7,16,0,10,0,
07/05/2014,MEX.,"SAN MATEO ATENCO, MEX.",13,0,13,0,0,50,
07/05/2014,MEX.,"IXTAPALUCA, MEX.",10,3,13,0,4,0,
07/05/2014,MEX.,"TEXCOCO, MEX.",12,0,12,0,0,0,
07/05/2014,MEX.,"NAUCALPAN DE JUAREZ, MEX.",8,0,8,2,0,0,
07/05/2014,B.C.,"TIJUANA, B.C.",2,3,5,0,0,0,
07/05/2014,MEX.,"TENANCINGO, MEX.",3,2,5,0,0,0,
07/05/2014,SIN.,"GUASAVE, SIN.",3,2,5,0,0,0,
07/05/2014,OAX.,"OAX. DE JUAREZ, OAX.",0,4,4,0,0,0,
07/05/2014,NAY.,"SANTIAGO IXCUINTLA, NAY.",2,2,4,0,0,0,
07/05/2014,OAX.,"OCOTLAN DE MOR., OAX.",2,1,3,2,0,18,
07/05/2014,SIN.,"ANGOSTURA, SIN.",2,0,2,0,0,0,
07/05/2014,CHIS.,"SAN CRISTOBAL DE LAS CASAS, CHIS.",1,1,2,1,0,0,
07/05/2014,CHIH.,"HGO. DEL PARRAL, CHIH.",1,0,1,0,0,0,
07/05/2014,N.L.,"SAN PEDRO GARZA GARCIA, N.L.",1,0,1,12,0,3460,
07/05/2014,JAL.,"GUADALAJARA, JAL.",1,0,1,0,0,0,
07/05/2014,B.C.,"ENSENADA, B.C.",0,1,1,0,0,0,
07/05/2014,NAY.,"SAN BLAS, NAY.",1,0,1,0,0,0,
07/05/2014,SON.,"CAJEME, SON.",0,1,1,0,0,0,
07/05/2014,ZAC.,"FRESNILLO, ZAC.",1,0,1,0,0,0,
07/05/2014,N.L.,"CADEREYTA JIMENEZ, N.L.",0,0,0,5,0,400,
07/05/2014,S.L.P.,"CIUDAD VALLES, S.L.P.",0,0,0,0,0,155,
07/05/2014,SON.,"HERMOSILLO, SON.",0,0,0,15,0,292,
08/05/2014,D.F.,"TLALPAN, D.F.",29,5,34,0,9,82,
08/05/2014,DGO.,"DGO., DGO.",23,8,31,34,1,0,
08/05/2014,SIN.,"AHOME, SIN.",16,7,23,0,10,0,
08/05/2014,MEX.,"TEXCOCO, MEX.",10,4,14,0,2,0,
08/05/2014,DGO.,"DGO., DGO.",11,2,13,2,1,0,
08/05/2014,B.C.,"MEXICALI, B.C.",2,7,9,0,0,0,
08/05/2014,MEX.,"IXTAPALUCA, MEX.",7,2,9,0,0,0,
08/05/2014,MEX.,"TENANCINGO, MEX.",5,0,5,0,0,0,
08/05/2014,SIN.,"GUASAVE, SIN.",2,2,4,0,0,0,
08/05/2014,NAY.,"SANTIAGO IXCUINTLA, NAY.",1,2,3,0,0,0,
08/05/2014,MEX.,"SAN MATEO ATENCO, MEX.",2,1,3,1,0,0,
08/05/2014,B.C.,"TIJUANA, B.C.",1,1,2,0,0,0,
08/05/2014,MEX.,"NAUCALPAN DE JUAREZ, MEX.",1,1,2,0,5,0,
08/05/2014,N.L.,"SAN PEDRO GARZA GARCIA, N.L.",2,0,2,6,0,350,
08/05/2014,B.C.,"ENSENADA, B.C.",1,0,1,0,0,0,
08/05/2014,SIN.,"ANGOSTURA, SIN.",0,1,1,0,0,0,
08/05/2014,NAY.,"SAN BLAS, NAY.",1,0,1,0,0,0,
08/05/2014,TAB.,"PARAISO, TAB.",0,1,1,1,0,0,
08/05/2014,ZAC.,"FRESNILLO, ZAC.",1,0,1,0,0,0,
08/05/2014,JAL.,"GUADALAJARA, JAL.",1,0,1,0,0,0,
08/05/2014,CHIH.,"HGO. DEL PARRAL, CHIH.",1,0,1,0,0,0,
08/05/2014,SON.,"HERMOSILLO, SON.",0,0,0,1,0,0,
08/05/2014,CHIS.,"SAN CRISTOBAL DE LAS CASAS, CHIS.",0,0,0,0,1,0,
09/05/2014,MEX.,"TEXCOCO, MEX.",32,6,38,0,0,0,
09/05/2014,D.F.,"TLALPAN, D.F.",32,5,37,0,20,265,
09/05/2014,SIN.,"AHOME, SIN.",24,3,27,0,14,0,
09/05/2014,DGO.,"DGO., DGO.",21,5,26,10,2,0,
09/05/2014,MEX.,"IXTAPALUCA, MEX.",11,0,11,0,0,500,
09/05/2014,SIN.,"GUASAVE, SIN.",8,3,11,0,0,0,
09/05/2014,MEX.,"SAN MATEO ATENCO, MEX.",3,3,6,0,0,0,
09/05/2014,B.C.,"TIJUANA, B.C.",3,2,5,0,0,0,
09/05/2014,OAX.,"PINOTEPA DE DON LUIS, OAX.",4,0,4,0,0,0,
09/05/2014,OAX.,"OAX. DE JUAREZ, OAX.",2,2,4,1,0,4,
09/05/2014,CHIS.,"SAN CRISTOBAL DE LAS CASAS, CHIS.",2,1,3,0,0,0,
09/05/2014,OAX.,"JUCHITAN DE ZARAGOZA, OAX.",0,2,2,3,0,0,
09/05/2014,OAX.,"SAN ANDRES HUAXPALTEPEC, OAX.",1,0,1,0,0,0,
09/05/2014,OAX.,"SAN PEDRO POCHUTLA, OAX.",1,0,1,0,0,0,
09/05/2014,MEX.,"TENANCINGO, MEX.",0,1,1,0,2,0,
09/05/2014,JAL.,"GUADALAJARA, JAL.",0,1,1,0,0,0,
09/05/2014,N.L.,"CADEREYTA JIMENEZ, N.L.",1,0,1,0,0,0,
09/05/2014,TAMPS.,"MATAMOROS, TAMPS.",0,1,1,4,0,115,
09/05/2014,COAH.,"RAMOS ARIZPE, COAH.",1,0,1,0,0,0,
09/05/2014,SIN.,"ANGOSTURA, SIN.",0,1,1,0,0,0,
09/05/2014,MEX.,"NAUCALPAN DE JUAREZ, MEX.",0,0,0,0,1,0,
10/05/2014,MEX.,"TEXCOCO, MEX.",21,9,30,0,0,0,
10/05/2014,MEX.,"IXTAPALUCA, MEX.",10,2,12,0,0,0,
10/05/2014,DGO.,"DGO., DGO.",7,2,9,2,0,0,
10/05/2014,B.C.,"MEXICALI, B.C.",2,4,6,0,0,0,
10/05/2014,TAMPS.,"MATAMOROS, TAMPS.",0,5,5,0,0,0,
10/05/2014,B.C.,"ENSENADA, B.C.",2,0,2,0,0,0,
10/05/2014,VER.,"COATZINTLA, VER.",1,0,1,0,0,0,
10/05/2014,B.C.,"TIJUANA, B.C.",0,1,1,0,0,0,
11/05/2014,OAX.,"CIUDAD IXTEPEC, OAX.",0,1,1,0,0,0,
12/05/2014,DGO.,"DGO., DGO.",20,6,26,5,0,0,
12/05/2014,D.F.,"COYOACAN, D.F.",11,6,17,0,4,0,
12/05/2014,MEX.,"TENANCINGO, MEX.",13,3,16,0,0,0,
12/05/2014,MEX.,"CHALCO, MEX.",10,2,12,5,1,170,
12/05/2014,MEX.,"AMECAMECA, MEX.",9,2,11,0,0,0,
12/05/2014,SIN.,"EL FUERTE, SIN.",5,5,10,0,3,0,
12/05/2014,N.L.,"SAN PEDRO GARZA GARCIA, N.L.",2,2,4,7,0,500,
12/05/2014,MEX.,"NAUCALPAN DE JUAREZ, MEX.",3,0,3,1,0,0,
12/05/2014,SIN.,"MOCORITO, SIN.",0,3,3,0,0,0,
12/05/2014,MEX.,"NOPALTEPEC, MEX.",1,1,2,0,0,0,
12/05/2014,NAY.,"ACAPONETA, NAY.",1,1,2,0,0,0,
12/05/2014,N.L.,"CADEREYTA JIMENEZ, N.L.",2,0,2,0,0,30,
12/05/2014,OAX.,"CIUDAD IXTEPEC, OAX.",0,1,1,0,0,0,
12/05/2014,TAB.,"JALPA DE MENDEZ, TAB.",1,0,1,0,0,0,
12/05/2014,COAH.,"ACUÑA, COAH.",1,0,1,0,0,0,
12/05/2014,CHIH.,"HGO. DEL PARRAL, CHIH.",1,0,1,1,0,0,
12/05/2014,OAX.,"OAX. DE JUAREZ, OAX.",1,0,1,0,0,0,
12/05/2014,SON.,"HERMOSILLO, SON.",0,1,1,9,0,0,
12/05/2014,TAMPS.,"GONZALEZ, TAMPS.",1,0,1,0,0,261,
13/05/2014,D.F.,"COYOACAN, D.F.",24,2,26,0,5,50,
13/05/2014,MEX.,"ATLACOMULCO, MEX.",17,5,22,0,0,0,
13/05/2014,SIN.,"EL FUERTE, SIN.",10,6,16,0,0,0,
13/05/2014,MEX.,"AMECAMECA, MEX.",9,7,16,0,0,0,
13/05/2014,MEX.,"CHALCO, MEX.",8,2,10,0,0,0,
13/05/2014,DGO.,"DGO., DGO.",8,2,10,24,6,0,
13/05/2014,B.C.,"MEXICALI, B.C.",3,4,7,0,0,0,
13/05/2014,SON.,"CAJEME, SON.",5,1,6,0,0,0,
13/05/2014,SIN.,"MOCORITO, SIN.",4,1,5,0,0,0,
13/05/2014,OAX.,"OAX. DE JUAREZ, OAX.",0,4,4,0,0,0,
13/05/2014,OAX.,"LOMA BONITA, OAX.",2,2,4,0,0,0,
13/05/2014,CHIS.,"SAN CRISTOBAL DE LAS CASAS, CHIS.",2,1,3,0,0,0,
13/05/2014,MEX.,"TENANGO DEL VALLE, MEX.",3,0,3,0,0,0,
13/05/2014,NAY.,"ACAPONETA, NAY.",0,3,3,0,0,0,
13/05/2014,ZAC.,"GUADALUPE, ZAC.",2,0,2,0,0,210,
13/05/2014,MEX.,"NAUCALPAN DE JUAREZ, MEX.",2,0,2,0,0,40,
13/05/2014,MEX.,"NOPALTEPEC, MEX.",2,0,2,0,0,47,
13/05/2014,B.C.,"ENSENADA, B.C.",2,0,2,0,0,0,
13/05/2014,S.L.P.,"CIUDAD VALLES, S.L.P.",0,1,1,1,0,15,
13/05/2014,N.L.,"SAN PEDRO GARZA GARCIA, N.L.",0,1,1,2,0,190,
13/05/2014,MEX.,"CHALCO, MEX.",0,0,0,0,0,0,
13/05/2014,CHIH.,"HGO. DEL PARRAL, CHIH.",0,0,0,0,2,0,
14/05/2014,D.F.,"COYOACAN, D.F.",24,8,32,0,3,80,
14/05/2014,SIN.,"EL FUERTE, SIN.",7,13,20,0,0,0,
14/05/2014,TAMPS.,"MATAMOROS, TAMPS.",2,15,17,0,0,273,
14/05/2014,MEX.,"ATLACOMULCO, MEX.",14,0,14,0,0,0,
14/05/2014,DGO.,"DGO., DGO.",9,5,14,8,1,0,
14/05/2014,MEX.,"AMECAMECA, MEX.",4,7,11,0,3,0,
14/05/2014,MEX.,"CHALCO, MEX.",5,5,10,0,2,0,
14/05/2014,MEX.,"NOPALTEPEC, MEX.",6,3,9,0,0,0,
14/05/2014,MEX.,"NAUCALPAN DE JUAREZ, MEX.",4,1,5,2,0,0,
14/05/2014,OAX.,"OAX. DE JUAREZ, OAX.",0,5,5,0,0,0,
14/05/2014,N.L.,"ANAHUAC, N.L.",0,5,5,1,0,100,
14/05/2014,B.C.,"MEXICALI, B.C.",2,2,4,0,0,0,
14/05/2014,B.C.,"ENSENADA, B.C.",1,2,3,0,0,0,
14/05/2014,PUE.,"PUE., PUE.",3,0,3,1,0,17,
14/05/2014,COAH.,"MONCLOVA, COAH.",2,0,2,0,0,0,
14/05/2014,SIN.,"MOCORITO, SIN.",1,0,1,0,1,0,
14/05/2014,MEX.,"TENANGO DEL VALLE, MEX.",1,0,1,0,0,0,
14/05/2014,CHIS.,"SAN CRISTOBAL DE LAS CASAS, CHIS.",1,0,1,0,0,0,
14/05/2014,B.C.,"TIJUANA, B.C.",1,0,1,0,0,0,
14/05/2014,B.C.,"TECATE, B.C.",0,1,1,0,0,0,
14/05/2014,ZAC.,"LORETO, ZAC.",1,0,1,0,0,96,
14/05/2014,N.L.,"SAN PEDRO GARZA GARCIA, N.L.",0,0,0,1,0,280,
14/05/2014,N.L.,"CADEREYTA JIMENEZ, N.L.",0,0,0,1,0,0,
14/05/2014,SON.,"HERMOSILLO, SON.",0,0,0,8,0,0,
15/05/2014,D.F.,"COYOACAN, D.F.",26,11,37,0,9,120,
15/05/2014,MEX.,"ATLACOMULCO, MEX.",18,6,24,0,0,0,
15/05/2014,DGO.,"DGO., DGO.",14,4,18,3,3,0,
15/05/2014,SIN.,"EL FUERTE, SIN.",12,5,17,0,4,0,
15/05/2014,MEX.,"CHALCO, MEX.",11,5,16,1,3,5,
15/05/2014,MEX.,"NOPALTEPEC, MEX.",9,4,13,0,1,0,
15/05/2014,MEX.,"AMECAMECA, MEX.",6,3,9,0,5,0,
15/05/2014,MEX.,"TENANGO DEL VALLE, MEX.",6,2,8,0,0,0,
15/05/2014,SIN.,"MOCORITO, SIN.",4,1,5,0,3,0,
15/05/2014,MEX.,"NAUCALPAN DE JUAREZ, MEX.",5,0,5,2,0,40,
15/05/2014,OAX.,"OAX. DE JUAREZ, OAX.",0,2,2,0,0,111,
15/05/2014,JAL.,"GUADALAJARA, JAL.",1,1,2,0,0,0,
15/05/2014,ZAC.,"VALPARAISO, ZAC.",2,0,2,1,0,0,
15/05/2014,N.L.,"SAN PEDRO GARZA GARCIA, N.L.",1,1,2,57,0,4373,
15/05/2014,COAH.,"ACUÑA, COAH.",1,0,1,0,0,0,
15/05/2014,COAH.,"ARTEAGA, COAH.",1,0,1,7,0,0,
15/05/2014,COAH.,"FRONTERA, COAH.",1,0,1,0,0,0,
15/05/2014,N.L.,"CADEREYTA JIMENEZ, N.L.",0,0,0,1,0,0,
16/05/2014,MEX.,"ATLACOMULCO, MEX.",23,9,32,0,0,0,
16/05/2014,DGO.,"DGO., DGO.",23,6,29,4,1,0,
16/05/2014,D.F.,"COYOACAN, D.F.",22,3,25,0,9,30,
16/05/2014,SIN.,"EL FUERTE, SIN.",16,9,25,0,4,0,
16/05/2014,MEX.,"CHALCO, MEX.",22,1,23,3,1,0,
16/05/2014,MEX.,"AMECAMECA, MEX.",12,6,18,0,2,0,
16/05/2014,TAMPS.,"MATAMOROS, TAMPS.",4,9,13,0,0,0,
16/05/2014,MEX.,"TENANGO DEL VALLE, MEX.",8,2,10,0,0,0,
16/05/2014,SIN.,"MOCORITO, SIN.",4,0,4,0,4,0,
16/05/2014,MEX.,"NOPALTEPEC, MEX.",3,1,4,0,12,0,
16/05/2014,JAL.,"GUADALAJARA, JAL.",2,1,3,0,0,10,
16/05/2014,PUE.,"PUE., PUE.",0,3,3,0,0,115,
16/05/2014,OAX.,"OAX. DE JUAREZ, OAX.",0,2,2,0,0,0,
16/05/2014,MEX.,"NAUCALPAN DE JUAREZ, MEX.",2,0,2,0,1,394,
16/05/2014,VER.,"TUXPAM, VER.",1,0,1,1,0,0,
16/05/2014,ZAC.,"LORETO, ZAC.",1,0,1,0,0,20,
16/05/2014,MEX.,"CHALCO, MEX.",0,0,0,0,0,0,
17/05/2014,MEX.,"ATLACOMULCO, MEX.",14,10,24,0,1,0,
17/05/2014,MEX.,"CHALCO, MEX.",9,3,12,1,0,0,
17/05/2014,MEX.,"AMECAMECA, MEX.",7,0,7,0,0,0,
17/05/2014,DGO.,"DGO., DGO.",6,1,7,6,2,0,
17/05/2014,MEX.,"TENANGO DEL VALLE, MEX.",2,3,5,0,0,0,
17/05/2014,TAMPS.,"MATAMOROS, TAMPS.",0,4,4,0,0,0,
17/05/2014,MEX.,"NAUCALPAN DE JUAREZ, MEX.",4,0,4,0,2,0,
17/05/2014,MEX.,"NOPALTEPEC, MEX.",2,1,3,0,5,0,
17/05/2014,B.C.,"MEXICALI, B.C.",1,1,2,0,0,0,
17/05/2014,N.L.,"SAN PEDRO GARZA GARCIA, N.L.",0,0,0,56,0,157,
17/05/2014,MEX.,"ATLACOMULCO, MEX.",0,0,0,0,0,0,
17/05/2014,MEX.,"NAUCALPAN DE JUAREZ, MEX.",0,0,0,0,0,0,
17/05/2014,MEX.,"TENANGO DEL VALLE, MEX.",0,0,0,0,0,0,
19/05/2014,D.F.,"COYOACAN, D.F.",17,1,18,0,5,0,
19/05/2014,MEX.,"TULTEPEC, MEX.",10,0,10,3,0,0,
19/05/2014,MEX.,"NAUCALPAN DE JUAREZ, MEX.",7,1,8,3,0,100,
19/05/2014,MEX.,"CHALCO, MEX.",7,0,7,2,1,47,
19/05/2014,MEX.,"CHALCO, MEX.",7,0,7,2,1,47,
19/05/2014,MEX.,"METEPEC, MEX.",4,0,4,1,0,42,
19/05/2014,MEX.,"TIANGUISTENCO, MEX.",2,1,3,0,0,0,
19/05/2014,ZAC.,"LORETO, ZAC.",1,1,2,0,0,0,
19/05/2014,MEX.,"ACOLMAN, MEX.",2,0,2,0,4,0,
19/05/2014,Q. ROO,"COZUMEL, Q. ROO",1,0,1,0,0,0,
19/05/2014,B.C.,"MEXICALI, B.C.",1,0,1,0,0,0,
20/05/2014,D.F.,"COYOACAN, D.F.",30,8,38,0,7,150,
20/05/2014,SIN.,"EL FUERTE, SIN.",6,20,26,0,2,0,
20/05/2014,MEX.,"VALLE DE CHALCO SOLIDARIDAD, MEX.",19,2,21,2,0,51,
20/05/2014,MEX.,"ACOLMAN, MEX.",16,3,19,0,0,0,
20/05/2014,MEX.,"METEPEC, MEX.",15,2,17,3,1,50,
20/05/2014,MEX.,"TULTEPEC, MEX.",13,4,17,0,0,6,
20/05/2014,MEX.,"NAUCALPAN DE JUAREZ, MEX.",6,0,6,5,0,70,
20/05/2014,MEX.,"TENANGO DEL VALLE, MEX.",3,1,4,0,0,0,
20/05/2014,CAMP.,"CALAKMUL, CAMP.",0,1,1,0,0,0,
20/05/2014,SIN.,"MOCORITO, SIN.",0,1,1,0,0,0,
20/05/2014,VER.,"MISANTLA, VER.",1,0,1,0,0,0,
20/05/2014,JAL.,"TLAQUEPAQUE, JAL.",0,1,1,0,0,0,
20/05/2014,N.L.,"SAN PEDRO GARZA GARCIA, N.L.",0,0,0,15,0,4100,
20/05/2014,CHIH.,"GUADALUPE, CHIH.",0,0,0,0,0,100,
20/05/2014,COAH.,"PARRAS, COAH.",0,0,0,0,0,13,
21/05/2014,D.F.,"COYOACAN, D.F.",23,10,33,0,2,20,
21/05/2014,SIN.,"EL FUERTE, SIN.",6,24,30,0,0,0,
21/05/2014,MEX.,"VALLE DE CHALCO SOLIDARIDAD, MEX.",15,2,17,0,0,0,
21/05/2014,MEX.,"TIANGUISTENCO, MEX.",6,4,10,0,0,0,
21/05/2014,MEX.,"METEPEC, MEX.",9,0,9,1,0,0,
21/05/2014,MEX.,"NAUCALPAN DE JUAREZ, MEX.",7,1,8,0,0,90,
21/05/2014,MEX.,"TULTEPEC, MEX.",8,0,8,1,0,1,
21/05/2014,N.L.,"LINARES, N.L.",3,2,5,0,0,15,
21/05/2014,MEX.,"ACOLMAN, MEX.",2,3,5,0,1,0,
21/05/2014,CHIH.,"JUÁREZ, CHIH.",0,4,4,0,0,14,
21/05/2014,COAH.,"PARRAS, COAH.",4,0,4,0,0,13,
21/05/2014,HGO.,"PACHUCA DE SOTO, HGO.",1,1,2,0,0,0,
21/05/2014,ZAC.,"LORETO, ZAC.",1,0,1,0,0,0,
21/05/2014,Q. ROO,"COZUMEL, Q. ROO",0,1,1,0,0,385,
21/05/2014,N.L.,"GARCIA, N.L.",0,1,1,31,0,3287,
21/05/2014,CHIH.,"MADERA, CHIH.",1,0,1,0,0,0,
21/05/2014,VER.,"MISANTLA, VER.",1,0,1,0,0,0,
21/05/2014,S.L.P.,"SAN LUIS POTOSI, S.L.P.",0,0,0,0,1,0,
22/05/2014,D.F.,"COYOACAN, D.F.",30,9,39,0,2,80,
22/05/2014,SIN.,"EL FUERTE, SIN.",12,12,24,0,0,0,
22/05/2014,MEX.,"NAUCALPAN DE JUAREZ, MEX.",10,7,17,2,2,567,
22/05/2014,MEX.,"VALLE DE CHALCO SOLIDARIDAD, MEX.",8,1,9,0,0,0,
22/05/2014,MEX.,"METEPEC, MEX.",4,3,7,1,5,0,
22/05/2014,MEX.,"TIANGUISTENCO, MEX.",4,2,6,0,0,0,
22/05/2014,MEX.,"ACOLMAN, MEX.",4,2,6,0,5,0,
22/05/2014,COAH.,"PARRAS, COAH.",1,3,4,2,0,75,
22/05/2014,OAX.,"OAX. DE JUAREZ, OAX.",0,3,3,0,0,0,
22/05/2014,NAY.,"SANTA MARIA DEL ORO, NAY.",1,2,3,0,0,0,
22/05/2014,N.L.,"LINARES, N.L.",3,0,3,2,0,54,
22/05/2014,MEX.,"TULTEPEC, MEX.",3,0,3,1,1,13,
22/05/2014,HGO.,"PACHUCA DE SOTO, HGO.",1,0,1,0,0,30,
22/05/2014,NAY.,"ACAPONETA, NAY.",1,0,1,0,0,0,
22/05/2014,SIN.,"MOCORITO, SIN.",0,1,1,0,0,0,
22/05/2014,JAL.,"TLAQUEPAQUE, JAL.",1,0,1,0,0,0,
22/05/2014,TAB.,"TENOSIQUE, TAB.",1,0,1,0,0,0,
22/05/2014,B.C.,"TIJUANA, B.C.",1,0,1,0,0,0,
22/05/2014,B.C.,"ENSENADA, B.C.",0,1,1,0,0,0,
22/05/2014,PUE.,"PUE., PUE.",0,0,0,2,0,40,
22/05/2014,N.L.,"GARCIA, N.L.",0,0,0,10,0,3775,
22/05/2014,Q. ROO,"COZUMEL, Q. ROO",0,0,0,0,0,18,
23/05/2014,D.F.,"COYOACAN, D.F.",27,16,43,0,6,430,
23/05/2014,SIN.,"EL FUERTE, SIN.",10,11,21,0,3,0,
23/05/2014,TAMPS.,"MATAMOROS, TAMPS.",5,12,17,0,0,0,
23/05/2014,MEX.,"NAUCALPAN DE JUAREZ, MEX.",9,5,14,3,0,318,
23/05/2014,MEX.,"TULTEPEC, MEX.",13,1,14,2,0,63,
23/05/2014,MEX.,"VALLE DE CHALCO SOLIDARIDAD, MEX.",9,1,10,0,0,0,
23/05/2014,NAY.,"SANTA MARIA DEL ORO, NAY.",0,8,8,0,0,0,
23/05/2014,MEX.,"METEPEC, MEX.",6,2,8,2,0,800,
23/05/2014,MEX.,"ACOLMAN, MEX.",6,0,6,0,5,0,
23/05/2014,SIN.,"MOCORITO, SIN.",1,4,5,0,0,0,
23/05/2014,MEX.,"TIANGUISTENCO, MEX.",4,1,5,0,0,0,
23/05/2014,N.L.,"LINARES, N.L.",4,1,5,0,0,148,
23/05/2014,N.L.,"GARCIA, N.L.",3,0,3,19,0,2253,
23/05/2014,CHIH.,"GUADALUPE, CHIH.",0,1,1,0,0,0,
23/05/2014,VER.,"MISANTLA, VER.",1,0,1,0,0,0,
23/05/2014,SON.,"HERMOSILLO, SON.",1,0,1,0,0,950,
23/05/2014,B.C.,"TIJUANA, B.C.",1,0,1,0,0,0,
24/05/2014,MEX.,"METEPEC, MEX.",13,3,16,1,0,710,
24/05/2014,MEX.,"NAUCALPAN DE JUAREZ, MEX.",10,3,13,1,0,100,
24/05/2014,MEX.,"TIANGUISTENCO, MEX.",9,4,13,0,0,0,
24/05/2014,MEX.,"VALLE DE CHALCO SOLIDARIDAD, MEX.",8,1,9,0,0,0,
24/05/2014,MEX.,"ACOLMAN, MEX.",5,3,8,0,3,0,
24/05/2014,MEX.,"TULTEPEC, MEX.",4,1,5,0,2,41,
24/05/2014,HGO.,"PACHUCA DE SOTO, HGO.",1,1,2,0,0,0,
24/05/2014,SON.,"HERMOSILLO, SON.",0,0,0,1,0,779,
25/05/2014,N.L.,"JUAREZ, N.L.",3,2,5,6,0,30,
25/05/2014,B.C.,"TIJUANA, B.C.",0,1,1,0,0,0,
25/05/2014,B.C.,"ENSENADA, B.C.",1,0,1,0,0,0,
25/05/2014,N.L.,"GARCIA, N.L.",0,0,0,22,0,2962,
26/05/2014,D.F.,"BENITO JUAREZ, D.F.",16,8,24,0,1,45,
26/05/2014,SIN.,"CULIACAN, SIN.",14,3,17,1,1,0,
26/05/2014,MEX.,"ZINACANTEPEC, MEX.",10,2,12,2,2,0,
26/05/2014,SIN.,"EL FUERTE, SIN.",7,5,12,0,2,0,
26/05/2014,NAY.,"SANTA MARIA DEL ORO, NAY.",0,8,8,0,0,0,
26/05/2014,SIN.,"CHOIX, SIN.",2,5,7,0,0,0,
26/05/2014,MEX.,"TOLUCA, MEX.",4,1,5,0,0,0,
26/05/2014,SIN.,"BADIRAGUATO, SIN.",1,4,5,0,0,0,
26/05/2014,MEX.,"HUIXQUILUCAN, MEX.",2,0,2,0,1,19,
26/05/2014,SON.,"CAJEME, SON.",2,0,2,0,0,14,
26/05/2014,MEX.,"LA PAZ, MEX.",2,0,2,0,0,0,
26/05/2014,ZAC.,"VALPARAISO, ZAC.",1,0,1,1,0,0,
26/05/2014,N.L.,"JUAREZ, N.L.",0,1,1,0,0,219,
26/05/2014,HGO.,"PACHUCA DE SOTO, HGO.",0,0,0,0,0,200,
26/05/2014,SON.,"HERMOSILLO, SON.",0,0,0,22,0,0,
26/05/2014,N.L.,"GARCIA, N.L.",0,0,0,5,0,310,
27/05/2014,MEX.,"LA PAZ, MEX.",20,4,24,0,3,0,
27/05/2014,SIN.,"EL FUERTE, SIN.",4,17,21,0,0,0,
27/05/2014,D.F.,"BENITO JUAREZ, D.F.",18,1,19,0,0,85,
27/05/2014,MEX.,"TOLUCA, MEX.",12,6,18,0,0,100,
27/05/2014,OAX.,"OAX. DE JUAREZ, OAX.",2,14,16,0,0,0,
27/05/2014,SIN.,"CULIACAN, SIN.",12,2,14,0,1,0,
27/05/2014,NAY.,"SANTA MARIA DEL ORO, NAY.",0,10,10,0,0,0,
27/05/2014,MEX.,"ZINACANTEPEC, MEX.",8,0,8,1,0,0,
27/05/2014,SIN.,"CHOIX, SIN.",4,2,6,0,0,0,
27/05/2014,CHIH.,"CHIH., CHIH.",3,2,5,3,1,486,
27/05/2014,SIN.,"BADIRAGUATO, SIN.",2,2,4,0,0,0,
27/05/2014,B.C.,"ENSENADA, B.C.",1,3,4,0,0,0,
27/05/2014,B.C.,"TIJUANA, B.C.",0,2,2,0,0,0,
27/05/2014,CHIH.,"GUADALUPE, CHIH.",0,2,2,1,0,0,
27/05/2014,PUE.,"COXCATLAN, PUE.",2,0,2,0,0,0,
27/05/2014,JAL.,"TLAQUEPAQUE, JAL.",2,0,2,0,0,19,
27/05/2014,S.L.P.,"CIUDAD VALLES, S.L.P.",1,0,1,1,1,8,
27/05/2014,HGO.,"PACHUCA DE SOTO, HGO.",0,1,1,0,0,39,
27/05/2014,QRO.,"TEQUISQUIAPAN, QRO.",1,0,1,0,0,0,
27/05/2014,N.L.,"JUAREZ, N.L.",0,0,0,2,0,0,
27/05/2014,N.L.,"GARCIA, N.L.",0,0,0,15,0,4598,
28/05/2014,D.F.,"BENITO JUAREZ, D.F.",22,8,30,0,2,35,
28/05/2014,MEX.,"LA PAZ, MEX.",16,1,17,0,0,0,
28/05/2014,MEX.,"TOLUCA, MEX.",11,4,15,0,0,100,
28/05/2014,SIN.,"CULIACAN, SIN.",10,2,12,0,0,0,
28/05/2014,NAY.,"ACAPONETA, NAY.",4,4,8,0,0,0,
28/05/2014,CHIH.,"CHIH., CHIH.",6,2,8,14,0,329,
28/05/2014,MEX.,"ZINACANTEPEC, MEX.",4,3,7,7,0,184,
28/05/2014,OAX.,"OAX. DE JUAREZ, OAX.",1,4,5,1,0,0,
28/05/2014,MEX.,"HUIXQUILUCAN, MEX.",3,1,4,0,0,0,
28/05/2014,B.C.,"TIJUANA, B.C.",3,1,4,0,0,0,
28/05/2014,SIN.,"EL FUERTE, SIN.",3,0,3,0,0,0,
28/05/2014,SIN.,"CHOIX, SIN.",2,1,3,0,0,0,
28/05/2014,SIN.,"BADIRAGUATO, SIN.",1,1,2,0,0,0,
28/05/2014,CHIH.,"MADERA, CHIH.",0,2,2,0,0,0,
28/05/2014,JAL.,"TLAQUEPAQUE, JAL.",1,0,1,0,0,5,
28/05/2014,SON.,"CAJEME, SON.",1,0,1,10,0,0,
28/05/2014,N.L.,"JUAREZ, N.L.",1,0,1,4,0,125,
28/05/2014,CHIH.,"GUADALUPE, CHIH.",1,0,1,0,0,0,
28/05/2014,S.L.P.,"CIUDAD VALLES, S.L.P.",0,0,0,0,1,0,
28/05/2014,N.L.,"GARCIA, N.L.",0,0,0,14,0,4500,
29/05/2014,D.F.,"BENITO JUAREZ, D.F.",22,1,23,0,3,530,
29/05/2014,MEX.,"LA PAZ, MEX.",16,0,16,0,1,0,
29/05/2014,CHIH.,"CHIH., CHIH.",7,0,7,0,0,52,
29/05/2014,OAX.,"OAX. DE JUAREZ, OAX.",2,3,5,2,0,0,
29/05/2014,NAY.,"SANTA MARIA DEL ORO, NAY.",4,0,4,0,0,0,
29/05/2014,HGO.,"PACHUCA DE SOTO, HGO.",2,0,2,0,1,41,
29/05/2014,ZAC.,"LORETO, ZAC.",2,0,2,0,0,0,
29/05/2014,JAL.,"TLAQUEPAQUE, JAL.",2,0,2,0,0,0,
29/05/2014,CHIH.,"MADERA, CHIH.",0,0,0,0,0,11,
30/05/2014,D.F.,"BENITO JUAREZ, D.F.",33,6,39,0,5,45,
30/05/2014,SIN.,"EL FUERTE, SIN.",7,20,27,0,3,0,
30/05/2014,MEX.,"LA PAZ, MEX.",18,7,25,0,5,199,
30/05/2014,MEX.,"TOLUCA, MEX.",18,3,21,2,0,1000,
30/05/2014,SIN.,"CHOIX, SIN.",7,12,19,0,0,0,
30/05/2014,SIN.,"CULIACAN, SIN.",12,4,16,0,2,0,
30/05/2014,MEX.,"ZINACANTEPEC, MEX.",9,3,12,0,0,0,
30/05/2014,HGO.,"PACHUCA DE SOTO, HGO.",6,0,6,0,0,460,
30/05/2014,OAX.,"OAX. DE JUAREZ, OAX.",1,4,5,0,0,0,
30/05/2014,MEX.,"HUIXQUILUCAN, MEX.",3,2,5,0,0,0,
30/05/2014,CHIH.,"CHIH., CHIH.",3,1,4,1,1,218,
30/05/2014,SIN.,"BADIRAGUATO, SIN.",1,2,3,0,0,0,
30/05/2014,JAL.,"TLAQUEPAQUE, JAL.",2,0,2,0,0,0,
30/05/2014,ZAC.,"LORETO, ZAC.",2,0,2,0,0,0,
30/05/2014,CHIH.,"NAMIQUIPA, CHIH.",1,1,2,0,0,0,
30/05/2014,N.L.,"JUAREZ, N.L.",0,1,1,1,0,100,
30/05/2014,S.L.P.,"CIUDAD VALLES, S.L.P.",0,1,1,1,0,0,
30/05/2014,PUE.,"COXCATLAN, PUE.",1,0,1,0,0,0,
30/05/2014,B.C.,"TIJUANA, B.C.",0,1,1,0,0,0,
30/05/2014,COL.,"COL., COL.",0,1,1,0,0,0,
30/05/2014,CHIH.,"MADERA, CHIH.",0,0,0,0,0,10,
30/05/2014,CHIH.,"GUADALUPE, CHIH.",0,0,0,0,0,25,
30/05/2014,N.L.,"GARCIA, N.L.",0,0,0,27,0,6833,
30/05/2014,PUE.,"PUE., PUE.",0,0,0,0,1,20,
30/05/2014,SON.,"HERMOSILLO, SON.",0,0,0,23,0,860,
31/05/2014,MEX.,"TOLUCA, MEX.",20,2,22,3,0,200,
31/05/2014,TAMPS.,"MATAMOROS, TAMPS.",11,7,18,0,1,0,
31/05/2014,MEX.,"LA PAZ, MEX.",12,3,15,0,2,0,
31/05/2014,HGO.,"PACHUCA DE SOTO, HGO.",8,1,9,0,0,340,
31/05/2014,MEX.,"ZINACANTEPEC, MEX.",3,1,4,2,1,140,
31/05/2014,MEX.,"HUIXQUILUCAN, MEX.",2,0,2,2,0,65,
31/05/2014,B.C.,"ENSENADA, B.C.",0,2,2,0,0,0,
31/05/2014,N.L.,"JUAREZ, N.L.",0,1,1,2,0,42,
31/05/2014,SON.,"CAJEME, SON.",1,0,1,0,0,14,
31/05/2014,B.C.,"TIJUANA, B.C.",1,0,1,0,0,0,
31/05/2014,N.L.,"GARCIA, N.L.",0,0,0,80,0,8257,
31/05/2014,SON.,"HERMOSILLO, SON.",0,0,0,9,0,0,
02/06/2014,D.F.,"CUAJIMALPA DE MOR., D.F.",21,6,27,0,0,0,
02/06/2014,SIN.,"CULIACAN, SIN.",10,8,18,0,2,0,
02/06/2014,CHIH.,"CHIH., CHIH.",7,3,10,0,0,50,
02/06/2014,SIN.,"CHOIX, SIN.",4,3,7,0,0,0,
02/06/2014,OAX.,"OAX. DE JUAREZ, OAX.",0,7,7,0,0,0,
02/06/2014,MEX.,"HUEYPOXTLA, MEX.",2,3,5,0,0,0,
02/06/2014,SIN.,"BADIRAGUATO, SIN.",3,1,4,0,0,0,
02/06/2014,MEX.,"TEJUPILCO, MEX.",4,0,4,0,0,0,
02/06/2014,MEX.,"TEQUIXQUIAC, MEX.",4,0,4,0,0,0,
02/06/2014,COL.,"COL., COL.",2,1,3,0,0,0,
02/06/2014,MEX.,"VILLA VICTORIA, MEX.",0,2,2,0,0,0,
02/06/2014,B.C.,"TIJUANA, B.C.",1,0,1,0,0,0,
02/06/2014,N.L.,"SANTIAGO, N.L.",0,1,1,40,0,1866,
02/06/2014,ZAC.,"VILLANUEVA, ZAC.",1,0,1,1,0,9,
02/06/2014,ZAC.,"VALPARAISO, ZAC.",1,0,1,1,0,0,
02/06/2014,N.L.,"JUAREZ, N.L.",0,0,0,4,0,100,
03/06/2014,D.F.,"CUAJIMALPA DE MOR., D.F.",24,1,25,0,6,0,
03/06/2014,CHIH.,"CHIH., CHIH.",3,3,6,0,0,480,
03/06/2014,MEX.,"HUEYPOXTLA, MEX.",1,3,4,0,0,37,
03/06/2014,OAX.,"OAX. DE JUAREZ, OAX.",0,3,3,0,0,0,
03/06/2014,YUC.,"KANASIN, YUC.",2,1,3,0,0,0,
03/06/2014,YUC.,"CHANKOM, YUC.",1,1,2,0,0,0,
03/06/2014,HGO.,"PACHUCA DE SOTO, HGO.",2,0,2,0,0,0,
03/06/2014,MEX.,"TEQUIXQUIAC, MEX.",1,1,2,1,0,64,
03/06/2014,QRO.,"EZEQUIEL MONTES, QRO.",1,1,2,0,0,0,
03/06/2014,QRO.,"EZEQUIEL MONTES, QRO.",0,1,1,0,1,0,
03/06/2014,COL.,"COL., COL.",0,1,1,0,0,0,
03/06/2014,OAX.,"CIUDAD IXTEPEC, OAX.",0,0,0,6,0,40,
03/06/2014,COL.,"COL., COL.",0,0,0,0,0,14,
03/06/2014,N.L.,"SANTIAGO, N.L.",0,0,0,10,0,450,
04/06/2014,D.F.,"CUAJIMALPA DE MOR., D.F.",31,1,32,0,5,40,
04/06/2014,MEX.,"TEJUPILCO, MEX.",8,0,8,4,0,0,
04/06/2014,B.C.,"TIJUANA, B.C.",3,5,8,0,0,0,
04/06/2014,MEX.,"TOLUCA, MEX.",1,3,4,0,0,0,
04/06/2014,YUC.,"KANASIN, YUC.",3,1,4,0,0,0,
04/06/2014,MEX.,"TEQUIXQUIAC, MEX.",4,0,4,0,0,0,
04/06/2014,HGO.,"TIZAYUCA, HGO.",1,2,3,0,0,75,
04/06/2014,MEX.,"HUEYPOXTLA, MEX.",3,0,3,0,0,0,
04/06/2014,ZAC.,"VILLANUEVA, ZAC.",2,0,2,0,0,0,
04/06/2014,CHIH.,"CHIH., CHIH.",1,1,2,0,0,0,
04/06/2014,OAX.,"OAX. DE JUAREZ, OAX.",0,1,1,0,0,0,
04/06/2014,COL.,"TECOMÁN, COL.",0,0,0,0,0,14,
04/06/2014,N.L.,"SANTIAGO, N.L.",0,0,0,2,1,389,
05/06/2014,D.F.,"CUAJIMALPA DE MOR., D.F.",26,15,41,0,3,128,
05/06/2014,D.F.,"MIGUEL HGO., D.F.",40,1,41,0,0,800,
05/06/2014,SIN.,"BADIRAGUATO, SIN.",7,6,13,0,0,0,
05/06/2014,SIN.,"CULIACAN, SIN.",7,6,13,0,0,0,
05/06/2014,MEX.,"TOLUCA, MEX.",8,1,9,0,0,0,
05/06/2014,SIN.,"CHOIX, SIN.",2,7,9,0,0,0,
05/06/2014,MEX.,"HUEYPOXTLA, MEX.",9,0,9,0,0,22,
05/06/2014,MEX.,"TEQUIXQUIAC, MEX.",5,2,7,0,0,0,
05/06/2014,OAX.,"OAX. DE JUAREZ, OAX.",0,5,5,0,0,0,
05/06/2014,MEX.,"TEJUPILCO, MEX.",2,1,3,1,0,0,
05/06/2014,B.C.,"TIJUANA, B.C.",2,1,3,0,0,0,
05/06/2014,N.L.,"JUAREZ, N.L.",2,1,3,0,0,0,
05/06/2014,ZAC.,"ZAC., ZAC.",0,2,2,0,0,0,
05/06/2014,ZAC.,"VILLANUEVA, ZAC.",1,1,2,2,0,0,
05/06/2014,N.L.,"SANTIAGO, N.L.",1,1,2,2,0,800,
05/06/2014,MEX.,"SULTEPEC, MEX.",0,1,1,0,0,0,
05/06/2014,JAL.,"ZAPOPAN, JAL.",1,0,1,0,0,10,
05/06/2014,YUC.,"CHANKOM, YUC.",0,1,1,0,0,0,
05/06/2014,SON.,"CAJEME, SON.",1,0,1,0,0,0,
05/06/2014,OAX.,"CIUDAD IXTEPEC, OAX.",0,1,1,10,0,0,
05/06/2014,SON.,"HERMOSILLO, SON.",0,0,0,5,0,0,
05/06/2014,PUE.,"PUE., PUE.",0,0,0,2,0,10,
06/06/2014,D.F.,"CUAJIMALPA DE MOR., D.F.",33,2,35,0,2,0,
06/06/2014,SIN.,"CULIACAN, SIN.",19,6,25,0,2,0,
06/06/2014,SIN.,"CHOIX, SIN.",6,8,14,0,4,0,
06/06/2014,MEX.,"TEQUIXQUIAC, MEX.",10,2,12,0,0,0,
06/06/2014,MEX.,"TOLUCA, MEX.",10,1,11,0,0,102,
06/06/2014,NAY.,"SANTA MARIA DEL ORO, NAY.",10,0,10,0,0,0,
06/06/2014,MEX.,"TEJUPILCO, MEX.",6,1,7,5,0,23,
06/06/2014,MEX.,"HUEYPOXTLA, MEX.",7,0,7,0,0,74,
06/06/2014,OAX.,"OAX. DE JUAREZ, OAX.",1,3,4,1,0,7,
06/06/2014,MEX.,"SULTEPEC, MEX.",3,1,4,0,0,0,
06/06/2014,HGO.,"TIZAYUCA, HGO.",2,0,2,0,0,400,
06/06/2014,ZAC.,"ZAC., ZAC.",1,1,2,0,0,0,
06/06/2014,COL.,"COL., COL.",2,0,2,8,0,0,
06/06/2014,CHIH.,"CHIH., CHIH.",2,0,2,0,1,265,
06/06/2014,N.L.,"SANTIAGO, N.L.",0,1,1,0,0,0,
06/06/2014,COL.,"COL., COL.",1,0,1,0,0,0,
06/06/2014,SIN.,"BADIRAGUATO, SIN.",1,0,1,0,0,0,
06/06/2014,ZAC.,"VALPARAISO, ZAC.",1,0,1,1,0,0,
06/06/2014,JAL.,"ZAPOPAN, JAL.",0,1,1,0,0,0,
06/06/2014,SON.,"HERMOSILLO, SON.",0,0,0,23,0,91,
06/06/2014,PUE.,"PUE., PUE.",0,0,0,0,2,110,
07/06/2014,MEX.,"TOLUCA, MEX.",14,2,16,6,1,0,
07/06/2014,MEX.,"TEJUPILCO, MEX.",9,4,13,4,0,0,
07/06/2014,MEX.,"TEQUIXQUIAC, MEX.",10,1,11,0,0,0,
07/06/2014,MEX.,"HUEYPOXTLA, MEX.",5,3,8,0,0,0,
07/06/2014,SON.,"CAJEME, SON.",2,1,3,1,0,0,
07/06/2014,MEX.,"SULTEPEC, MEX.",1,0,1,0,0,0,
08/06/2014,TAMPS.,"MATAMOROS, TAMPS.",1,6,7,0,0,0,
08/06/2014,B.C.,"ENSENADA, B.C.",0,1,1,0,0,0,
09/06/2014,D.F.,"AZCAPOTZALCO, D.F.",20,4,24,0,1,0,
09/06/2014,SIN.,"CULIACAN, SIN.",2,6,8,0,3,0,
09/06/2014,TAMPS.,"MATAMOROS, TAMPS.",1,6,7,0,0,0,
09/06/2014,MEX.,"IXTLAHUACA, MEX.",6,1,7,3,0,0,
09/06/2014,SIN.,"CHOIX, SIN.",4,0,4,0,0,0,
09/06/2014,SIN.,"SIN., SIN.",2,2,4,0,0,0,
09/06/2014,OAX.,"OAX. DE JUAREZ, OAX.",0,3,3,0,0,0,
09/06/2014,CHIH.,"CHIH., CHIH.",2,0,2,0,0,17,
09/06/2014,MEX.,"SAN FELIPE DEL PROGRESO, MEX.",2,0,2,0,0,0,
09/06/2014,MEX.,"JILOTEPEC, MEX.",1,1,2,1,1,1,
09/06/2014,MEX.,"ALMOLOYA DE ALQUISIRAS, MEX.",1,1,2,0,0,0,
09/06/2014,HGO.,"TIZAYUCA, HGO.",1,0,1,0,1,0,
09/06/2014,JAL.,"ZAPOPAN, JAL.",1,0,1,0,0,0,
09/06/2014,COAH.,"MÚZQUIZ, COAH.",1,0,1,0,0,0,
09/06/2014,MEX.,"IXTAPAN DE LA SAL, MEX.",0,1,1,0,0,0,
09/06/2014,CHIH.,"CHIH., CHIH.",0,0,0,0,0,0,
10/06/2014,D.F.,"AZCAPOTZALCO, D.F.",29,0,29,0,0,128,
10/06/2014,SIN.,"CHOIX, SIN.",1,16,17,0,1,0,
10/06/2014,SIN.,"SIN., SIN.",5,7,12,0,2,0,
10/06/2014,NAY.,"SANTA MARIA DEL ORO, NAY.",10,0,10,4,0,0,
10/06/2014,SIN.,"CULIACAN, SIN.",6,1,7,0,0,0,
10/06/2014,MEX.,"JILOTEPEC, MEX.",1,4,5,0,0,11,
10/06/2014,MEX.,"IXTLAHUACA, MEX.",0,3,3,0,0,0,
10/06/2014,JAL.,"ZAPOPAN, JAL.",2,0,2,0,0,0,
10/06/2014,COL.,"COL., COL.",2,0,2,2,0,0,
10/06/2014,NAY.,"ACAPONETA, NAY.",2,0,2,0,0,0,
10/06/2014,MEX.,"SAN FELIPE DEL PROGRESO, MEX.",2,0,2,0,0,0,
10/06/2014,MEX.,"ALMOLOYA DE ALQUISIRAS, MEX.",2,0,2,0,0,0,
10/06/2014,OAX.,"OAX. DE JUAREZ, OAX.",1,0,1,1,0,0,
10/06/2014,YUC.,"CHIKINDZONOT, YUC.",0,1,1,0,0,0,
10/06/2014,YUC.,"ACANCEH, YUC.",0,1,1,0,0,0,
10/06/2014,ZAC.,"VILLANUEVA, ZAC.",1,0,1,1,0,10,
10/06/2014,S.L.P.,"SAN LUIS POTOSI, S.L.P.",1,0,1,0,0,27,
10/06/2014,CHIH.,"CHIH., CHIH.",1,0,1,0,0,58,
10/06/2014,SON.,"HERMOSILLO, SON.",0,1,1,0,0,15,
10/06/2014,B.C.,"TECATE, B.C.",0,1,1,0,0,0,
10/06/2014,COAH.,"MONCLOVA, COAH.",1,0,1,0,0,0,
10/06/2014,N.L.,"SANTIAGO, N.L.",0,0,0,1,0,2265,
11/06/2014,D.F.,"AZCAPOTZALCO, D.F.",29,6,35,0,2,210,
11/06/2014,SIN.,"SIN., SIN.",3,8,11,0,12,0,
11/06/2014,MEX.,"IXTLAHUACA, MEX.",7,4,11,0,0,0,
11/06/2014,SIN.,"CULIACAN, SIN.",6,1,7,0,0,0,
11/06/2014,MEX.,"ALMOLOYA DE ALQUISIRAS, MEX.",5,2,7,0,0,0,
11/06/2014,S.L.P.,"MATEHUALA, S.L.P.",4,2,6,0,0,0,
11/06/2014,B.C.,"TIJUANA, B.C.",2,2,4,0,0,0,
11/06/2014,B.C.,"ENSENADA, B.C.",4,0,4,0,0,0,
11/06/2014,MEX.,"SAN FELIPE DEL PROGRESO, MEX.",2,2,4,0,0,0,
11/06/2014,CHIH.,"CHIH., CHIH.",3,0,3,0,0,182,
11/06/2014,YUC.,"ACANCEH, YUC.",1,1,2,0,0,0,
11/06/2014,MEX.,"JILOTEPEC, MEX.",2,0,2,0,0,0,
11/06/2014,COL.,"TECOMÁN, COL.",0,1,1,0,0,0,
11/06/2014,HGO.,"TIZAYUCA, HGO.",0,1,1,0,0,0,
11/06/2014,OAX.,"OAX. DE JUAREZ, OAX.",0,1,1,0,0,0,
11/06/2014,SIN.,"CHOIX, SIN.",1,0,1,0,0,0,
11/06/2014,JAL.,"ZAPOPAN, JAL.",1,0,1,0,0,0,
11/06/2014,N.L.,"LOS ALDAMAS, N.L.",0,0,0,0,0,4,
11/06/2014,PUE.,"PUE., PUE.",0,0,0,0,1,0,
11/06/2014,SON.,"HERMOSILLO, SON.",0,0,0,25,0,832,
11/06/2014,SON.,"CAJEME, SON.",0,0,0,0,0,100,
12/06/2014,D.F.,"AZCAPOTZALCO, D.F.",23,2,25,0,5,814,
12/06/2014,MEX.,"IXTLAHUACA, MEX.",8,8,16,1,0,0,
12/06/2014,MEX.,"SAN FELIPE DEL PROGRESO, MEX.",6,1,7,0,0,0,
12/06/2014,MEX.,"JILOTEPEC, MEX.",3,2,5,0,0,0,
12/06/2014,MEX.,"ALMOLOYA DE ALQUISIRAS, MEX.",2,2,4,1,0,0,
12/06/2014,N.L.,"LOS ALDAMAS, N.L.",1,3,4,4,0,126,
12/06/2014,COAH.,"FRONTERA, COAH.",3,0,3,0,0,0,
12/06/2014,B.C.,"TIJUANA, B.C.",2,0,2,0,0,0,
12/06/2014,S.L.P.,"MATEHUALA, S.L.P.",2,0,2,0,0,36,
12/06/2014,HGO.,"TIZAYUCA, HGO.",1,0,1,0,0,0,
12/06/2014,CHIH.,"CHIH., CHIH.",1,0,1,0,0,150,
12/06/2014,COL.,"COL., COL.",1,0,1,0,0,101,
12/06/2014,ZAC.,"VILLANUEVA, ZAC.",1,0,1,0,0,0,
12/06/2014,N.L.,"BUSTAMANTE, N.L.",0,1,1,1,0,0,
12/06/2014,SON.,"HERMOSILLO, SON.",0,0,0,7,0,663,
13/06/2014,D.F.,"AZCAPOTZALCO, D.F.",20,1,21,0,5,570,
13/06/2014,MEX.,"IXTLAHUACA, MEX.",8,5,13,0,0,85,
13/06/2014,SIN.,"CHOIX, SIN.",0,12,12,0,0,0,
13/06/2014,SIN.,"SIN., SIN.",6,3,9,0,1,0,
13/06/2014,SIN.,"CULIACAN, SIN.",8,1,9,0,0,0,
13/06/2014,S.L.P.,"MATEHUALA, S.L.P.",4,3,7,0,0,276,
13/06/2014,CHIH.,"CHIH., CHIH.",1,5,6,0,0,345,
13/06/2014,NAY.,"ACAPONETA, NAY.",2,3,5,0,0,0,
13/06/2014,MEX.,"JILOTEPEC, MEX.",1,3,4,0,0,0,
13/06/2014,B.C.,"TIJUANA, B.C.",3,0,3,0,0,0,
13/06/2014,B.C.,"ENSENADA, B.C.",2,1,3,0,0,0,
13/06/2014,MEX.,"SAN FELIPE DEL PROGRESO, MEX.",1,2,3,0,0,0,
13/06/2014,HGO.,"TIZAYUCA, HGO.",2,0,2,0,0,236,
13/06/2014,SON.,"CAJEME, SON.",1,1,2,0,0,0,
13/06/2014,CHIH.,"HGO. DEL PARRAL, CHIH.",0,2,2,0,0,0,
13/06/2014,COAH.,"FRONTERA, COAH.",1,1,2,0,0,0,
13/06/2014,COAH.,"TORREÓN, COAH.",2,0,2,0,0,0,
13/06/2014,JAL.,"ZAPOPAN, JAL.",1,0,1,0,0,0,
13/06/2014,COL.,"COL., COL.",1,0,1,0,0,0,
13/06/2014,ZAC.,"VILLANUEVA, ZAC.",0,1,1,0,0,0,
13/06/2014,MEX.,"IXTAPAN DE LA SAL, MEX.",1,0,1,0,0,0,
13/06/2014,MEX.,"ALMOLOYA DE ALQUISIRAS, MEX.",1,0,1,0,0,0,
13/06/2014,NAY.,"SANTA MARIA DEL ORO, NAY.",0,0,0,0,0,0,
14/06/2014,MEX.,"IXTLAHUACA, MEX.",12,11,23,0,2,0,
14/06/2014,MEX.,"JILOTEPEC, MEX.",4,11,15,0,3,0,
14/06/2014,MEX.,"ALMOLOYA DE ALQUISIRAS, MEX.",9,0,9,0,0,0,
14/06/2014,N.L.,"LOS ALDAMAS, N.L.",0,3,3,4,0,42,
14/06/2014,MEX.,"SAN FELIPE DEL PROGRESO, MEX.",2,1,3,0,0,0,
14/06/2014,COL.,"TECOMÁN, COL.",2,0,2,0,0,26,
14/06/2014,OAX.,"OAX. DE JUAREZ, OAX.",1,0,1,1,0,34,
14/06/2014,MEX.,"IXTAPAN DE LA SAL, MEX.",1,0,1,0,0,0,
14/06/2014,N.L.,"BUSTAMANTE, N.L.",0,0,0,9,0,1000,
16/06/2014,D.F.,"VENUSTIANO CARRANZA, D.F.",30,5,35,0,1,200,
16/06/2014,MEX.,"VALLE DE CHALCO SOLIDARIDAD, MEX.",8,0,8,0,0,0,
16/06/2014,N.L.,"LOS ALDAMAS, N.L.",0,5,5,10,0,0,
16/06/2014,NAY.,"ACAPONETA, NAY.",3,2,5,0,0,0,
16/06/2014,SIN.,"SIN., SIN.",1,3,4,0,0,0,
16/06/2014,MEX.,"COACALCO DE BERRIOZABAL, MEX.",3,1,4,1,0,0,
16/06/2014,MEX.,"CUAUTITLAN, MEX.",4,0,4,0,0,0,
16/06/2014,B.C.S.,"LA PAZ, B.C.S.",2,1,3,0,0,0,
16/06/2014,ZAC.,"VILLANUEVA, ZAC.",2,0,2,0,0,0,
16/06/2014,MEX.,"TECAMAC, MEX.",2,0,2,0,0,0,
16/06/2014,OAX.,"OAX. DE JUAREZ, OAX.",0,1,1,0,0,0,
16/06/2014,COL.,"COL., COL.",1,0,1,0,0,0,
16/06/2014,COL.,"COL., COL.",0,1,1,0,0,0,
16/06/2014,CHIH.,"CHIH., CHIH.",0,1,1,0,0,30,
16/06/2014,COAH.,"SALTILLO, COAH.",1,0,1,0,0,0,
16/06/2014,COAH.,"TORREÓN, COAH.",1,0,1,0,0,0,
16/06/2014,MEX.,"TULTITLAN, MEX.",1,0,1,0,0,0,
17/06/2014,D.F.,"VENUSTIANO CARRANZA, D.F.",22,1,23,0,2,120,
17/06/2014,SIN.,"SIN., SIN.",7,3,10,0,4,0,
17/06/2014,N.L.,"LOS ALDAMAS, N.L.",1,4,5,5,0,920,
17/06/2014,MEX.,"TULTITLAN, MEX.",2,3,5,0,0,0,
17/06/2014,B.C.,"TIJUANA, B.C.",2,2,4,0,0,0,
17/06/2014,B.C.S.,"LA PAZ, B.C.S.",0,3,3,0,0,0,
17/06/2014,B.C.,"ENSENADA, B.C.",0,2,2,0,0,0,
17/06/2014,ZAC.,"VILLANUEVA, ZAC.",2,0,2,0,0,0,
17/06/2014,COAH.,"MONCLOVA, COAH.",0,2,2,0,0,0,
17/06/2014,COAH.,"TORREÓN, COAH.",1,1,2,0,0,0,
17/06/2014,MEX.,"TECAMAC, MEX.",2,0,2,0,0,0,
17/06/2014,MEX.,"COACALCO DE BERRIOZABAL, MEX.",2,0,2,0,0,116,
17/06/2014,MEX.,"CUAUTITLAN IZCALLI, MEX.",2,0,2,0,2,0,
17/06/2014,CHIH.,"CHIH., CHIH.",1,0,1,1,0,205,
17/06/2014,YUC.,"TIMUCUY, YUC.",1,0,1,0,0,0,
17/06/2014,COL.,"TECOMÁN, COL.",0,1,1,0,0,0,
17/06/2014,MEX.,"IXTAPALUCA, MEX.",1,0,1,0,0,0,
18/06/2014,D.F.,"VENUSTIANO CARRANZA, D.F.",28,13,41,0,6,2100,
18/06/2014,MEX.,"CUAUTITLAN IZCALLI, MEX.",9,2,11,0,1,149,
18/06/2014,MEX.,"TECAMAC, MEX.",10,0,10,0,0,0,
18/06/2014,SIN.,"SIN., SIN.",5,4,9,0,1,0,
18/06/2014,N.L.,"LOS ALDAMAS, N.L.",2,5,7,7,0,278,
18/06/2014,MEX.,"TULTITLAN, MEX.",4,2,6,0,0,0,
18/06/2014,MEX.,"VALLE DE CHALCO SOLIDARIDAD, MEX.",1,3,4,0,0,0,
18/06/2014,CHIH.,"CHIH., CHIH.",1,2,3,1,0,205,
18/06/2014,MEX.,"IXTAPALUCA, MEX.",2,1,3,0,0,300,
18/06/2014,MEX.,"COACALCO DE BERRIOZABAL, MEX.",2,1,3,0,0,0,
18/06/2014,YUC.,"TIMUCUY, YUC.",2,0,2,0,0,0,
18/06/2014,JAL.,"GUADALAJARA, JAL.",1,1,2,0,0,0,
18/06/2014,HGO.,"TULANCINGO DE BRAVO, HGO.",2,0,2,0,0,0,
18/06/2014,COL.,"COL., COL.",1,0,1,0,0,0,
18/06/2014,NAY.,"LA YESCA, NAY.",0,1,1,0,0,0,
18/06/2014,B.C.,"TIJUANA, B.C.",1,0,1,0,0,0,
18/06/2014,B.C.,"TECATE, B.C.",0,1,1,0,0,0,
18/06/2014,SON.,"HERMOSILLO, SON.",0,0,0,0,0,67,
19/06/2014,D.F.,"VENUSTIANO CARRANZA, D.F.",25,13,38,0,0,375,
19/06/2014,MEX.,"TECAMAC, MEX.",17,3,20,0,1,0,
19/06/2014,MEX.,"VALLE DE CHALCO SOLIDARIDAD, MEX.",8,3,11,0,0,0,
19/06/2014,MEX.,"CUAUTITLAN IZCALLI, MEX.",9,2,11,0,0,0,
19/06/2014,MEX.,"TULTITLAN, MEX.",7,4,11,1,0,5,
19/06/2014,N.L.,"LOS ALDAMAS, N.L.",1,9,10,11,0,0,
19/06/2014,NAY.,"ACAPONETA, NAY.",3,3,6,0,0,0,
19/06/2014,SIN.,"SIN., SIN.",4,0,4,0,0,0,
19/06/2014,CHIH.,"CHIH., CHIH.",3,1,4,0,0,0,
19/06/2014,MEX.,"COACALCO DE BERRIOZABAL, MEX.",1,2,3,0,0,0,
19/06/2014,COL.,"COL., COL.",3,0,3,0,0,0,
19/06/2014,MEX.,"IXTAPALUCA, MEX.",1,1,2,0,2,0,
19/06/2014,B.C.,"TIJUANA, B.C.",1,1,2,0,0,0,
19/06/2014,COAH.,"MÚZQUIZ, COAH.",2,0,2,0,0,0,
19/06/2014,HGO.,"TULANCINGO DE BRAVO, HGO.",1,0,1,0,0,0,
19/06/2014,COAH.,"SALTILLO, COAH.",0,1,1,2,0,40,
19/06/2014,COAH.,"FRONTERA, COAH.",1,0,1,0,0,0,
20/06/2014,D.F.,"VENUSTIANO CARRANZA, D.F.",27,9,36,0,1,150,
20/06/2014,MEX.,"TECAMAC, MEX.",19,11,30,0,1,0,
20/06/2014,MEX.,"CUAUTITLAN IZCALLI, MEX.",11,1,12,0,1,158,
20/06/2014,MEX.,"TULTITLAN, MEX.",8,0,8,0,0,50,
20/06/2014,HGO.,"TULANCINGO DE BRAVO, HGO.",3,4,7,0,0,0,
20/06/2014,MEX.,"VALLE DE CHALCO SOLIDARIDAD, MEX.",6,1,7,0,0,0,
20/06/2014,MEX.,"IXTAPALUCA, MEX.",4,3,7,0,0,0,
20/06/2014,B.C.,"TIJUANA, B.C.",3,2,5,0,0,0,
20/06/2014,B.C.S.,"MULEGÉ, B.C.S.",0,3,3,0,0,0,
20/06/2014,COL.,"COL., COL.",1,1,2,0,0,0,
20/06/2014,CHIH.,"CHIH., CHIH.",1,1,2,0,1,385,
20/06/2014,N.L.,"LOS ALDAMAS, N.L.",0,2,2,0,0,0,
20/06/2014,B.C.S.,"LA PAZ, B.C.S.",0,1,1,0,0,0,
20/06/2014,B.C.S.,"COMONDÚ, B.C.S.",1,0,1,0,0,0,
20/06/2014,JAL.,"ZAPOPAN, JAL.",0,1,1,0,0,0,
20/06/2014,COAH.,"SALTILLO, COAH.",1,0,1,1,0,19,
20/06/2014,SON.,"HERMOSILLO, SON.",0,0,0,0,0,10,
21/06/2014,MEX.,"TECAMAC, MEX.",15,5,20,0,0,0,
21/06/2014,MEX.,"IXTAPALUCA, MEX.",10,3,13,0,0,0,
21/06/2014,MEX.,"CUAUTITLAN IZCALLI, MEX.",9,4,13,0,0,0,
21/06/2014,MEX.,"TULTITLAN, MEX.",12,1,13,0,0,0,
21/06/2014,TAMPS.,"MATAMOROS, TAMPS.",4,8,12,0,0,0,
21/06/2014,B.C.S.,"MULEGÉ, B.C.S.",0,3,3,0,0,0,
21/06/2014,MEX.,"COACALCO DE BERRIOZABAL, MEX.",3,0,3,0,0,0,
21/06/2014,HGO.,"TULANCINGO DE BRAVO, HGO.",1,1,2,0,0,0,
21/06/2014,B.C.,"TIJUANA, B.C.",2,0,2,0,0,0,
21/06/2014,MEX.,"VALLE DE CHALCO SOLIDARIDAD, MEX.",2,0,2,0,0,0,
21/06/2014,B.C.S.,"LA PAZ, B.C.S.",1,0,1,0,0,0,
21/06/2014,SON.,"ALTAR, SON.",1,0,1,0,0,0,
21/06/2014,B.C.,"ENSENADA, B.C.",0,1,1,0,0,0,
21/06/2014,SON.,"HERMOSILLO, SON.",0,0,0,2,0,84,
22/06/2014,TAMPS.,"MATAMOROS, TAMPS.",2,8,10,0,0,0,
22/06/2014,B.C.S.,"MULEGÉ, B.C.S.",0,3,3,0,0,0,
23/06/2014,D.F.,"VENUSTIANO CARRANZA, D.F.",22,2,24,0,0,50,
23/06/2014,MEX.,"TLALNEPANTLA DE BAZ, MEX.",11,4,15,1,3,137,
23/06/2014,SIN.,"SIN., SIN.",1,7,8,0,0,0,
23/06/2014,MEX.,"ECATEPEC DE MOR., MEX.",7,1,8,0,2,0,
23/06/2014,NAY.,"ACAPONETA, NAY.",2,1,3,0,0,0,
23/06/2014,B.C.S.,"COMONDÚ, B.C.S.",1,1,2,0,0,0,
23/06/2014,CHIH.,"CHIH., CHIH.",0,2,2,0,0,0,
23/06/2014,COAH.,"MONCLOVA, COAH.",1,1,2,0,0,0,
23/06/2014,COAH.,"TORREÓN, COAH.",2,0,2,0,0,0,
23/06/2014,COAH.,"SALTILLO, COAH.",2,0,2,0,0,68,
23/06/2014,MEX.,"CHALCO, MEX.",1,1,2,0,0,0,
23/06/2014,B.C.S.,"LA PAZ, B.C.S.",1,0,1,0,0,0,
23/06/2014,N.L.,"SALINAS VICTORIA, N.L.",1,0,1,10,0,3135,
23/06/2014,B.C.,"TIJUANA, B.C.",0,1,1,0,0,0,
23/06/2014,NAY.,"LA YESCA, NAY.",1,0,1,0,0,0,
23/06/2014,ZAC.,"VILLANUEVA, ZAC.",0,0,0,0,0,25,
23/06/2014,N.L.,"MONTEMOR., N.L.",0,0,0,0,0,1415,
24/06/2014,D.F.,"VENUSTIANO CARRANZA, D.F.",27,3,30,0,2,120,
24/06/2014,MEX.,"ECATEPEC DE MOR., MEX.",14,4,18,0,5,0,
24/06/2014,MEX.,"TLALNEPANTLA DE BAZ, MEX.",9,3,12,0,0,500,
24/06/2014,SIN.,"SIN., SIN.",1,10,11,0,0,0,
24/06/2014,MEX.,"CHALCO, MEX.",7,4,11,0,1,0,
24/06/2014,NAY.,"ACAPONETA, NAY.",3,2,5,0,0,0,
24/06/2014,SIN.,"NAVOLATO, SIN.",3,1,4,0,0,0,
24/06/2014,CHIH.,"CHIH., CHIH.",1,2,3,2,0,182,
24/06/2014,COAH.,"PIEDRAS NEGRAS, COAH.",0,2,2,0,0,0,
24/06/2014,B.C.,"ENSENADA, B.C.",0,1,1,0,0,0,
24/06/2014,N.L.,"SALINAS VICTORIA, N.L.",0,1,1,12,0,100,
24/06/2014,ZAC.,"VILLANUEVA, ZAC.",0,1,1,0,0,0,
24/06/2014,COL.,"COL., COL.",1,0,1,0,0,0,
24/06/2014,YUC.,"TECOH, YUC.",1,0,1,0,0,0,
24/06/2014,YUC.,"SOTUTA, YUC.",0,1,1,0,0,0,
24/06/2014,SON.,"HERMOSILLO, SON.",0,0,0,22,0,0,
24/06/2014,COAH.,"SALTILLO, COAH.",0,0,0,2,0,223,
24/06/2014,N.L.,"MONTEMOR., N.L.",0,0,0,1,0,850,
24/06/2014,HGO.,"TULANCINGO DE BRAVO, HGO.",0,0,0,0,1,0,
25/06/2014,D.F.,"VENUSTIANO CARRANZA, D.F.",24,4,28,0,6,0,
25/06/2014,MEX.,"ECATEPEC DE MOR., MEX.",16,8,24,0,8,0,
25/06/2014,MEX.,"CHALCO, MEX.",12,5,17,1,0,53,
25/06/2014,SIN.,"NAVOLATO, SIN.",4,2,6,0,0,0,
25/06/2014,SIN.,"SIN., SIN.",0,6,6,0,4,0,
25/06/2014,B.C.,"TIJUANA, B.C.",3,3,6,0,0,0,
25/06/2014,MEX.,"TLALNEPANTLA DE BAZ, MEX.",4,0,4,1,0,75,
25/06/2014,CHIH.,"CHIH., CHIH.",0,3,3,0,0,0,
25/06/2014,ZAC.,"VILLANUEVA, ZAC.",1,1,2,0,0,0,
25/06/2014,SON.,"HERMOSILLO, SON.",1,1,2,0,0,401,
25/06/2014,COAH.,"FRONTERA, COAH.",1,1,2,0,0,0,
25/06/2014,COAH.,"MÚZQUIZ, COAH.",2,0,2,0,0,0,
25/06/2014,SIN.,"SAN IGNACIO, SIN.",0,1,1,0,0,0,
25/06/2014,COAH.,"PIEDRAS NEGRAS, COAH.",0,1,1,0,0,0,
25/06/2014,COAH.,"TORREÓN, COAH.",1,0,1,0,0,0,
25/06/2014,HGO.,"TULANCINGO DE BRAVO, HGO.",0,0,0,0,1,0,
25/06/2014,CHIH.,"CHIH., CHIH.",0,0,0,30,0,0,
25/06/2014,COAH.,"ACUÑA, COAH.",0,0,0,0,0,67,
26/06/2014,D.F.,"VENUSTIANO CARRANZA, D.F.",26,14,40,0,5,400,
26/06/2014,MEX.,"ECATEPEC DE MOR., MEX.",25,7,32,32,1,0,
26/06/2014,MEX.,"TLALNEPANTLA DE BAZ, MEX.",22,4,26,2,0,72,
26/06/2014,MEX.,"CHALCO, MEX.",5,2,7,0,0,72,
26/06/2014,SIN.,"SIN., SIN.",2,3,5,0,0,0,
26/06/2014,COAH.,"MONCLOVA, COAH.",1,2,3,0,0,0,
26/06/2014,SIN.,"NAVOLATO, SIN.",2,0,2,0,0,0,
26/06/2014,N.L.,"SALINAS VICTORIA, N.L.",0,1,1,0,0,0,
26/06/2014,SIN.,"SAN IGNACIO, SIN.",1,0,1,0,0,0,
26/06/2014,COL.,"COL., COL.",1,0,1,0,0,0,
26/06/2014,NAY.,"ACAPONETA, NAY.",1,0,1,0,0,0,
26/06/2014,COAH.,"TORREÓN, COAH.",1,0,1,0,0,0,
26/06/2014,COL.,"COL., COL.",1,0,1,0,0,0,
26/06/2014,COL.,"TECOMÁN, COL.",1,0,1,0,0,0,
26/06/2014,N.L.,"MONTEMOR., N.L.",0,0,0,8,0,3602,
26/06/2014,ZAC.,"VILLANUEVA, ZAC.",0,0,0,0,0,129,
27/06/2014,D.F.,"VENUSTIANO CARRANZA, D.F.",49,4,53,0,8,180,
27/06/2014,MEX.,"TLALNEPANTLA DE BAZ, MEX.",21,8,29,0,0,0,
27/06/2014,MEX.,"ECATEPEC DE MOR., MEX.",17,4,21,0,1,0,
27/06/2014,MEX.,"CHALCO, MEX.",12,5,17,0,8,0,
27/06/2014,TAMPS.,"MATAMOROS, TAMPS.",5,6,11,0,0,0,
27/06/2014,SIN.,"SIN., SIN.",3,4,7,0,5,0,
27/06/2014,HGO.,"TULANCINGO DE BRAVO, HGO.",3,0,3,0,0,0,
27/06/2014,COAH.,"MÚZQUIZ, COAH.",3,0,3,0,0,64,
27/06/2014,CHIH.,"CHIH., CHIH.",3,0,3,1,0,534,
27/06/2014,COAH.,"PIEDRAS NEGRAS, COAH.",0,2,2,0,0,0,
27/06/2014,SIN.,"NAVOLATO, SIN.",1,1,2,0,0,0,
27/06/2014,PUE.,"PUE., PUE.",2,0,2,1,0,6,
27/06/2014,COAH.,"TORREÓN, COAH.",1,0,1,0,0,0,
27/06/2014,COAH.,"MONCLOVA, COAH.",1,0,1,0,0,0,
27/06/2014,SIN.,"SAN IGNACIO, SIN.",0,1,1,0,1,0,
27/06/2014,SON.,"HERMOSILLO, SON.",1,0,1,7,0,0,
27/06/2014,N.L.,"MONTEMOR., N.L.",0,0,0,5,0,2660,
28/06/2014,MEX.,"TLALNEPANTLA DE BAZ, MEX.",21,8,29,0,0,0,
28/06/2014,MEX.,"ECATEPEC DE MOR., MEX.",17,0,17,0,8,0,
28/06/2014,MEX.,"CHALCO, MEX.",5,1,6,0,0,0,
28/06/2014,B.C.,"TIJUANA, B.C.",2,1,3,0,0,0,
28/06/2014,B.C.,"ENSENADA, B.C.",1,2,3,0,0,0,
28/06/2014,HGO.,"TULANCINGO DE BRAVO, HGO.",0,2,2,0,1,40,
28/06/2014,N.L.,"MONTEMOR., N.L.",0,0,0,2,0,2950,
28/06/2014,N.L.,"SALINAS VICTORIA, N.L.",0,0,0,5,0,141,
28/06/2014,SON.,"HERMOSILLO, SON.",0,0,0,11,0,0,
30/06/2014,D.F.,"LA MAGDALENA CONTRERAS, D.F.",10,1,11,0,1,300,
30/06/2014,SIN.,"NAVOLATO, SIN.",2,3,5,0,3,0,
30/06/2014,B.C.,"TIJUANA, B.C.",2,3,5,0,0,0,
30/06/2014,COL.,"TECOMÁN, COL.",1,0,1,5,0,0,
30/06/2014,N.L.,"MONTEMOR., N.L.",0,0,0,0,0,50,
30/06/2014,N.L.,"SALINAS VICTORIA, N.L.",0,0,0,2,0,100,
30/06/2014,COAH.,"MÚZQUIZ, COAH.",0,0,0,2,2,188,
01/07/2014,D.F.,"LA MAGDALENA CONTRERAS, D.F.",23,0,23,0,0,450,
01/07/2014,NAY.,"ACAPONETA, NAY.",3,1,4,0,0,0,
01/07/2014,SIN.,"SAN IGNACIO, SIN.",2,0,2,0,0,0,
01/07/2014,SIN.,"NAVOLATO, SIN.",1,0,1,0,0,0,
01/07/2014,N.L.,"HUALAHUISES, N.L.",0,1,1,0,0,0,
02/07/2014,D.F.,"LA MAGDALENA CONTRERAS, D.F.",26,1,27,0,0,100,
02/07/2014,B.C.,"TIJUANA, B.C.",1,5,6,0,0,0,
02/07/2014,COAH.,"MÚZQUIZ, COAH.",2,0,2,2,2,176,
02/07/2014,Q. ROO,"OTHON P. BLANCO, Q. ROO",2,0,2,0,0,209,
02/07/2014,PUE.,"PUE., PUE.",1,0,1,0,0,0,
02/07/2014,N.L.,"HUALAHUISES, N.L.",0,0,0,11,0,100,
02/07/2014,ZAC.,"VILLANUEVA, ZAC.",0,0,0,2,0,0,
03/07/2014,D.F.,"LA MAGDALENA CONTRERAS, D.F.",18,11,29,0,6,70,
03/07/2014,SIN.,"NAVOLATO, SIN.",3,4,7,0,0,0,
03/07/2014,SIN.,"SAN IGNACIO, SIN.",0,1,1,0,0,0,
03/07/2014,NAY.,"LA YESCA, NAY.",0,1,1,0,0,0,
03/07/2014,B.C.S.,"MULEGÉ, B.C.S.",0,1,1,0,0,0,
03/07/2014,CHIS.,"ARRIAGA, CHIS.",0,0,0,0,0,7,
03/07/2014,SON.,"HERMOSILLO, SON.",0,0,0,9,0,50,
04/07/2014,D.F.,"LA MAGDALENA CONTRERAS, D.F.",14,17,31,0,0,700,
04/07/2014,TAMPS.,"MATAMOROS, TAMPS.",17,11,28,0,0,0,
04/07/2014,SIN.,"NAVOLATO, SIN.",3,0,3,0,5,0,
04/07/2014,SIN.,"SAN IGNACIO, SIN.",1,1,2,0,0,0,
04/07/2014,Q. ROO,"OTHON P. BLANCO, Q. ROO",1,0,1,1,0,0,
04/07/2014,B.C.,"TIJUANA, B.C.",0,1,1,0,0,0,
04/07/2014,B.C.,"ENSENADA, B.C.",1,0,1,0,0,0,
04/07/2014,ZAC.,"VILLANUEVA, ZAC.",0,0,0,1,0,0,
04/07/2014,N.L.,"CARMEN, N.L.",0,0,0,56,0,252,
05/07/2014,COL.,"COL., COL.",2,0,2,0,0,150,
05/07/2014,HGO.,"NOPALA DE VILLAGRAN, HGO.",1,0,1,0,0,0,
05/07/2014,N.L.,"CARMEN, N.L.",1,0,1,17,0,3680,
05/07/2014,SON.,"CAJEME, SON.",0,1,1,1,0,0,
05/07/2014,N.L.,"HUALAHUISES, N.L.",0,0,0,7,0,100,
05/07/2014,SON.,"HERMOSILLO, SON.",0,0,0,22,0,0,
06/07/2014,B.C.,"TECATE, B.C.",1,1,2,0,0,0,
06/07/2014,N.L.,"HUALAHUISES, N.L.",1,0,1,0,0,0,
06/07/2014,B.C.S.,"MULEGÉ, B.C.S.",0,1,1,0,0,0,
06/07/2014,CHIS.,"ARRIAGA, CHIS.",0,0,0,0,0,94,
06/07/2014,N.L.,"CARMEN, N.L.",0,0,0,8,0,613,
07/07/2014,HGO.,"NOPALA DE VILLAGRAN, HGO.",0,2,2,0,0,0,
07/07/2014,Q. ROO,"OTHON P. BLANCO, Q. ROO",1,0,1,0,0,0,
07/07/2014,B.C.,"TIJUANA, B.C.",1,0,1,0,0,0,
07/07/2014,N.L.,"HUALAHUISES, N.L.",0,0,0,12,0,0,
08/07/2014,D.F.,"ALVARO OBREGON, D.F.",28,6,34,0,3,180,
08/07/2014,B.C.,"TIJUANA, B.C.",7,0,7,0,0,0,
08/07/2014,CHIS.,"ARRIAGA, CHIS.",0,2,2,0,0,39,
08/07/2014,JAL.,"TLAQUEPAQUE, JAL.",1,0,1,1,0,5,
08/07/2014,YUC.,"TIXKOKOB, YUC.",1,0,1,0,0,0,
08/07/2014,COAH.,"MONCLOVA, COAH.",1,0,1,0,0,0,
08/07/2014,COAH.,"TORREÓN, COAH.",1,0,1,0,0,0,
08/07/2014,PUE.,"PUE., PUE.",1,0,1,1,0,0,
08/07/2014,N.L.,"HUALAHUISES, N.L.",0,1,1,14,0,0,
08/07/2014,ZAC.,"FRESNILLO, ZAC.",0,1,1,0,0,0,
08/07/2014,B.C.,"TIJUANA, B.C.",1,0,1,0,0,0,
09/07/2014,D.F.,"ALVARO OBREGON, D.F.",25,3,28,0,9,100,
09/07/2014,Q. ROO,"OTHON P. BLANCO, Q. ROO",4,1,5,0,0,118,
09/07/2014,CHIS.,"ARRIAGA, CHIS.",1,1,2,2,0,222,
09/07/2014,COAH.,"SALTILLO, COAH.",1,0,1,1,0,0,
09/07/2014,ZAC.,"VILLANUEVA, ZAC.",1,0,1,0,0,200,
09/07/2014,ZAC.,"VALPARAISO, ZAC.",0,1,1,0,0,0,
09/07/2014,N.L.,"CARMEN, N.L.",0,0,0,2,0,2400,
09/07/2014,N.L.,"HUALAHUISES, N.L.",0,0,0,8,0,100,
09/07/2014,PUE.,"PUE., PUE.",0,0,0,0,0,285,
09/07/2014,SON.,"HERMOSILLO, SON.",0,0,0,0,0,26,
10/07/2014,D.F.,"ALVARO OBREGON, D.F.",35,15,50,0,1,0,
10/07/2014,NAY.,"ACAPONETA, NAY.",5,1,6,0,0,0,
10/07/2014,CHIS.,"ARRIAGA, CHIS.",1,1,2,1,0,149,
10/07/2014,COAH.,"SALTILLO, COAH.",1,0,1,0,0,0,
10/07/2014,COAH.,"MONCLOVA, COAH.",1,0,1,0,0,0,
10/07/2014,N.L.,"HUALAHUISES, N.L.",1,0,1,1,0,88,
10/07/2014,PUE.,"PUE., PUE.",1,0,1,0,0,110,
10/07/2014,B.C.,"TIJUANA, B.C.",0,1,1,0,0,0,
10/07/2014,CHIH.,"CHIH., CHIH.",1,0,1,0,0,0,
10/07/2014,N.L.,"CARMEN, N.L.",0,0,0,2,0,2895,
10/07/2014,SON.,"HERMOSILLO, SON.",0,0,0,0,0,366,
11/07/2014,D.F.,"ALVARO OBREGON, D.F.",32,8,40,0,1,290,
11/07/2014,CHIH.,"JUÁREZ, CHIH.",7,4,11,0,0,0,
11/07/2014,NAY.,"ACAPONETA, NAY.",4,4,8,0,0,0,
11/07/2014,TAMPS.,"MATAMOROS, TAMPS.",4,0,4,0,0,0,
11/07/2014,N.L.,"LOS HERRERAS, N.L.",0,4,4,0,0,300,
11/07/2014,TAMPS.,"MATAMOROS, TAMPS.",4,0,4,0,0,0,
11/07/2014,SON.,"CAJEME, SON.",1,2,3,0,0,22,
11/07/2014,COAH.,"MÚZQUIZ, COAH.",1,2,3,0,0,0,
11/07/2014,COL.,"COL., COL.",0,1,1,0,0,0,
11/07/2014,COAH.,"TORREÓN, COAH.",1,0,1,0,0,0,
11/07/2014,ZAC.,"VALPARAISO, ZAC.",0,1,1,0,0,0,
12/07/2014,CHIH.,"JUÁREZ, CHIH.",26,11,37,0,0,0,
12/07/2014,N.L.,"LOS HERRERAS, N.L.",1,2,3,1,0,65,
12/07/2014,SON.,"CAJEME, SON.",1,1,2,1,0,0,
12/07/2014,TAMPS.,"MATAMOROS, TAMPS.",1,1,2,0,0,0,
12/07/2014,SON.,"HERMOSILLO, SON.",0,0,0,24,0,0,
13/07/2014,N.L.,"LOS HERRERAS, N.L.",0,1,1,0,0,0,
14/07/2014,D.F.,"GUSTAVO A. MADERO, D.F.",25,3,28,0,1,80,
14/07/2014,B.C.,"TIJUANA, B.C.",1,6,7,0,0,0,
14/07/2014,CHIH.,"JUÁREZ, CHIH.",4,3,7,0,0,0,
14/07/2014,QRO.,"QUERETARO, QRO.",2,2,4,0,0,0,
14/07/2014,COAH.,"MONCLOVA, COAH.",1,2,3,0,0,0,
14/07/2014,COAH.,"TORREÓN, COAH.",2,0,2,0,0,0,
14/07/2014,COL.,"TECOMÁN, COL.",1,1,2,0,0,0,
14/07/2014,COAH.,"PIEDRAS NEGRAS, COAH.",1,0,1,0,0,0,
14/07/2014,CHIH.,"MEOQUI, CHIH.",1,0,1,0,0,0,
15/07/2014,D.F.,"GUSTAVO A. MADERO, D.F.",31,3,34,0,4,200,
15/07/2014,CHIH.,"JUÁREZ, CHIH.",14,9,23,0,0,0,
15/07/2014,QRO.,"QUERETARO, QRO.",7,2,9,0,5,0,
15/07/2014,QRO.,"QUERETARO, QRO.",0,5,5,0,3,0,
15/07/2014,COAH.,"MÚZQUIZ, COAH.",2,2,4,0,0,0,
15/07/2014,N.L.,"LOS HERRERAS, N.L.",1,1,2,2,0,130,
15/07/2014,COAH.,"PIEDRAS NEGRAS, COAH.",1,1,2,0,0,0,
15/07/2014,N.L.,"ANAHUAC, N.L.",0,1,1,0,0,0,
15/07/2014,B.C.,"TECATE, B.C.",0,1,1,0,0,0,
15/07/2014,CHIH.,"MEOQUI, CHIH.",0,1,1,0,0,0,
15/07/2014,ZAC.,"FRESNILLO, ZAC.",0,1,1,0,0,0,
16/07/2014,D.F.,"VENUSTIANO CARRANZA, D.F.",32,2,34,0,8,50,
16/07/2014,QRO.,"QUERETARO, QRO.",1,3,4,0,5,0,
16/07/2014,SON.,"CAJEME, SON.",1,0,1,0,0,0,
17/07/2014,D.F.,"GUSTAVO A. MADERO, D.F.",37,12,49,0,9,0,
17/07/2014,CHIH.,"JUÁREZ, CHIH.",4,4,8,0,0,0,
17/07/2014,QRO.,"QUERETARO, QRO.",0,5,5,0,3,0,
17/07/2014,QRO.,"QUERETARO, QRO.",5,0,5,0,7,0,
17/07/2014,QRO.,"QUERETARO, QRO.",3,1,4,0,5,0,
17/07/2014,COAH.,"MÚZQUIZ, COAH.",1,2,3,0,0,0,
17/07/2014,N.L.,"ANAHUAC, N.L.",1,1,2,2,0,0,
17/07/2014,COAH.,"MONCLOVA, COAH.",1,0,1,0,0,0,
17/07/2014,ZAC.,"FRESNILLO, ZAC.",0,1,1,0,0,0,
17/07/2014,JAL.,"TLAQUEPAQUE, JAL.",0,1,1,0,0,0,
17/07/2014,COL.,"COL., COL.",0,0,0,8,0,225,
17/07/2014,N.L.,"LOS HERRERAS, N.L.",0,0,0,2,0,535,
18/07/2014,D.F.,"GUSTAVO A. MADERO, D.F.",40,7,47,0,16,0,
18/07/2014,N.L.,"ANAHUAC, N.L.",4,5,9,0,0,50,
18/07/2014,QRO.,"QUERETARO, QRO.",5,4,9,0,7,0,
18/07/2014,B.C.,"TIJUANA, B.C.",2,2,4,0,0,0,
18/07/2014,CHIH.,"JUÁREZ, CHIH.",1,3,4,0,0,0,
18/07/2014,JAL.,"TLAQUEPAQUE, JAL.",0,2,2,0,0,0,
18/07/2014,COAH.,"MONCLOVA, COAH.",1,1,2,20,0,0,
18/07/2014,SON.,"CAJEME, SON.",2,0,2,0,0,0,
18/07/2014,N.L.,"LOS HERRERAS, N.L.",0,1,1,0,0,150,
18/07/2014,COAH.,"PIEDRAS NEGRAS, COAH.",0,1,1,0,0,0,
18/07/2014,COAH.,"SALTILLO, COAH.",0,0,0,177,0,0,
18/07/2014,COL.,"COL., COL.",0,0,0,0,0,13,
19/07/2014,CHIH.,"JUÁREZ, CHIH.",14,8,22,0,0,0,
19/07/2014,TAMPS.,"MATAMOROS, TAMPS.",9,2,11,0,0,128,
19/07/2014,N.L.,"ANAHUAC, N.L.",3,8,11,0,0,50,
19/07/2014,QRO.,"QUERETARO, QRO.",0,6,6,0,6,0,
19/07/2014,N.L.,"LOS HERRERAS, N.L.",0,2,2,2,0,0,
19/07/2014,B.C.,"TIJUANA, B.C.",1,1,2,0,0,0,
19/07/2014,B.C.S.,"LA PAZ, B.C.S.",0,1,1,0,0,0,
20/07/2014,CHIH.,"JUÁREZ, CHIH.",15,6,21,0,0,0,
20/07/2014,TAMPS.,"MATAMOROS, TAMPS.",3,5,8,0,0,0,
20/07/2014,N.L.,"ANAHUAC, N.L.",0,1,1,0,0,100,
21/07/2014,D.F.,"GUSTAVO A. MADERO, D.F.",38,0,38,0,11,200,
21/07/2014,CHIH.,"JUÁREZ, CHIH.",9,2,11,0,0,0,
21/07/2014,QRO.,"QUERETARO, QRO.",7,2,9,0,8,0,
21/07/2014,SON.,"CAJEME, SON.",0,1,1,0,0,0,
22/07/2014,D.F.,"GUSTAVO A. MADERO, D.F.",47,11,58,0,7,180,
22/07/2014,CHIH.,"JUÁREZ, CHIH.",8,7,15,0,0,0,
22/07/2014,QRO.,"QUERETARO, QRO.",8,1,9,0,0,0,
22/07/2014,B.C.,"TECATE, B.C.",0,2,2,0,0,0,
22/07/2014,JAL.,"GUADALAJARA, JAL.",1,0,1,0,0,0,
22/07/2014,COAH.,"SALTILLO, COAH.",0,0,0,0,0,120,
23/07/2014,D.F.,"GUSTAVO A. MADERO, D.F.",43,4,47,0,14,50,
23/07/2014,CHIH.,"JUÁREZ, CHIH.",8,6,14,0,0,0,
23/07/2014,NAY.,"JALA, NAY.",2,7,9,0,0,0,
23/07/2014,QRO.,"QUERETARO, QRO.",4,5,9,0,5,0,
23/07/2014,QRO.,"QUERETARO, QRO.",5,4,9,0,5,0,
23/07/2014,COAH.,"MONCLOVA, COAH.",3,2,5,0,0,0,
23/07/2014,COAH.,"TORREÓN, COAH.",2,0,2,0,0,0,
23/07/2014,CHIH.,"MEOQUI, CHIH.",1,0,1,0,0,0,
23/07/2014,N.L.,"ABASOLO, N.L.",0,1,1,5,0,2294,
23/07/2014,N.L.,"MINA, N.L.",0,1,1,0,0,0,
24/07/2014,D.F.,"GUSTAVO A. MADERO, D.F.",53,16,69,0,7,70,
24/07/2014,NAY.,"JALA, NAY.",0,4,4,0,0,0,
24/07/2014,SON.,"CAJEME, SON.",1,2,3,1,0,0,
24/07/2014,CHIS.,"CINTALAPA, CHIS.",2,0,2,0,0,0,
24/07/2014,COAH.,"TORREÓN, COAH.",2,0,2,0,0,0,
24/07/2014,N.L.,"ABASOLO, N.L.",1,0,1,0,0,1450,
25/07/2014,D.F.,"GUSTAVO A. MADERO, D.F.",56,10,66,0,13,100,
25/07/2014,CHIH.,"JUÁREZ, CHIH.",6,5,11,0,0,0,
25/07/2014,TAMPS.,"MATAMOROS, TAMPS.",6,0,6,3,0,50,
25/07/2014,NAY.,"JALA, NAY.",0,3,3,0,0,0,
25/07/2014,COAH.,"PIEDRAS NEGRAS, COAH.",2,0,2,0,0,0,
25/07/2014,B.C.S.,"LA PAZ, B.C.S.",1,1,2,0,0,0,
25/07/2014,N.L.,"MINA, N.L.",0,2,2,0,0,0,
25/07/2014,COAH.,"TORREÓN, COAH.",1,0,1,0,0,0,
25/07/2014,COAH.,"MONCLOVA, COAH.",1,0,1,0,0,0,
25/07/2014,JAL.,"ZAPOPAN, JAL.",1,0,1,0,0,0,
25/07/2014,N.L.,"ABASOLO, N.L.",1,0,1,3,0,2397,
25/07/2014,CHIH.,"CHIH., CHIH.",1,0,1,1,0,1,
25/07/2014,CHIH.,"MEOQUI, CHIH.",0,0,0,0,0,19,
26/07/2014,CHIH.,"JUÁREZ, CHIH.",2,8,10,0,0,0,
26/07/2014,AGS.,"EL LLANO, AGS.",3,2,5,2,0,12,
26/07/2014,B.C.,"TIJUANA, B.C.",3,0,3,0,0,0,
26/07/2014,B.C.S.,"MULEGÉ, B.C.S.",0,2,2,0,0,0,
26/07/2014,B.C.,"TIJUANA, B.C.",2,0,2,0,0,0,
26/07/2014,TAMPS.,"MATAMOROS, TAMPS.",1,0,1,0,0,0,
26/07/2014,N.L.,"ABASOLO, N.L.",0,0,0,4,0,1450,
27/07/2014,CHIH.,"JUÁREZ, CHIH.",7,3,10,0,0,0,
27/07/2014,N.L.,"ABASOLO, N.L.",0,0,0,66,0,2870,
28/07/2014,CHIH.,"JUÁREZ, CHIH.",4,3,7,0,0,0,
28/07/2014,SON.,"CAJEME, SON.",1,1,2,1,0,14,
28/07/2014,CHIS.,"CINTALAPA, CHIS.",0,1,1,0,0,30,
28/07/2014,N.L.,"ABASOLO, N.L.",0,0,0,53,0,2240,
29/07/2014,D.F.,"XOCHIMILCO, D.F.",36,7,43,0,1,10,
29/07/2014,CHIH.,"JUÁREZ, CHIH.",8,7,15,0,0,0,
29/07/2014,B.C.,"TIJUANA, B.C.",5,3,8,0,0,0,
29/07/2014,NAY.,"JALA, NAY.",0,6,6,0,0,0,
29/07/2014,JAL.,"GUADALAJARA, JAL.",2,1,3,0,0,0,
29/07/2014,CAMP.,"CAMP., CAMP.",0,1,1,0,0,0,
29/07/2014,COL.,"COL., COL.",1,0,1,0,0,0,
29/07/2014,N.L.,"ABASOLO, N.L.",0,0,0,28,0,870,
30/07/2014,CHIH.,"JUÁREZ, CHIH.",6,4,10,0,0,0,
30/07/2014,NAY.,"ACAPONETA, NAY.",3,3,6,0,0,0,
30/07/2014,JAL.,"GUADALAJARA, JAL.",2,2,4,0,0,0,
30/07/2014,YUC.,"YAXKUKUL, YUC.",1,2,3,0,0,0,
30/07/2014,B.C.,"TECATE, B.C.",1,2,3,0,0,0,
30/07/2014,COL.,"COL., COL.",2,0,2,1,0,0,
30/07/2014,B.C.S.,"MULEGÉ, B.C.S.",0,1,1,0,0,0,
30/07/2014,SON.,"HERMOSILLO, SON.",0,0,0,0,0,36,
30/07/2014,N.L.,"ABASOLO, N.L.",0,0,0,65,0,1474,
30/07/2014,N.L.,"MINA, N.L.",0,0,0,2,0,0,
31/07/2014,CHIH.,"JUÁREZ, CHIH.",11,4,15,0,1,0,
31/07/2014,NAY.,"JALA, NAY.",5,2,7,0,0,0,
31/07/2014,COL.,"COL., COL.",2,0,2,0,0,0,
31/07/2014,CAMP.,"CAMP., CAMP.",2,0,2,0,0,0,
31/07/2014,B.C.S.,"MULEGÉ, B.C.S.",0,1,1,0,0,0,
31/07/2014,ZAC.,"VILLANUEVA, ZAC.",0,1,1,0,0,18,
31/07/2014,JAL.,"GUADALAJARA, JAL.",1,0,1,0,0,4,
31/07/2014,PUE.,"TETELA DE OCAMPO, PUE.",1,0,1,0,0,0,
31/07/2014,N.L.,"CERRALVO, N.L.",0,1,1,32,0,1725,
31/07/2014,COAH.,"SALTILLO, COAH.",1,0,1,0,0,0,
01/08/2014,CHIH.,"JUÁREZ, CHIH.",4,7,11,0,0,0,
01/08/2014,TAMPS.,"MATAMOROS, TAMPS.",9,0,9,0,0,0,
01/08/2014,B.C.,"TECATE, B.C.",6,0,6,0,0,0,
01/08/2014,COAH.,"PIEDRAS NEGRAS, COAH.",5,0,5,0,0,0,
01/08/2014,SON.,"CAJEME, SON.",2,0,2,0,0,0,
01/08/2014,B.C.,"MEXICALI, B.C.",1,0,1,0,0,0,
01/08/2014,N.L.,"CERRALVO, N.L.",1,0,1,34,0,2882,
01/08/2014,N.L.,"DR. ARROYO, N.L.",1,0,1,2,0,0,
01/08/2014,VER.,"COATZACOALCOS, VER.",1,0,1,0,0,0,
01/08/2014,COAH.,"SALTILLO, COAH.",0,0,0,0,0,59,
01/08/2014,COAH.,"ACUÑA, COAH.",0,0,0,0,0,60,
02/08/2014,CHIH.,"JUÁREZ, CHIH.",4,3,7,0,4,0,
02/08/2014,AGS.,"EL LLANO, AGS.",3,0,3,13,0,312,
02/08/2014,B.C.,"TIJUANA, B.C.",1,1,2,0,0,0,
02/08/2014,N.L.,"CERRALVO, N.L.",0,0,0,4,0,490,
02/08/2014,N.L.,"DR. ARROYO, N.L.",0,0,0,1,0,50,
02/08/2014,SON.,"HERMOSILLO, SON.",0,0,0,0,0,374,
03/08/2014,CHIH.,"JUÁREZ, CHIH.",4,1,5,0,0,0,
03/08/2014,N.L.,"DR. ARROYO, N.L.",1,0,1,1,0,0,
03/08/2014,N.L.,"CERRALVO, N.L.",0,0,0,2,0,150,
04/08/2014,SIN.,"MAZATLAN, SIN.",3,1,4,0,0,0,
04/08/2014,B.C.,"TIJUANA, B.C.",0,3,3,0,0,0,
04/08/2014,VER.,"COATZACOALCOS, VER.",2,0,2,0,0,0,
04/08/2014,SON.,"HERMOSILLO, SON.",0,0,0,36,0,0,
05/08/2014,SIN.,"MAZATLAN, SIN.",17,5,22,0,7,0,
05/08/2014,B.C.,"MEXICALI, B.C.",2,5,7,0,0,0,
05/08/2014,NAY.,"JALA, NAY.",4,2,6,0,0,0,
05/08/2014,B.C.,"TIJUANA, B.C.",4,1,5,0,0,0,
05/08/2014,CHIH.,"JUÁREZ, CHIH.",3,0,3,0,0,0,
05/08/2014,CHIS.,"CINTALAPA, CHIS.",1,0,1,0,0,0,
05/08/2014,SON.,"HERMOSILLO, SON.",1,0,1,2,0,80,
05/08/2014,COAH.,"PIEDRAS NEGRAS, COAH.",1,0,1,0,0,0,
05/08/2014,N.L.,"DR. ARROYO, N.L.",0,0,0,8,0,884,
06/08/2014,SIN.,"MAZATLAN, SIN.",10,5,15,0,0,0,
06/08/2014,COL.,"COL., COL.",10,0,10,0,0,281,
06/08/2014,CHIH.,"JUÁREZ, CHIH.",4,2,6,0,0,0,
06/08/2014,COAH.,"SALTILLO, COAH.",1,0,1,1,0,20,
06/08/2014,COAH.,"MONCLOVA, COAH.",1,0,1,0,0,0,
06/08/2014,B.C.,"MEXICALI, B.C.",1,0,1,0,0,0,
06/08/2014,N.L.,"DR. ARROYO, N.L.",1,0,1,0,0,0,
06/08/2014,N.L.,"CERRALVO, N.L.",0,0,0,7,0,456,
07/08/2014,SIN.,"MAZATLAN, SIN.",9,3,12,0,7,0,
07/08/2014,COL.,"COL., COL.",6,3,9,0,0,182,
07/08/2014,B.C.,"TIJUANA, B.C.",5,4,9,0,0,0,
07/08/2014,CHIH.,"JUÁREZ, CHIH.",2,0,2,0,0,0,
07/08/2014,N.L.,"CERRALVO, N.L.",1,1,2,43,0,2730,
07/08/2014,COAH.,"SALTILLO, COAH.",1,0,1,0,0,185,
07/08/2014,COAH.,"PIEDRAS NEGRAS, COAH.",0,1,1,0,0,0,
07/08/2014,B.C.,"ENSENADA, B.C.",0,1,1,0,0,0,
08/08/2014,TAMPS.,"MATAMOROS, TAMPS.",6,4,10,0,0,0,
08/08/2014,JAL.,"GUADALAJARA, JAL.",2,0,2,0,0,0,
08/08/2014,COAH.,"PIEDRAS NEGRAS, COAH.",0,2,2,0,0,0,
08/08/2014,PUE.,"ATLIXCO, PUE.",0,2,2,0,0,0,
08/08/2014,CHIH.,"JUÁREZ, CHIH.",2,0,2,0,0,0,
08/08/2014,COAH.,"TORREÓN, COAH.",0,1,1,0,0,0,
08/08/2014,N.L.,"DR. ARROYO, N.L.",1,0,1,0,0,0,
08/08/2014,SON.,"HERMOSILLO, SON.",1,0,1,1,0,0,
08/08/2014,COAH.,"SALTILLO, COAH.",0,0,0,0,0,10,
08/08/2014,N.L.,"CERRALVO, N.L.",0,0,0,14,0,975,
09/08/2014,B.C.,"TIJUANA, B.C.",3,1,4,0,0,0,
09/08/2014,B.C.,"ENSENADA, B.C.",1,1,2,0,0,0,
09/08/2014,AGS.,"EL LLANO, AGS.",1,1,2,8,0,109,
09/08/2014,TAMPS.,"MATAMOROS, TAMPS.",2,0,2,0,0,0,
09/08/2014,PUE.,"ATLIXCO, PUE.",1,0,1,0,0,2,
09/08/2014,CHIH.,"JUÁREZ, CHIH.",1,0,1,0,0,0,
10/08/2014,CHIH.,"JUÁREZ, CHIH.",3,1,4,0,1,0,
11/08/2014,SIN.,"MAZATLAN, SIN.",14,2,16,0,8,0,
11/08/2014,CHIH.,"JUÁREZ, CHIH.",2,2,4,0,0,0,
11/08/2014,SON.,"HERMOSILLO, SON.",2,1,3,0,0,0,
11/08/2014,B.C.,"TIJUANA, B.C.",2,0,2,0,0,0,
11/08/2014,SON.,"CAJEME, SON.",0,1,1,0,0,0,
11/08/2014,COAH.,"ACUÑA, COAH.",0,1,1,0,0,0,
12/08/2014,SIN.,"MAZATLAN, SIN.",10,1,11,0,4,0,
12/08/2014,CHIH.,"JUÁREZ, CHIH.",3,1,4,0,0,0,
12/08/2014,NAY.,"ACAPONETA, NAY.",1,1,2,0,0,0,
12/08/2014,N.L.,"MONTERREY, N.L.",1,0,1,18,0,47,
12/08/2014,COAH.,"PIEDRAS NEGRAS, COAH.",1,0,1,0,0,0,
12/08/2014,B.C.,"ENSENADA, B.C.",1,0,1,0,0,0,
12/08/2014,B.C.,"TIJUANA, B.C.",1,0,1,0,0,0,
12/08/2014,COAH.,"SALTILLO, COAH.",0,0,0,0,0,149,
13/08/2014,SIN.,"MAZATLAN, SIN.",6,4,10,0,6,0,
13/08/2014,B.C.,"MEXICALI, B.C.",0,4,4,0,0,0,
13/08/2014,B.C.,"TIJUANA, B.C.",1,2,3,0,0,0,
13/08/2014,CHIH.,"JUÁREZ, CHIH.",2,0,2,0,0,0,
13/08/2014,SON.,"HERMOSILLO, SON.",2,0,2,1,0,0,
13/08/2014,ZAC.,"SOMBRERETE, ZAC.",1,0,1,0,0,0,
14/08/2014,SIN.,"MAZATLAN, SIN.",10,6,16,0,11,0,
14/08/2014,N.L.,"MONTERREY, N.L.",7,1,8,29,0,703,
14/08/2014,B.C.,"TIJUANA, B.C.",4,3,7,0,0,0,
14/08/2014,COL.,"COL., COL.",2,4,6,0,0,299,
14/08/2014,B.C.,"TECATE, B.C.",1,4,5,0,0,0,
14/08/2014,B.C.,"ENSENADA, B.C.",0,4,4,0,0,0,
14/08/2014,NAY.,"IXTLAN DEL RIO, NAY.",3,0,3,0,0,0,
14/08/2014,COAH.,"TORREÓN, COAH.",2,0,2,0,0,0,
14/08/2014,B.C.,"PLAYAS DE ROSARITO, B.C.",1,0,1,0,0,0,
14/08/2014,CHIH.,"JUÁREZ, CHIH.",1,0,1,0,0,0,
14/08/2014,COAH.,"ACUÑA, COAH.",0,0,0,0,0,30,
14/08/2014,N.L.,"SAN NICOLAS DE LOS GARZA, N.L.",0,0,0,0,0,100,
15/08/2014,SIN.,"MAZATLAN, SIN.",10,3,13,0,10,0,
15/08/2014,N.L.,"MONTERREY, N.L.",4,1,5,54,0,2220,
15/08/2014,B.C.,"MEXICALI, B.C.",3,1,4,0,0,0,
15/08/2014,CHIH.,"JUÁREZ, CHIH.",3,1,4,0,0,0,
15/08/2014,NAY.,"IXTLAN DEL RIO, NAY.",2,1,3,0,0,0,
15/08/2014,COAH.,"PIEDRAS NEGRAS, COAH.",2,0,2,0,0,0,
15/08/2014,ZAC.,"VALPARAISO, ZAC.",1,0,1,0,0,0,
15/08/2014,COAH.,"SALTILLO, COAH.",1,0,1,0,0,465,
15/08/2014,TAMPS.,"MATAMOROS, TAMPS.",1,0,1,75,0,0,
15/08/2014,N.L.,"SAN NICOLAS DE LOS GARZA, N.L.",1,0,1,8,0,0,
16/08/2014,N.L.,"MONTERREY, N.L.",1,3,4,115,0,640,
16/08/2014,CHIH.,"JUÁREZ, CHIH.",2,1,3,0,0,0,
16/08/2014,AGS.,"EL LLANO, AGS.",1,1,2,8,0,406,
16/08/2014,TAMPS.,"REYNOSA, TAMPS.",0,2,2,0,0,0,
16/08/2014,B.C.,"MEXICALI, B.C.",1,1,2,0,0,0,
16/08/2014,N.L.,"SAN NICOLAS DE LOS GARZA, N.L.",1,0,1,0,0,0,
16/08/2014,ZAC.,"VALPARAISO, ZAC.",1,0,1,0,0,0,
16/08/2014,ZAC.,"SOMBRERETE, ZAC.",1,0,1,0,0,10,
16/08/2014,B.C.,"ENSENADA, B.C.",1,0,1,0,0,0,
16/08/2014,B.C.,"TIJUANA, B.C.",1,0,1,0,0,0,
16/08/2014,SON.,"HERMOSILLO, SON.",0,0,0,1,0,1120,
16/08/2014,SON.,"CAJEME, SON.",0,0,0,1,0,442,
16/08/2014,TAMPS.,"MATAMOROS, TAMPS.",0,0,0,4,0,88,
18/08/2014,D.F.,"IZTAPALAPA, D.F.",19,1,20,0,2,150,
18/08/2014,N.L.,"MONTERREY, N.L.",4,3,7,63,0,721,
18/08/2014,SIN.,"COSALA, SIN.",1,2,3,0,0,0,
18/08/2014,QRO.,"CORREGIDORA, QRO.",1,2,3,0,0,0,
18/08/2014,CHIH.,"JUÁREZ, CHIH.",1,0,1,0,0,0,
18/08/2014,COAH.,"PIEDRAS NEGRAS, COAH.",1,0,1,0,0,0,
18/08/2014,ZAC.,"FRESNILLO, ZAC.",1,0,1,0,0,0,
18/08/2014,COAH.,"SALTILLO, COAH.",0,0,0,5,0,228,
18/08/2014,N.L.,"SAN NICOLAS DE LOS GARZA, N.L.",0,0,0,1,0,250,
19/08/2014,D.F.,"IZTAPALAPA, D.F.",19,1,20,0,0,75,
19/08/2014,B.C.,"MEXICALI, B.C.",1,10,11,0,0,0,
19/08/2014,NAY.,"IXTLAN DEL RIO, NAY.",4,2,6,0,0,0,
19/08/2014,PUE.,"PUE., PUE.",5,0,5,0,0,93,
19/08/2014,SIN.,"ROSARIO, SIN.",2,1,3,0,0,0,
19/08/2014,N.L.,"MONTERREY, N.L.",2,1,3,65,0,2210,
19/08/2014,SON.,"CAJEME, SON.",3,0,3,2,0,0,
19/08/2014,B.C.,"TIJUANA, B.C.",0,2,2,0,0,0,
19/08/2014,NAY.,"ACAPONETA, NAY.",1,1,2,0,0,0,
19/08/2014,B.C.,"ENSENADA, B.C.",1,0,1,0,0,0,
19/08/2014,COAH.,"SALTILLO, COAH.",1,0,1,5,0,43,
19/08/2014,SIN.,"COSALA, SIN.",0,1,1,0,4,0,
19/08/2014,N.L.,"SAN NICOLAS DE LOS GARZA, N.L.",1,0,1,1,0,0,
19/08/2014,JAL.,"TLAQUEPAQUE, JAL.",1,0,1,0,0,0,
19/08/2014,PUE.,"ATLIXCO, PUE.",0,0,0,1,0,6,
19/08/2014,SON.,"HERMOSILLO, SON.",0,0,0,0,0,700,
20/08/2014,D.F.,"IZTAPALAPA, D.F.",17,7,24,0,0,200,
20/08/2014,SIN.,"COSALA, SIN.",4,7,11,0,0,0,
20/08/2014,QRO.,"CORREGIDORA, QRO.",7,2,9,0,1,0,
20/08/2014,SIN.,"ROSARIO, SIN.",2,1,3,0,1,0,
20/08/2014,N.L.,"MONTERREY, N.L.",3,0,3,116,0,2556,
20/08/2014,B.C.S.,"MULEGÉ, B.C.S.",2,1,3,0,0,0,
20/08/2014,CHIH.,"JUÁREZ, CHIH.",1,1,2,0,0,0,
20/08/2014,SON.,"CAJEME, SON.",2,0,2,0,0,0,
20/08/2014,B.C.,"ENSENADA, B.C.",1,1,2,0,0,0,
20/08/2014,N.L.,"SAN NICOLAS DE LOS GARZA, N.L.",1,0,1,0,0,309,
20/08/2014,S.L.P.,"CIUDAD VALLES, S.L.P.",1,0,1,0,0,0,
20/08/2014,NAY.,"IXTLAN DEL RIO, NAY.",0,1,1,0,0,0,
20/08/2014,JAL.,"TLAQUEPAQUE, JAL.",0,1,1,0,0,0,
20/08/2014,PUE.,"ATLIXCO, PUE.",1,0,1,0,5,202,
20/08/2014,PUE.,"PUE., PUE.",1,0,1,2,0,47,
20/08/2014,SON.,"HERMOSILLO, SON.",0,0,0,0,0,98,
21/08/2014,D.F.,"IZTAPALAPA, D.F.",22,15,37,0,7,150,
21/08/2014,B.C.,"ENSENADA, B.C.",4,14,18,0,0,0,
21/08/2014,YUC.,"Q. ROO., YUC.",0,6,6,0,0,0,
21/08/2014,NAY.,"IXTLAN DEL RIO, NAY.",5,1,6,0,0,0,
21/08/2014,SIN.,"ROSARIO, SIN.",2,2,4,0,0,0,
21/08/2014,PUE.,"PUE., PUE.",2,1,3,2,0,12,
21/08/2014,QRO.,"CORREGIDORA, QRO.",3,0,3,0,0,0,
21/08/2014,SIN.,"COSALA, SIN.",1,1,2,0,0,0,
21/08/2014,NAY.,"ACAPONETA, NAY.",1,1,2,0,0,0,
21/08/2014,COAH.,"FRONTERA, COAH.",0,1,1,0,0,0,
21/08/2014,B.C.,"TIJUANA, B.C.",0,1,1,0,0,0,
21/08/2014,ZAC.,"FRESNILLO, ZAC.",1,0,1,0,0,0,
21/08/2014,SON.,"HERMOSILLO, SON.",0,0,0,0,0,1700,
21/08/2014,COAH.,"SALTILLO, COAH.",0,0,0,0,0,78,
21/08/2014,N.L.,"SANTA CATARINA, N.L.",0,0,0,5,0,0,
22/08/2014,D.F.,"IZTAPALAPA, D.F.",16,2,18,0,5,100,
22/08/2014,SIN.,"COSALA, SIN.",3,4,7,0,0,0,
22/08/2014,B.C.,"MEXICALI, B.C.",3,4,7,0,0,0,
22/08/2014,SIN.,"ROSARIO, SIN.",3,3,6,0,0,0,
22/08/2014,TAMPS.,"MATAMOROS, TAMPS.",3,3,6,1,0,0,
22/08/2014,PUE.,"PUE., PUE.",3,1,4,0,2,124,
22/08/2014,B.C.,"TIJUANA, B.C.",2,2,4,0,0,0,
22/08/2014,SON.,"HERMOSILLO, SON.",0,2,2,10,0,0,
22/08/2014,N.L.,"GUADALUPE, N.L.",1,0,1,7,0,50,
22/08/2014,CHIH.,"JUÁREZ, CHIH.",1,0,1,0,0,0,
22/08/2014,TAB.,"TENOSIQUE, TAB.",0,1,1,0,0,0,
22/08/2014,B.C.,"ENSENADA, B.C.",1,0,1,0,0,0,
22/08/2014,N.L.,"SANTA CATARINA, N.L.",0,0,0,50,0,0,
22/08/2014,COAH.,"SALTILLO, COAH.",0,0,0,1,1,9,
23/08/2014,SIN.,"MAZATLAN, SIN.",92,75,167,1,52,18,
24/08/2014,N.L.,"SANTA CATARINA, N.L.",1,0,1,7,0,0,
25/08/2014,D.F.,"IZTAPALAPA, D.F.",17,0,17,0,3,70,
25/08/2014,AGS.,"JESÚS MARÍA, AGS.",9,3,12,0,0,107,
25/08/2014,B.C.,"TIJUANA, B.C.",2,1,3,0,0,0,
25/08/2014,NAY.,"ACAPONETA, NAY.",1,1,2,0,0,0,
25/08/2014,VER.,"COATZACOALCOS, VER.",2,0,2,0,0,0,
25/08/2014,VER.,"MARTINEZ DE LA TORRE, VER.",1,0,1,0,0,0,
25/08/2014,SON.,"CAJEME, SON.",0,0,0,1,0,330,
25/08/2014,N.L.,"SANTA CATARINA, N.L.",0,0,0,1,0,91,
26/08/2014,CHIH.,"JUÁREZ, CHIH.",51,48,99,0,1,986,
26/08/2014,N.L.,"GUADALUPE, N.L.",33,22,55,0,0,25632,
26/08/2014,D.F.,"IZTAPALAPA, D.F.",20,14,34,0,4,0,
26/08/2014,NAY.,"IXTLAN DEL RIO, NAY.",15,16,31,0,0,27,
26/08/2014,COAH.,"SALTILLO, COAH.",23,2,25,0,3,2470,
26/08/2014,ZAC.,"FRESNILLO, ZAC.",16,7,23,0,0,0,
26/08/2014,PUE.,"SAN PEDRO CHOLULA, PUE.",11,0,11,2,1,97,
26/08/2014,CHIH.,"JUÁREZ, CHIH.",4,3,7,0,0,0,
26/08/2014,SIN.,"ROSARIO, SIN.",4,0,4,0,2,0,
26/08/2014,NAY.,"IXTLAN DEL RIO, NAY.",1,3,4,0,0,0,
26/08/2014,CHIS.,"IXTACOMITÁN, CHIS.",2,1,3,0,0,0,
26/08/2014,B.C.,"TIJUANA, B.C.",2,1,3,0,0,0,
26/08/2014,TAB.,"TENOSIQUE, TAB.",0,3,3,0,0,0,
26/08/2014,AGS.,"JESÚS MARÍA, AGS.",1,2,3,2,0,0,
26/08/2014,COL.,"COL., COL.",2,0,2,0,0,0,
26/08/2014,SIN.,"COSALA, SIN.",0,1,1,0,0,0,
26/08/2014,B.C.,"ENSENADA, B.C.",1,0,1,0,0,0,
26/08/2014,B.C.,"MEXICALI, B.C.",0,1,1,0,0,0,
26/08/2014,VER.,"MARTINEZ DE LA TORRE, VER.",0,1,1,0,0,0,
26/08/2014,N.L.,"GUADALUPE, N.L.",0,0,0,1,0,261,
27/08/2014,D.F.,"IZTAPALAPA, D.F.",19,12,31,0,14,600,
27/08/2014,SIN.,"COSALA, SIN.",8,0,8,0,0,0,
27/08/2014,SIN.,"ROSARIO, SIN.",2,2,4,0,0,0,
27/08/2014,CHIH.,"JUÁREZ, CHIH.",2,1,3,0,0,0,
27/08/2014,NAY.,"ACAPONETA, NAY.",1,1,2,0,0,0,
27/08/2014,COAH.,"SALTILLO, COAH.",1,0,1,0,0,0,
27/08/2014,COAH.,"PIEDRAS NEGRAS, COAH.",0,1,1,0,0,0,
27/08/2014,TAB.,"TENOSIQUE, TAB.",1,0,1,0,0,0,
27/08/2014,PUE.,"PUE., PUE.",1,0,1,1,0,0,
27/08/2014,N.L.,"SANTA CATARINA, N.L.",1,0,1,16,0,237,
27/08/2014,B.C.,"ENSENADA, B.C.",0,1,1,0,0,0,
27/08/2014,SON.,"CAJEME, SON.",0,1,1,0,0,0,
27/08/2014,NAY.,"IXTLAN DEL RIO, NAY.",0,1,1,0,0,0,
27/08/2014,ZAC.,"TEPECHITLAN, ZAC.",1,0,1,0,0,0,
27/08/2014,N.L.,"GUADALUPE, N.L.",0,0,0,2,0,221,
27/08/2014,SON.,"HERMOSILLO, SON.",0,0,0,0,0,800,
28/08/2014,D.F.,"IZTAPALAPA, D.F.",27,20,47,0,3,25,
28/08/2014,SIN.,"COSALA, SIN.",9,0,9,0,0,0,
28/08/2014,MICH.,"MORELIA, MICH.",5,4,9,4,0,0,
28/08/2014,MICH.,"ZAMORA, MICH.",5,4,9,1,0,0,
28/08/2014,SIN.,"ROSARIO, SIN.",5,0,5,0,0,0,
28/08/2014,TAMPS.,"REYNOSA, TAMPS.",3,2,5,0,8,104,
28/08/2014,CHIH.,"JUÁREZ, CHIH.",4,0,4,0,0,0,
28/08/2014,B.C.,"TIJUANA, B.C.",1,2,3,0,0,0,
28/08/2014,PUE.,"PUE., PUE.",3,0,3,2,0,198,
28/08/2014,MICH.,"TACAMBARO, MICH.",2,1,3,2,0,0,
28/08/2014,VER.,"MARTINEZ DE LA TORRE, VER.",0,2,2,0,0,0,
28/08/2014,MICH.,"APATZINGAN, MICH.",2,0,2,1,0,0,
28/08/2014,SON.,"HERMOSILLO, SON.",0,2,2,0,0,0,
28/08/2014,COL.,"COL., COL.",1,0,1,0,0,0,
28/08/2014,B.C.,"ENSENADA, B.C.",0,1,1,0,0,0,
28/08/2014,B.C.,"MEXICALI, B.C.",1,0,1,0,0,0,
28/08/2014,MICH.,"LAZARO CARDENAS, MICH.",1,0,1,1,0,244,
28/08/2014,N.L.,"GUADALUPE, N.L.",0,0,0,1,0,0,
29/08/2014,D.F.,"IZTAPALAPA, D.F.",18,4,22,0,2,0,
29/08/2014,TAMPS.,"REYNOSA, TAMPS.",8,8,16,7,2,194,
29/08/2014,MICH.,"MORELIA, MICH.",5,4,9,3,1,42,
29/08/2014,TAMPS.,"MATAMOROS, TAMPS.",6,2,8,0,0,0,
29/08/2014,MICH.,"ZAMORA, MICH.",6,2,8,4,0,403,
29/08/2014,CHIH.,"JUÁREZ, CHIH.",5,1,6,0,0,0,
29/08/2014,MICH.,"TACAMBARO, MICH.",3,2,5,1,0,0,
29/08/2014,SIN.,"ROSARIO, SIN.",4,0,4,0,2,0,
29/08/2014,PUE.,"SAN PEDRO CHOLULA, PUE.",4,0,4,1,0,387,
29/08/2014,COAH.,"PIEDRAS NEGRAS, COAH.",2,1,3,0,0,0,
29/08/2014,B.C.,"ENSENADA, B.C.",0,3,3,0,0,0,
29/08/2014,MICH.,"LAZARO CARDENAS, MICH.",3,0,3,3,0,210,
29/08/2014,B.C.,"TIJUANA, B.C.",1,1,2,0,0,0,
29/08/2014,AGS.,"JESÚS MARÍA, AGS.",2,0,2,0,0,0,
29/08/2014,SIN.,"COSALA, SIN.",1,0,1,0,0,0,
29/08/2014,VER.,"MARTINEZ DE LA TORRE, VER.",1,0,1,0,0,0,
29/08/2014,COAH.,"MÚZQUIZ, COAH.",1,0,1,0,0,0,
29/08/2014,N.L.,"GUADALUPE, N.L.",1,0,1,141,0,400,
29/08/2014,MICH.,"TEPALCATEPEC, MICH.",1,0,1,1,0,0,
29/08/2014,PUE.,"ATLIXCO, PUE.",0,1,1,0,0,0,
29/08/2014,TAB.,"TENOSIQUE, TAB.",0,0,0,0,1,0,
29/08/2014,MICH.,"APATZINGAN, MICH.",0,0,0,0,2,0,
30/08/2014,TAMPS.,"REYNOSA, TAMPS.",10,13,23,0,0,520,
30/08/2014,MICH.,"ZAMORA, MICH.",8,6,14,0,0,128,
30/08/2014,MICH.,"MORELIA, MICH.",7,5,12,6,0,0,
30/08/2014,MICH.,"TACAMBARO, MICH.",3,6,9,2,0,0,
30/08/2014,MICH.,"LAZARO CARDENAS, MICH.",3,1,4,0,5,600,
30/08/2014,MICH.,"APATZINGAN, MICH.",3,0,3,0,0,56,
30/08/2014,MICH.,"TEPALCATEPEC, MICH.",1,2,3,0,0,34,
30/08/2014,N.L.,"GUADALUPE, N.L.",1,0,1,1,0,850,
30/08/2014,B.C.,"ENSENADA, B.C.",0,1,1,0,0,0,
30/08/2014,N.L.,"SANTA CATARINA, N.L.",0,0,0,41,0,0,
31/08/2014,MICH.,"LAZARO CARDENAS, MICH.",4,0,4,5,0,13,
31/08/2014,N.L.,"GUADALUPE, N.L.",1,0,1,0,0,634,
31/08/2014,MICH.,"APATZINGAN, MICH.",1,0,1,0,0,276,
31/08/2014,B.C.,"TIJUANA, B.C.",0,1,1,0,0,0,
31/08/2014,B.C.,"ENSENADA, B.C.",1,0,1,0,0,0,
01/09/2014,D.F.,"IZTAPALAPA, D.F.",18,1,19,0,0,100,
01/09/2014,TAMPS.,"MATAMOROS, TAMPS.",7,6,13,0,0,0,
01/09/2014,MICH.,"ZAMORA, MICH.",6,3,9,3,0,17,
01/09/2014,COL.,"COL., COL.",1,5,6,0,0,0,
01/09/2014,MICH.,"MORELIA, MICH.",3,2,5,0,0,0,
01/09/2014,B.C.,"ENSENADA, B.C.",1,3,4,0,0,0,
01/09/2014,MICH.,"APATZINGAN, MICH.",0,2,2,3,0,0,
01/09/2014,MICH.,"LAZARO CARDENAS, MICH.",2,0,2,1,0,792,
01/09/2014,SON.,"CAJEME, SON.",1,1,2,1,0,36,
01/09/2014,CHIH.,"JUÁREZ, CHIH.",1,1,2,0,0,0,
01/09/2014,SIN.,"COSALA, SIN.",1,0,1,0,0,0,
01/09/2014,N.L.,"APODACA, N.L.",0,0,0,1,0,158,
01/09/2014,AGS.,"JESÚS MARÍA, AGS.",0,0,0,2,0,98,
02/09/2014,D.F.,"IZTAPALAPA, D.F.",24,1,25,0,0,0,
02/09/2014,MICH.,"MORELIA, MICH.",22,2,24,9,0,0,
02/09/2014,MICH.,"ZAMORA, MICH.",8,5,13,4,0,139,
02/09/2014,MICH.,"TACAMBARO, MICH.",8,5,13,5,0,828,
02/09/2014,MICH.,"LAZARO CARDENAS, MICH.",8,2,10,5,0,117,
02/09/2014,JAL.,"TLAQUEPAQUE, JAL.",5,1,6,0,0,0,
02/09/2014,PUE.,"AMOZOC, PUE.",3,0,3,2,0,112,
02/09/2014,TAB.,"TENOSIQUE, TAB.",1,1,2,0,0,0,
02/09/2014,MICH.,"APATZINGAN, MICH.",1,1,2,1,0,55,
02/09/2014,COAH.,"SALTILLO, COAH.",0,1,1,0,0,411,
02/09/2014,SIN.,"COSALA, SIN.",1,0,1,0,0,0,
02/09/2014,COL.,"COL., COL.",1,0,1,0,1,0,
02/09/2014,VER.,"MARTINEZ DE LA TORRE, VER.",1,0,1,0,0,0,
02/09/2014,CHIH.,"HGO. DEL PARRAL, CHIH.",0,1,1,0,0,0,
02/09/2014,N.L.,"APODACA, N.L.",0,1,1,3,0,1150,
02/09/2014,PUE.,"ATLIXCO, PUE.",1,0,1,0,0,0,
02/09/2014,SON.,"CAJEME, SON.",0,0,0,1,0,100,
02/09/2014,N.L.,"GRAL. ESCOBEDO, N.L.",0,0,0,150,0,3500,
03/09/2014,D.F.,"MIGUEL HGO., D.F.",39,14,53,0,0,50,
03/09/2014,MICH.,"LAZARO CARDENAS, MICH.",7,0,7,3,0,79,
03/09/2014,MICH.,"BUENAVISTA, MICH.",1,2,3,2,0,82,
03/09/2014,MICH.,"ZITACUARO, MICH.",2,0,2,0,0,0,
03/09/2014,B.C.,"ENSENADA, B.C.",2,0,2,0,0,0,
03/09/2014,VER.,"MARTINEZ DE LA TORRE, VER.",1,0,1,0,0,0,
03/09/2014,COAH.,"TORREÓN, COAH.",0,1,1,0,0,0,
03/09/2014,SON.,"HERMOSILLO, SON.",1,0,1,38,0,142,
03/09/2014,SON.,"CAJEME, SON.",0,1,1,0,0,0,
03/09/2014,N.L.,"APODACA, N.L.",1,0,1,0,0,0,
03/09/2014,AGS.,"JESÚS MARÍA, AGS.",1,0,1,5,0,5,
03/09/2014,COAH.,"SALTILLO, COAH.",0,0,0,2,1,83,
03/09/2014,PUE.,"PUE., PUE.",0,0,0,0,0,26,
04/09/2014,D.F.,"MIGUEL HGO., D.F.",36,6,42,0,6,0,
04/09/2014,TAMPS.,"VICTORIA, TAMPS.",6,1,7,0,0,38,
04/09/2014,MICH.,"APATZINGAN, MICH.",4,1,5,3,0,525,
04/09/2014,COAH.,"SALTILLO, COAH.",2,3,5,0,0,132,
04/09/2014,N.L.,"GRAL. ESCOBEDO, N.L.",4,0,4,171,0,30,
04/09/2014,MICH.,"BUENAVISTA, MICH.",0,3,3,0,0,0,
04/09/2014,MICH.,"SAHUAYO, MICH.",2,1,3,0,0,51,
04/09/2014,AGS.,"JESÚS MARÍA, AGS.",1,1,2,1,0,235,
04/09/2014,JAL.,"TLAQUEPAQUE, JAL.",1,0,1,0,0,0,
04/09/2014,MICH.,"ZITACUARO, MICH.",1,0,1,0,0,0,
04/09/2014,PUE.,"PUE., PUE.",1,0,1,0,0,61,
04/09/2014,PUE.,"AMOZOC, PUE.",1,0,1,0,0,0,
04/09/2014,N.L.,"APODACA, N.L.",1,0,1,16,0,0,
04/09/2014,SON.,"HERMOSILLO, SON.",0,0,0,33,0,300,
05/09/2014,MICH.,"SAHUAYO, MICH.",10,4,14,2,0,6,
05/09/2014,MICH.,"ZITACUARO, MICH.",9,4,13,2,0,0,
05/09/2014,MICH.,"BUENAVISTA, MICH.",4,1,5,0,0,2942,
05/09/2014,NAY.,"IXTLAN DEL RIO, NAY.",2,1,3,0,0,0,
05/09/2014,AGS.,"JESÚS MARÍA, AGS.",1,1,2,0,0,9,
05/09/2014,N.L.,"APODACA, N.L.",2,0,2,1,1,531,
05/09/2014,CHIH.,"JUÁREZ, CHIH.",0,2,2,0,0,0,
05/09/2014,N.L.,"APODACA, N.L.",2,0,2,3,1,531,
05/09/2014,VER.,"MARTINEZ DE LA TORRE, VER.",1,1,2,0,0,0,
05/09/2014,ZAC.,"TEPECHITLAN, ZAC.",1,0,1,0,0,0,
05/09/2014,COL.,"TECOMÁN, COL.",1,0,1,0,0,0,
05/09/2014,TAB.,"TENOSIQUE, TAB.",1,0,1,0,0,0,
05/09/2014,TAMPS.,"VICTORIA, TAMPS.",1,0,1,4,0,160,
05/09/2014,PUE.,"AMOZOC, PUE.",1,0,1,0,0,71,
05/09/2014,N.L.,"MONTERREY, N.L.",0,0,0,2,0,0,
05/09/2014,PUE.,"ATLIXCO, PUE.",0,0,0,0,0,12,
05/09/2014,N.L.,"GRAL. ESCOBEDO, N.L.",0,0,0,2,0,0,
06/09/2014,MICH.,"BUENAVISTA, MICH.",3,3,6,1,0,1104,
06/09/2014,SON.,"HERMOSILLO, SON.",1,3,4,0,0,0,
06/09/2014,AGS.,"EL LLANO, AGS.",2,2,4,1,0,52,
06/09/2014,MICH.,"ZITACUARO, MICH.",3,0,3,0,0,0,
06/09/2014,SON.,"CAJEME, SON.",1,1,2,0,0,0,
06/09/2014,PUE.,"PUE., PUE.",1,0,1,0,0,0,
06/09/2014,MICH.,"SAHUAYO, MICH.",1,0,1,0,0,0,
06/09/2014,B.C.,"ENSENADA, B.C.",1,0,1,0,0,0,
06/09/2014,N.L.,"GRAL. ESCOBEDO, N.L.",0,0,0,107,0,1182,
06/09/2014,N.L.,"APODACA, N.L.",0,0,0,3,0,490,
07/09/2014,MICH.,"SAHUAYO, MICH.",2,0,2,0,0,46,
07/09/2014,N.L.,"APODACA, N.L.",1,0,1,0,0,0,
07/09/2014,SON.,"HERMOSILLO, SON.",1,0,1,1,0,0,
08/09/2014,D.F.,"IZTACALCO, D.F.",19,5,24,0,0,0,
08/09/2014,MICH.,"ZITACUARO, MICH.",9,1,10,2,0,0,
08/09/2014,N.L.,"APODACA, N.L.",3,1,4,0,0,0,
08/09/2014,MICH.,"LAZARO CARDENAS, MICH.",3,0,3,0,0,0,
08/09/2014,MICH.,"SAHUAYO, MICH.",2,0,2,0,0,45,
08/09/2014,TAMPS.,"VICTORIA, TAMPS.",1,1,2,4,0,45,
08/09/2014,MICH.,"BUENAVISTA, MICH.",1,0,1,0,0,0,
08/09/2014,CHIH.,"CHIH., CHIH.",0,1,1,0,0,0,
08/09/2014,CHIH.,"JUÁREZ, CHIH.",0,1,1,0,0,0,
08/09/2014,COAH.,"SALTILLO, COAH.",1,0,1,0,0,182,
08/09/2014,AGS.,"JESÚS MARÍA, AGS.",0,0,0,25,0,0,
09/09/2014,D.F.,"IZTACALCO, D.F.",31,0,31,0,5,0,
09/09/2014,MICH.,"ZITACUARO, MICH.",2,4,6,1,0,0,
09/09/2014,MICH.,"LAZARO CARDENAS, MICH.",4,0,4,4,0,9,
09/09/2014,COAH.,"SALTILLO, COAH.",3,0,3,9,0,37,
09/09/2014,B.C.,"TIJUANA, B.C.",1,1,2,0,0,0,
09/09/2014,MICH.,"SAHUAYO, MICH.",1,1,2,0,0,120,
09/09/2014,N.L.,"APODACA, N.L.",2,0,2,1,0,526,
09/09/2014,TAMPS.,"VICTORIA, TAMPS.",0,2,2,1,0,169,
09/09/2014,SON.,"HERMOSILLO, SON.",1,0,1,0,0,0,
09/09/2014,COAH.,"FRONTERA, COAH.",1,0,1,0,0,0,
10/09/2014,D.F.,"IZTACALCO, D.F.",35,24,59,0,4,0,
10/09/2014,N.L.,"GRAL. ESCOBEDO, N.L.",4,0,4,121,0,3500,
10/09/2014,SON.,"CAJEME, SON.",2,0,2,0,0,2000,
10/09/2014,PUE.,"TEPEACA, PUE.",2,0,2,2,0,25,
10/09/2014,HGO.,"HUICHAPAN, HGO.",0,1,1,0,0,0,
10/09/2014,COL.,"COL., COL.",1,0,1,0,0,0,
10/09/2014,CHIH.,"CHIH., CHIH.",0,1,1,0,0,0,
10/09/2014,N.L.,"APODACA, N.L.",0,0,0,0,0,480,
10/09/2014,PUE.,"ATLIXCO, PUE.",0,0,0,0,0,94,
11/09/2014,D.F.,"IZTACALCO, D.F.",41,3,44,0,14,30,
11/09/2014,PUE.,"TEPEACA, PUE.",1,1,2,0,0,0,
11/09/2014,N.L.,"CADEREYTA JIMENEZ, N.L.",0,1,1,0,0,0,
11/09/2014,CHIH.,"JUÁREZ, CHIH.",1,0,1,0,0,0,
11/09/2014,COAH.,"SALTILLO, COAH.",0,0,0,2,1,257,
11/09/2014,SON.,"CAJEME, SON.",0,0,0,0,0,1001,
12/09/2014,D.F.,"IZTACALCO, D.F.",45,6,51,0,3,10,
12/09/2014,TAMPS.,"MATAMOROS, TAMPS.",6,6,12,0,0,0,
12/09/2014,TAB.,"HUIMANGUILLO, TAB.",2,0,2,0,0,10,
12/09/2014,TAMPS.,"VICTORIA, TAMPS.",1,0,1,9,0,308,
12/09/2014,SON.,"HERMOSILLO, SON.",1,0,1,6,0,626,
13/09/2014,TAMPS.,"MATAMOROS, TAMPS.",7,3,10,0,0,0,
13/09/2014,SON.,"HERMOSILLO, SON.",1,0,1,0,0,295,
14/09/2014,N.L.,"CADEREYTA JIMENEZ, N.L.",5,0,5,0,0,0,
14/09/2014,N.L.,"GARCIA, N.L.",1,0,1,163,0,500,
15/09/2014,D.F.,"TLAHUAC, D.F.",15,7,22,0,1,0,
15/09/2014,TAB.,"HUIMANGUILLO, TAB.",1,0,1,0,0,0,
15/09/2014,N.L.,"SAN PEDRO GARZA GARCIA, N.L.",0,0,0,0,0,300,
15/09/2014,N.L.,"CADEREYTA JIMENEZ, N.L.",0,0,0,0,0,450,
16/09/2014,TAMPS.,"VICTORIA, TAMPS.",1,0,1,0,0,0,
16/09/2014,N.L.,"SAN PEDRO GARZA GARCIA, N.L.",0,0,0,0,0,6480,
16/09/2014,N.L.,"CADEREYTA JIMENEZ, N.L.",0,0,0,1,0,2000,
17/09/2014,B.C.,"TIJUANA, B.C.",90,94,184,0,0,0,
17/09/2014,D.F.,"TLAHUAC, D.F.",29,10,39,1,0,50,
17/09/2014,HGO.,"HUICHAPAN, HGO.",1,0,1,0,0,0,
17/09/2014,CHIH.,"CHIH., CHIH.",0,1,1,0,0,0,
17/09/2014,N.L.,"CADEREYTA JIMENEZ, N.L.",0,0,0,"1,039",0,0,
18/09/2014,D.F.,"TLAHUAC, D.F.",34,5,39,0,6,15,
18/09/2014,TAMPS.,"MATAMOROS, TAMPS.",25,13,38,76,3,366,
18/09/2014,OAX.,"OAX. DE JUAREZ, OAX.",21,9,30,0,3,5878,
18/09/2014,S.L.P.,"CIUDAD VALLES, S.L.P.",5,1,6,0,0,6,
18/09/2014,MICH.,"JIQUILPAN, MICH.",4,1,5,4,0,3,
18/09/2014,MICH.,"VISTA HERMOSA, MICH.",0,4,4,0,0,0,
18/09/2014,COL.,"TECOMÁN, COL.",1,1,2,0,0,0,
18/09/2014,COAH.,"SALTILLO, COAH.",0,2,2,0,2,136,
18/09/2014,N.L.,"CADEREYTA JIMENEZ, N.L.",0,0,0,0,0,69,
19/09/2014,D.F.,"IZTACALCO, D.F.",30,2,32,1,3,0,
19/09/2014,MICH.,"JIQUILPAN, MICH.",2,4,6,0,0,146,
19/09/2014,MICH.,"VISTA HERMOSA, MICH.",2,1,3,2,0,0,
19/09/2014,TAB.,"HUIMANGUILLO, TAB.",2,0,2,0,0,0,
19/09/2014,MICH.,"APATZINGAN, MICH.",2,0,2,1,0,0,
19/09/2014,AGS.,"JESÚS MARÍA, AGS.",0,1,1,0,0,18,
19/09/2014,N.L.,"CADEREYTA JIMENEZ, N.L.",0,1,1,0,0,0,
19/09/2014,COAH.,"SALTILLO, COAH.",0,0,0,6,0,40,
19/09/2014,SON.,"HERMOSILLO, SON.",0,0,0,0,0,162,
19/09/2014,N.L.,"SAN PEDRO GARZA GARCIA, N.L.",0,0,0,0,0,7156,
20/09/2014,COAH.,"SALTILLO, COAH.",4,10,14,0,0,0,
20/09/2014,MICH.,"VISTA HERMOSA, MICH.",1,4,5,0,0,19,
20/09/2014,MICH.,"COALCOMAN DE VAZQUEZ PALLARES, MICH.",3,0,3,2,0,0,
20/09/2014,MICH.,"JIQUILPAN, MICH.",1,1,2,1,0,311,
20/09/2014,HGO.,"HUICHAPAN, HGO.",1,1,2,0,0,0,
20/09/2014,TAMPS.,"VICTORIA, TAMPS.",1,0,1,0,0,0,
20/09/2014,TAMPS.,"VICTORIA, TAMPS.",1,0,1,0,0,0,
20/09/2014,AGS.,"JESÚS MARÍA, AGS.",0,1,1,2,0,0,
20/09/2014,N.L.,"SAN PEDRO GARZA GARCIA, N.L.",0,0,0,0,0,64,
21/09/2014,GRO.,"ACAPULCO DE JUAREZ, GRO.",38,11,49,6,16,431,
21/09/2014,MICH.,"VISTA HERMOSA, MICH.",1,2,3,0,0,0,
21/09/2014,MICH.,"JIQUILPAN, MICH.",1,0,1,0,0,0,
21/09/2014,N.L.,"GARCIA, N.L.",1,0,1,65,0,0,
21/09/2014,MICH.,"COALCOMAN DE VAZQUEZ PALLARES, MICH.",0,0,0,0,0,575,
22/09/2014,D.F.,"MILPA ALTA, D.F.",28,4,32,0,2,29,
22/09/2014,AGS.,"AGS., AGS.",8,3,11,0,0,163,
22/09/2014,AGS.,"SAN JOSÉ DE GRACIA, AGS.",0,1,1,0,0,0,
22/09/2014,VER.,"SAN RAFAEL, VER.",0,1,1,0,0,0,
22/09/2014,N.L.,"GARCIA, N.L.",1,0,1,0,0,0,
22/09/2014,TAB.,"CENTRO, TAB.",1,0,1,0,0,0,
23/09/2014,D.F.,"MILPA ALTA, D.F.",23,2,25,0,5,32,
23/09/2014,B.C.,"TIJUANA, B.C.",5,2,7,0,0,0,
23/09/2014,MICH.,"JIQUILPAN, MICH.",5,1,6,6,0,24,
23/09/2014,AGS.,"AGS., AGS.",5,0,5,0,0,0,
23/09/2014,MICH.,"VISTA HERMOSA, MICH.",1,3,4,0,0,0,
23/09/2014,S.L.P.,"SAN LUIS POTOSI, S.L.P.",2,0,2,0,0,0,
23/09/2014,MICH.,"COALCOMAN DE VAZQUEZ PALLARES, MICH.",2,0,2,0,0,0,
23/09/2014,COAH.,"TORREÓN, COAH.",2,0,2,0,0,0,
23/09/2014,TAB.,"CENTRO, TAB.",1,0,1,0,0,0,
23/09/2014,TAMPS.,"VICTORIA, TAMPS.",0,1,1,0,0,16,
23/09/2014,AGS.,"SAN JOSÉ DE GRACIA, AGS.",0,1,1,0,0,2,
23/09/2014,N.L.,"GARCIA, N.L.",0,1,1,0,0,4550,
24/09/2014,D.F.,"MILPA ALTA, D.F.",38,22,60,0,7,0,
24/09/2014,MICH.,"JIQUILPAN, MICH.",7,9,16,10,0,784,
24/09/2014,AGS.,"AGS., AGS.",6,4,10,4,0,310,
24/09/2014,MICH.,"VISTA HERMOSA, MICH.",1,2,3,0,0,0,
24/09/2014,AGS.,"SAN JOSÉ DE GRACIA, AGS.",2,0,2,0,0,0,
24/09/2014,B.C.,"TIJUANA, B.C.",1,1,2,0,0,0,
24/09/2014,S.L.P.,"SAN LUIS POTOSI, S.L.P.",1,0,1,0,0,0,
24/09/2014,PUE.,"PUE., PUE.",1,0,1,0,0,0,
24/09/2014,N.L.,"GARCIA, N.L.",0,0,0,0,0,6750,
24/09/2014,MICH.,"COALCOMAN DE VAZQUEZ PALLARES, MICH.",0,0,0,0,0,723,
25/09/2014,D.F.,"MILPA ALTA, D.F.",42,6,48,1,1,3,
25/09/2014,AGS.,"AGS., AGS.",5,2,7,8,0,1214,
25/09/2014,COL.,"COL., COL.",3,1,4,0,0,0,
25/09/2014,MICH.,"APATZINGAN, MICH.",2,0,2,0,0,100,
25/09/2014,MICH.,"LA HUACANA, MICH.",0,1,1,1,0,0,
25/09/2014,MICH.,"ARTEAGA, MICH.",1,0,1,0,0,0,
25/09/2014,CHIH.,"JUÁREZ, CHIH.",0,1,1,0,0,0,
25/09/2014,PUE.,"ATLIXCO, PUE.",1,0,1,7,0,0,
25/09/2014,COAH.,"SALTILLO, COAH.",0,0,0,0,0,45,
25/09/2014,N.L.,"GARCIA, N.L.",0,0,0,0,0,6725,
26/09/2014,D.F.,"MILPA ALTA, D.F.",31,10,41,1,2,300,
26/09/2014,TAMPS.,"MATAMOROS, TAMPS.",24,12,36,0,0,0,
26/09/2014,AGS.,"AGS., AGS.",8,4,12,7,0,262,
26/09/2014,OAX.,"CIUDAD IXTEPEC, OAX.",5,4,9,29,0,53,
26/09/2014,B.C.,"TIJUANA, B.C.",7,2,9,0,0,0,
26/09/2014,MICH.,"LA HUACANA, MICH.",5,2,7,4,0,6,
26/09/2014,OAX.,"SAN PEDRO POCHUTLA, OAX.",1,5,6,34,0,140,
26/09/2014,TAB.,"CENTRO, TAB.",2,0,2,0,0,80,
26/09/2014,N.L.,"GARCIA, N.L.",1,1,2,100,0,800,
26/09/2014,MICH.,"COAHUAYANA, MICH.",1,1,2,1,0,0,
26/09/2014,PUE.,"PUE., PUE.",1,0,1,0,0,0,
26/09/2014,JAL.,"TLAQUEPAQUE, JAL.",1,0,1,0,0,0,
26/09/2014,COL.,"TECOMÁN, COL.",1,0,1,0,0,0,
26/09/2014,AGS.,"SAN JOSÉ DE GRACIA, AGS.",0,0,0,0,0,76,
27/09/2014,B.C.,"TIJUANA, B.C.",3,1,4,0,0,0,
27/09/2014,MICH.,"LAZARO CARDENAS, MICH.",3,1,4,1,0,36,
27/09/2014,JAL.,"TLAQUEPAQUE, JAL.",1,0,1,0,0,0,
28/09/2014,B.C.,"MEXICALI, B.C.",2,5,7,0,0,0,
28/09/2014,MICH.,"ZAMORA, MICH.",3,3,6,1,0,0,
28/09/2014,MICH.,"LAZARO CARDENAS, MICH.",3,0,3,2,0,32,
28/09/2014,N.L.,"JUAREZ, N.L.",0,0,0,0,0,30,
29/09/2014,B.C.,"TIJUANA, B.C.",4,2,6,0,0,0,
29/09/2014,MICH.,"LAZARO CARDENAS, MICH.",2,2,4,0,0,50,
29/09/2014,MICH.,"GABRIEL ZAMORA, MICH.",2,1,3,0,0,23,
29/09/2014,COL.,"COL., COL.",1,0,1,0,0,0,
29/09/2014,MICH.,"LA HUACANA, MICH.",0,1,1,1,0,0,
29/09/2014,AGS.,"AGS., AGS.",1,0,1,0,0,220,
30/09/2014,D.F.,"XOCHIMILCO, D.F.",32,8,40,0,2,80,
30/09/2014,B.C.,"MEXICALI, B.C.",3,8,11,0,0,0,
30/09/2014,MICH.,"ZAMORA, MICH.",3,0,3,0,0,320,
30/09/2014,AGS.,"AGS., AGS.",1,1,2,0,0,0,
30/09/2014,SIN.,"ELOTA, SIN.",0,1,1,1,0,0,
30/09/2014,MICH.,"ARTEAGA, MICH.",1,0,1,0,0,0,
30/09/2014,MICH.,"LAZARO CARDENAS, MICH.",1,0,1,0,0,0,
30/09/2014,B.C.,"TIJUANA, B.C.",0,1,1,0,0,0,
30/09/2014,COAH.,"SALTILLO, COAH.",1,0,1,0,0,0,
30/09/2014,N.L.,"GARCIA, N.L.",0,0,0,1,0,100,
01/10/2014,D.F.,"XOCHIMILCO, D.F.",40,15,55,0,2,0,
01/10/2014,B.C.,"MEXICALI, B.C.",5,7,12,0,0,0,
01/10/2014,SIN.,"ESCUINAPA, SIN.",2,4,6,0,0,0,
01/10/2014,SIN.,"ELOTA, SIN.",1,4,5,0,0,0,
01/10/2014,MICH.,"LAZARO CARDENAS, MICH.",2,2,4,0,0,0,
01/10/2014,N.L.,"MONTERREY, N.L.",3,0,3,19,0,60,
01/10/2014,MICH.,"GABRIEL ZAMORA, MICH.",0,2,2,0,0,1050,
01/10/2014,MICH.,"LA HUACANA, MICH.",2,0,2,2,0,0,
01/10/2014,B.C.,"ENSENADA, B.C.",0,2,2,0,0,0,
01/10/2014,YUC.,"UMAN, YUC.",1,0,1,0,0,0,
01/10/2014,PUE.,"PUE., PUE.",0,1,1,1,0,0,
01/10/2014,B.C.,"TIJUANA, B.C.",0,1,1,0,0,0,
01/10/2014,B.C.,"ENSENADA, B.C.",0,1,1,0,0,0,
01/10/2014,AGS.,"AGS., AGS.",1,0,1,0,0,0,
01/10/2014,COAH.,"SALTILLO, COAH.",0,0,0,0,0,19,
02/10/2014,D.F.,"XOCHIMILCO, D.F.",22,3,25,0,0,0,
02/10/2014,B.C.,"MEXICALI, B.C.",4,5,9,0,0,0,
02/10/2014,N.L.,"MONTERREY, N.L.",7,1,8,106,0,1875,
02/10/2014,B.C.,"TIJUANA, B.C.",2,5,7,0,0,0,
02/10/2014,MICH.,"URUAPAN, MICH.",3,3,6,0,0,6,
02/10/2014,SIN.,"ESCUINAPA, SIN.",5,0,5,0,0,0,
02/10/2014,SIN.,"ELOTA, SIN.",1,3,4,0,0,0,
02/10/2014,B.C.,"ENSENADA, B.C.",1,1,2,0,0,0,
02/10/2014,AGS.,"AGS., AGS.",0,2,2,0,0,0,
02/10/2014,MICH.,"TIQUICHEO DE NICOLAS ROMERO, MICH.",0,2,2,0,0,0,
02/10/2014,S.L.P.,"SAN LUIS POTOSI, S.L.P.",1,0,1,0,0,0,
02/10/2014,MICH.,"ZINAPECUARO, MICH.",1,0,1,1,0,29,
02/10/2014,MICH.,"HUETAMO, MICH.",1,0,1,0,0,0,
02/10/2014,COL.,"TECOMÁN, COL.",1,0,1,0,0,0,
02/10/2014,B.C.S.,"MULEGÉ, B.C.S.",0,1,1,0,0,0,
02/10/2014,N.L.,"SAN NICOLAS DE LOS GARZA, N.L.",0,0,0,0,0,175,
03/10/2014,B.C.,"TIJUANA, B.C.",29,13,42,0,0,0,
03/10/2014,D.F.,"XOCHIMILCO, D.F.",29,2,31,0,3,0,
03/10/2014,N.L.,"MONTERREY, N.L.",5,4,9,0,0,624,
03/10/2014,COL.,"TECOMÁN, COL.",2,1,3,0,0,0,
03/10/2014,SIN.,"ESCUINAPA, SIN.",1,1,2,0,0,0,
03/10/2014,B.C.S.,"MULEGÉ, B.C.S.",0,1,1,0,0,0,
03/10/2014,N.L.,"SAN NICOLAS DE LOS GARZA, N.L.",1,0,1,0,0,0,
03/10/2014,SIN.,"ELOTA, SIN.",0,0,0,0,2,0,
03/10/2014,AGS.,"AGS., AGS.",0,0,0,0,0,130,
03/10/2014,COAH.,"SALTILLO, COAH.",0,0,0,4,0,141,
04/10/2014,TAMPS.,"MATAMOROS, TAMPS.",9,3,12,0,0,0,
04/10/2014,B.C.,"TIJUANA, B.C.",7,5,12,0,0,0,
04/10/2014,N.L.,"MONTERREY, N.L.",4,2,6,9,1,420,
04/10/2014,MICH.,"URUAPAN, MICH.",4,2,6,0,0,163,
04/10/2014,MICH.,"URUAPAN, MICH.",4,1,5,0,0,147,
04/10/2014,MICH.,"HUETAMO, MICH.",3,2,5,3,0,0,
04/10/2014,MICH.,"HUETAMO, MICH.",4,0,4,2,0,2,
04/10/2014,MICH.,"ZINAPECUARO, MICH.",3,0,3,2,0,0,
04/10/2014,MICH.,"ZINAPECUARO, MICH.",2,0,2,1,0,174,
04/10/2014,N.L.,"SAN NICOLAS DE LOS GARZA, N.L.",0,1,1,18,0,0,
04/10/2014,MICH.,"TIQUICHEO DE NICOLAS ROMERO, MICH.",0,1,1,0,0,0,
04/10/2014,MICH.,"TIQUICHEO DE NICOLAS ROMERO, MICH.",1,0,1,0,0,0,
05/10/2014,N.L.,"MONTERREY, N.L.",11,2,13,12,4,131,
06/10/2014,D.F.,"TLALPAN, D.F.",23,3,26,0,1,20,
06/10/2014,MICH.,"ZINAPECUARO, MICH.",3,11,14,2,0,17,
06/10/2014,AGS.,"AGS., AGS.",8,1,9,2,0,14,
06/10/2014,B.C.,"TIJUANA, B.C.",5,3,8,0,0,0,
06/10/2014,MICH.,"URUAPAN, MICH.",3,4,7,1,0,157,
06/10/2014,SIN.,"ELOTA, SIN.",3,1,4,0,0,0,
06/10/2014,SIN.,"ESCUINAPA, SIN.",3,0,3,0,1,0,
06/10/2014,MOR.,"CUERNAVACA, MOR.",2,1,3,2,0,0,
06/10/2014,N.L.,"MONTERREY, N.L.",1,1,2,1,0,550,
06/10/2014,JAL.,"TLAQUEPAQUE, JAL.",0,1,1,0,0,0,
06/10/2014,COAH.,"SALTILLO, COAH.",1,0,1,1,0,464,
06/10/2014,CHIH.,"JUÁREZ, CHIH.",1,0,1,0,0,0,
06/10/2014,MICH.,"TIQUICHEO DE NICOLAS ROMERO, MICH.",1,0,1,1,0,0,
06/10/2014,MICH.,"HUETAMO, MICH.",1,0,1,1,0,0,
06/10/2014,N.L.,"SAN NICOLAS DE LOS GARZA, N.L.",0,1,1,0,0,339,
07/10/2014,D.F.,"TLALPAN, D.F.",21,0,21,0,3,0,
07/10/2014,MICH.,"ZINAPECUARO, MICH.",6,4,10,3,0,14,
07/10/2014,B.C.,"TIJUANA, B.C.",3,6,9,0,0,0,
07/10/2014,MICH.,"URUAPAN, MICH.",5,1,6,1,0,2306,
07/10/2014,SON.,"CABORCA, SON.",5,1,6,4,0,110,
07/10/2014,SIN.,"ESCUINAPA, SIN.",3,2,5,0,1,0,
07/10/2014,MICH.,"TIQUICHEO DE NICOLAS ROMERO, MICH.",4,1,5,1,0,0,
07/10/2014,AGS.,"AGS., AGS.",4,1,5,5,0,166,
07/10/2014,SON.,"AGUA PRIETA, SON.",4,1,5,0,0,0,
07/10/2014,MOR.,"CUERNAVACA, MOR.",1,3,4,2,2,250,
07/10/2014,SIN.,"ELOTA, SIN.",1,2,3,0,4,0,
07/10/2014,MICH.,"HUETAMO, MICH.",2,1,3,2,0,0,
07/10/2014,COL.,"COL., COL.",1,2,3,2,0,290,
07/10/2014,SON.,"IMURIS, SON.",3,0,3,2,0,0,
07/10/2014,SON.,"CANANEA, SON.",1,1,2,2,0,336,
07/10/2014,JAL.,"TLAQUEPAQUE, JAL.",0,1,1,0,0,0,
07/10/2014,CHIH.,"JUÁREZ, CHIH.",0,1,1,0,0,0,
07/10/2014,SON.,"NOGALES, SON.",1,0,1,0,0,0,
07/10/2014,SON.,"ALTAR, SON.",1,0,1,1,0,10,
07/10/2014,SON.,"PITIQUITO, SON.",1,0,1,1,0,0,
07/10/2014,SON.,"GENERAL PLUTARCO ELIAS CALLES, SON.",1,0,1,1,0,0,
07/10/2014,PUE.,"ATLIXCO, PUE.",0,0,0,0,0,61,
07/10/2014,COAH.,"SALTILLO, COAH.",0,0,0,0,0,32,
07/10/2014,SON.,"MAGDALENA, SON.",0,0,0,2,0,0,
08/10/2014,D.F.,"TLALPAN, D.F.",33,0,33,0,3,0,
08/10/2014,N.L.,"MONTERREY, N.L.",10,5,15,79,0,12556,
08/10/2014,SON.,"GUAYMAS, SON.",4,1,5,1,0,167,
08/10/2014,SON.,"NAVOJOA, SON.",4,1,5,0,0,79,
08/10/2014,AGS.,"AGS., AGS.",5,0,5,1,0,192,
08/10/2014,MICH.,"URUAPAN, MICH.",1,4,5,4,0,3034,
08/10/2014,SON.,"NOGALES, SON.",3,2,5,1,0,41,
08/10/2014,SON.,"CANANEA, SON.",3,2,5,0,0,275,
08/10/2014,SIN.,"ESCUINAPA, SIN.",1,3,4,0,0,0,
08/10/2014,SON.,"CABORCA, SON.",2,2,4,2,0,20,
08/10/2014,B.C.S.,"COMONDÚ, B.C.S.",0,3,3,0,0,0,
08/10/2014,COAH.,"SALTILLO, COAH.",3,0,3,0,0,408,
08/10/2014,MICH.,"ZINAPECUARO, MICH.",3,0,3,1,0,128,
08/10/2014,MICH.,"TIQUICHEO DE NICOLAS ROMERO, MICH.",2,1,3,3,0,0,
08/10/2014,SON.,"ALAMOS, SON.",2,0,2,1,0,0,
08/10/2014,SON.,"AGUA PRIETA, SON.",1,1,2,0,0,0,
08/10/2014,B.C.,"ENSENADA, B.C.",0,1,1,0,0,0,
08/10/2014,SON.,"CAJEME, SON.",1,0,1,0,0,50,
08/10/2014,SON.,"HUATABAMPO, SON.",1,0,1,0,0,24,
08/10/2014,SON.,"ETCHOJOA, SON.",1,0,1,0,0,0,
08/10/2014,SIN.,"ELOTA, SIN.",1,0,1,0,2,0,
08/10/2014,MICH.,"HUETAMO, MICH.",1,0,1,0,0,0,
08/10/2014,MOR.,"CUERNAVACA, MOR.",1,0,1,0,3,0,
08/10/2014,SON.,"FRONTERAS, SON.",0,1,1,0,0,0,
08/10/2014,SON.,"SANTA ANA, SON.",1,0,1,0,0,0,
08/10/2014,CHIH.,"JUÁREZ, CHIH.",1,0,1,0,0,0,
08/10/2014,PUE.,"PUE., PUE.",0,1,1,0,0,0,
08/10/2014,N.L.,"SAN NICOLAS DE LOS GARZA, N.L.",1,0,1,0,0,50,
08/10/2014,GRO.,"CHILAPA DE ALVAREZ, GRO.",1,0,1,0,0,0,
08/10/2014,COL.,"TECOMÁN, COL.",1,0,1,0,0,0,
08/10/2014,CHIH.,"JUÁREZ, CHIH.",1,0,1,0,0,0,
08/10/2014,GRO.,"CHILAPA DE ALVAREZ, GRO.",1,0,1,0,0,0,
08/10/2014,AGS.,"SAN JOSÉ DE GRACIA, AGS.",0,0,0,1,0,11,
08/10/2014,CHIS.,"UNIÓN JUÁREZ, CHIS.",0,0,0,0,1,0,
08/10/2014,SON.,"MAGDALENA, SON.",0,0,0,0,0,20,
08/10/2014,CHIH.,"NUEVO CASAS GRANDES, CHIH.",0,0,0,0,0,7,
08/10/2014,CHIH.,"CASAS GRANDES, CHIH.",0,0,0,0,0,7,
09/10/2014,D.F.,"TLALPAN, D.F.",30,5,35,0,0,0,
09/10/2014,SIN.,"ESCUINAPA, SIN.",3,2,5,0,0,0,
09/10/2014,SON.,"NOGALES, SON.",5,0,5,2,1,76,
09/10/2014,MICH.,"PARACHO, MICH.",3,1,4,1,0,506,
09/10/2014,SON.,"CABORCA, SON.",3,1,4,0,0,20,
09/10/2014,MOR.,"CUERNAVACA, MOR.",0,4,4,0,0,0,
09/10/2014,N.L.,"MONTERREY, N.L.",3,1,4,65,0,4323,
09/10/2014,SIN.,"ELOTA, SIN.",2,0,2,0,1,0,
09/10/2014,SON.,"CARBO, SON.",2,0,2,0,0,180,
09/10/2014,SON.,"CAJEME, SON.",1,1,2,0,0,4,
09/10/2014,SON.,"BENITO JUAREZ, SON.",2,0,2,0,0,20,
09/10/2014,SON.,"GUAYMAS, SON.",2,0,2,0,0,0,
09/10/2014,SON.,"NAVOJOA, SON.",2,0,2,0,0,73,
09/10/2014,SON.,"ALAMOS, SON.",2,0,2,1,0,0,
09/10/2014,SON.,"CANANEA, SON.",2,0,2,0,0,94,
09/10/2014,SON.,"FRONTERAS, SON.",0,2,2,0,0,0,
09/10/2014,AGS.,"AGS., AGS.",1,1,2,0,0,40,
09/10/2014,N.L.,"SAN NICOLAS DE LOS GARZA, N.L.",2,0,2,0,0,0,
09/10/2014,SON.,"HERMOSILLO, SON.",1,0,1,0,0,2100,
09/10/2014,SON.,"SANTA ANA, SON.",1,0,1,1,0,20,
09/10/2014,SON.,"GENERAL PLUTARCO ELIAS CALLES, SON.",0,1,1,0,0,0,
09/10/2014,NAY.,"ACAPONETA, NAY.",1,0,1,0,0,0,
09/10/2014,SON.,"AGUA PRIETA, SON.",0,0,0,3,0,0,
09/10/2014,SON.,"PUERTO PEÑASCO, SON.",0,0,0,2,0,9,
10/10/2014,D.F.,"TLALPAN, D.F.",31,12,43,0,1,30,
10/10/2014,TAMPS.,"MATAMOROS, TAMPS.",12,6,18,0,0,0,
10/10/2014,SIN.,"ESCUINAPA, SIN.",4,5,9,0,0,0,
10/10/2014,B.C.,"MEXICALI, B.C.",4,4,8,0,0,0,
10/10/2014,N.L.,"MONTERREY, N.L.",6,1,7,131,0,4570,
10/10/2014,SON.,"NAVOJOA, SON.",5,1,6,3,0,0,
10/10/2014,SON.,"NOGALES, SON.",2,4,6,30,0,60,
10/10/2014,SON.,"HERMOSILLO, SON.",5,0,5,0,0,1977,
10/10/2014,B.C.,"TIJUANA, B.C.",4,0,4,0,0,0,
10/10/2014,SIN.,"ELOTA, SIN.",2,2,4,0,0,0,
10/10/2014,MICH.,"PARACHO, MICH.",2,1,3,0,0,1675,
10/10/2014,MOR.,"CUERNAVACA, MOR.",2,1,3,0,2,232,
10/10/2014,B.C.,"ENSENADA, B.C.",2,0,2,0,0,0,
10/10/2014,COAH.,"TORREÓN, COAH.",1,1,2,0,0,391,
10/10/2014,PUE.,"ACATZINGO, PUE.",2,0,2,0,0,0,
10/10/2014,SON.,"EMPALME, SON.",2,0,2,6,0,34,
10/10/2014,SON.,"FRONTERAS, SON.",0,2,2,0,0,0,
10/10/2014,CHIH.,"JUÁREZ, CHIH.",1,0,1,0,0,0,
10/10/2014,SON.,"SAN MIGUEL DE HORCASITAS, SON.",1,0,1,1,0,30,
10/10/2014,SON.,"CAJEME, SON.",1,0,1,0,0,0,
10/10/2014,SON.,"HUATABAMPO, SON.",1,0,1,0,0,0,
10/10/2014,SON.,"SANTA ANA, SON.",1,0,1,0,0,0,
10/10/2014,SON.,"CABORCA, SON.",1,0,1,0,0,0,
10/10/2014,GRO.,"CHILAPA DE ALVAREZ, GRO.",1,0,1,1,0,7,
10/10/2014,SON.,"GUAYMAS, SON.",1,0,1,0,0,0,
10/10/2014,SON.,"ALAMOS, SON.",0,0,0,1,0,28,
10/10/2014,SON.,"CANANEA, SON.",0,0,0,0,1,4,
10/10/2014,N.L.,"SAN NICOLAS DE LOS GARZA, N.L.",0,0,0,68,0,0,
11/10/2014,SON.,"SAN LUIS RIO COLORADO, SON.",8,10,18,3,0,600,
11/10/2014,SON.,"HERMOSILLO, SON.",9,0,9,27,0,911,
11/10/2014,SON.,"NOGALES, SON.",3,2,5,2,0,127,
11/10/2014,MOR.,"CUERNAVACA, MOR.",4,1,5,3,2,292,
11/10/2014,SON.,"CAJEME, SON.",3,1,4,2,0,8,
11/10/2014,SON.,"NAVOJOA, SON.",3,0,3,0,0,460,
11/10/2014,SON.,"ALAMOS, SON.",3,0,3,1,0,0,
11/10/2014,MICH.,"PARACHO, MICH.",1,2,3,0,0,2694,
11/10/2014,TAMPS.,"MATAMOROS, TAMPS.",0,3,3,0,0,0,
11/10/2014,SON.,"CABORCA, SON.",0,3,3,0,0,0,
11/10/2014,SON.,"ETCHOJOA, SON.",2,0,2,0,0,0,
11/10/2014,SON.,"FRONTERAS, SON.",0,2,2,0,0,0,
11/10/2014,SON.,"GENERAL PLUTARCO ELIAS CALLES, SON.",2,0,2,0,0,0,
11/10/2014,SON.,"SAN MIGUEL DE HORCASITAS, SON.",0,1,1,0,0,0,
11/10/2014,SON.,"BENITO JUAREZ, SON.",1,0,1,0,0,0,
11/10/2014,SON.,"EMPALME, SON.",0,1,1,0,0,0,
11/10/2014,MICH.,"AGUILILLA, MICH.",0,1,1,1,0,0,
11/10/2014,SON.,"MAGDALENA, SON.",0,1,1,0,0,0,
11/10/2014,SON.,"CANANEA, SON.",0,1,1,0,0,0,
11/10/2014,GRO.,"COAHUAYUTLA DE JOSE MARIA IZAZAGA, GRO.",0,1,1,0,0,0,
11/10/2014,TLAX.,"TLAX., TLAX.",0,1,1,0,0,0,
11/10/2014,N.L.,"GUADALUPE, N.L.",0,0,0,2,0,2000,
12/10/2014,MOR.,"CUERNAVACA, MOR.",3,1,4,3,2,605,
12/10/2014,GRO.,"TECPAN DE GALEANA, GRO.",0,2,2,0,0,0,
12/10/2014,MICH.,"PARACHO, MICH.",1,0,1,0,0,3579,
12/10/2014,MICH.,"PARACHO, MICH.",1,0,1,0,0,357,
13/10/2014,D.F.,"GUSTAVO A. MADERO, D.F.",27,1,28,0,2,0,
13/10/2014,GTO.,"SALAMANCA, GTO.",9,5,14,0,0,0,
13/10/2014,SON.,"SAN LUIS RIO COLORADO, SON.",4,2,6,2,0,0,
13/10/2014,TLAX.,"TLAX., TLAX.",3,2,5,2,0,2,
13/10/2014,SON.,"ALTAR, SON.",2,3,5,1,0,0,
13/10/2014,SON.,"CANANEA, SON.",2,2,4,1,0,0,
13/10/2014,SON.,"NAVOJOA, SON.",3,1,4,0,0,20,
13/10/2014,SON.,"ALAMOS, SON.",2,1,3,1,0,0,
13/10/2014,MOR.,"CUERNAVACA, MOR.",0,2,2,0,1,0,
13/10/2014,SON.,"NOGALES, SON.",1,1,2,19,1,39,
13/10/2014,SON.,"CABORCA, SON.",1,1,2,0,0,0,
13/10/2014,B.C.,"TIJUANA, B.C.",0,2,2,0,0,0,
13/10/2014,SON.,"HERMOSILLO, SON.",1,1,2,6,0,60,
13/10/2014,SIN.,"CONCORDIA, SIN.",1,1,2,0,0,0,
13/10/2014,MICH.,"AGUILILLA, MICH.",2,0,2,2,0,0,
13/10/2014,MICH.,"PARACHO, MICH.",1,1,2,0,0,1533,
13/10/2014,TAMPS.,"LLERA, TAMPS.",1,1,2,0,0,0,
13/10/2014,MICH.,"AGUILILLA, MICH.",2,0,2,2,0,0,
13/10/2014,COL.,"COL., COL.",0,1,1,0,0,0,
13/10/2014,SON.,"AGUA PRIETA, SON.",0,1,1,0,0,0,
13/10/2014,SON.,"PUERTO PEÑASCO, SON.",1,0,1,0,0,0,
13/10/2014,SON.,"SAHUARIPA, SON.",0,1,1,0,0,0,
13/10/2014,SON.,"GUAYMAS, SON.",1,0,1,0,0,40,
13/10/2014,N.L.,"GUADALUPE, N.L.",0,1,1,0,0,0,
13/10/2014,NAY.,"ACAPONETA, NAY.",1,0,1,0,0,0,
13/10/2014,CHIH.,"JUÁREZ, CHIH.",0,1,1,0,0,0,
13/10/2014,GRO.,"TECPAN DE GALEANA, GRO.",1,0,1,0,0,0,
13/10/2014,GRO.,"COAHUAYUTLA DE JOSE MARIA IZAZAGA, GRO.",1,0,1,0,0,0,
13/10/2014,SON.,"IMURIS, SON.",0,0,0,1,0,0,
13/10/2014,SON.,"SANTA ANA, SON.",0,0,0,12,0,0,
13/10/2014,COAH.,"SALTILLO, COAH.",0,0,0,0,0,151,
14/10/2014,D.F.,"GUSTAVO A. MADERO, D.F.",20,4,24,0,0,0,
14/10/2014,GTO.,"SALAMANCA, GTO.",14,10,24,0,1,30,
14/10/2014,SON.,"HERMOSILLO, SON.",11,1,12,12,0,154,
14/10/2014,SON.,"SAN LUIS RIO COLORADO, SON.",2,5,7,2,0,176,
14/10/2014,SON.,"NOGALES, SON.",5,1,6,2,0,65,
14/10/2014,MOR.,"CUERNAVACA, MOR.",4,2,6,1,3,35,
14/10/2014,TLAX.,"TLAX., TLAX.",4,2,6,1,0,0,
14/10/2014,GRO.,"CHILPANCINGO DE LOS BRAVO, GRO.",4,2,6,0,0,0,
14/10/2014,SIN.,"CONCORDIA, SIN.",5,0,5,0,0,0,
14/10/2014,MICH.,"PARACHO, MICH.",2,2,4,0,0,487,
14/10/2014,SON.,"CABORCA, SON.",1,3,4,0,0,60,
14/10/2014,B.C.,"ENSENADA, B.C.",0,4,4,0,0,0,
14/10/2014,N.L.,"GUADALUPE, N.L.",1,2,3,0,0,1189,
14/10/2014,MICH.,"CHURUMUCO, MICH.",2,1,3,0,0,0,
14/10/2014,SON.,"GUAYMAS, SON.",0,3,3,0,0,143,
14/10/2014,SON.,"NAVOJOA, SON.",3,0,3,2,0,0,
14/10/2014,JAL.,"ZAPOPAN, JAL.",2,1,3,0,0,0,
14/10/2014,SON.,"ALAMOS, SON.",1,1,2,0,0,0,
14/10/2014,TAMPS.,"RIO BRAVO, TAMPS.",2,0,2,4,0,0,
14/10/2014,SON.,"IMURIS, SON.",0,1,1,0,0,0,
14/10/2014,SON.,"CANANEA, SON.",1,0,1,0,0,60,
14/10/2014,SON.,"AGUA PRIETA, SON.",0,1,1,0,0,0,
14/10/2014,SON.,"FRONTERAS, SON.",0,1,1,0,0,0,
14/10/2014,SON.,"PUERTO PEÑASCO, SON.",1,0,1,0,0,0,
14/10/2014,SON.,"PITIQUITO, SON.",1,0,1,0,0,0,
14/10/2014,SON.,"SAN MIGUEL DE HORCASITAS, SON.",1,0,1,0,0,6,
14/10/2014,SON.,"CAJEME, SON.",1,0,1,2,0,20,
14/10/2014,SON.,"SAHUARIPA, SON.",1,0,1,0,0,0,
14/10/2014,SON.,"ETCHOJOA, SON.",1,0,1,0,0,0,
14/10/2014,COL.,"COL., COL.",1,0,1,0,0,0,
14/10/2014,AGS.,"AGS., AGS.",1,0,1,1,0,0,
14/10/2014,B.C.,"ENSENADA, B.C.",0,1,1,0,0,0,
14/10/2014,COAH.,"SALTILLO, COAH.",0,0,0,2,0,254,
15/10/2014,GTO.,"SALAMANCA, GTO.",16,12,28,0,0,0,
15/10/2014,D.F.,"GUSTAVO A. MADERO, D.F.",25,1,26,0,0,0,
15/10/2014,TAMPS.,"RIO BRAVO, TAMPS.",3,4,7,0,0,400,
15/10/2014,SON.,"HERMOSILLO, SON.",5,0,5,63,0,20,
15/10/2014,SON.,"CAJEME, SON.",4,1,5,1,0,0,
15/10/2014,COAH.,"TORREÓN, COAH.",4,0,4,0,0,0,
15/10/2014,TLAX.,"TLAX., TLAX.",4,0,4,4,0,0,
15/10/2014,SIN.,"CONCORDIA, SIN.",2,2,4,0,0,0,
15/10/2014,SON.,"NAVOJOA, SON.",2,1,3,0,0,0,
15/10/2014,SON.,"ALAMOS, SON.",2,1,3,0,0,0,
15/10/2014,MICH.,"PARACHO, MICH.",1,2,3,0,0,1754,
15/10/2014,MICH.,"AGUILILLA, MICH.",2,0,2,1,0,0,
15/10/2014,B.C.,"TIJUANA, B.C.",1,1,2,0,0,0,
15/10/2014,YUC.,"TIXCACALCUPUL, YUC.",0,1,1,0,0,0,
15/10/2014,COAH.,"SALTILLO, COAH.",1,0,1,0,0,175,
15/10/2014,CHIH.,"JUÁREZ, CHIH.",1,0,1,0,0,0,
15/10/2014,SON.,"SAN MIGUEL DE HORCASITAS, SON.",1,0,1,0,0,14,
15/10/2014,SON.,"HUATABAMPO, SON.",1,0,1,0,0,0,
15/10/2014,AGS.,"AGS., AGS.",1,0,1,4,0,45,
15/10/2014,COL.,"TECOMÁN, COL.",0,1,1,0,0,0,
15/10/2014,SON.,"GUAYMAS, SON.",0,0,0,1,0,7,
15/10/2014,SON.,"EMPALME, SON.",0,0,0,0,0,9,
15/10/2014,SON.,"ETCHOJOA, SON.",0,0,0,0,0,16,
15/10/2014,PUE.,"ACATZINGO, PUE.",0,0,0,0,1,13,
16/10/2014,GTO.,"SALAMANCA, GTO.",22,5,27,0,0,0,
16/10/2014,D.F.,"GUSTAVO A. MADERO, D.F.",17,0,17,0,0,500,
16/10/2014,SON.,"CABORCA, SON.",4,1,5,0,0,0,
16/10/2014,SON.,"SAN LUIS RIO COLORADO, SON.",1,4,5,2,0,75,
16/10/2014,TLAX.,"TLAX., TLAX.",3,1,4,2,0,0,
16/10/2014,CHIH.,"JUÁREZ, CHIH.",2,2,4,0,0,0,
16/10/2014,MICH.,"PATZCUARO, MICH.",0,3,3,0,0,0,
16/10/2014,SON.,"HERMOSILLO, SON.",3,0,3,1,0,40,
16/10/2014,MOR.,"CUERNAVACA, MOR.",2,0,2,0,0,20,
16/10/2014,AGS.,"AGS., AGS.",1,1,2,0,0,0,
16/10/2014,GRO.,"TELOLOAPAN, GRO.",1,1,2,0,0,0,
16/10/2014,MICH.,"HGO., MICH.",1,1,2,1,0,89,
16/10/2014,SON.,"NOGALES, SON.",1,1,2,0,0,83,
16/10/2014,SON.,"CANANEA, SON.",2,0,2,0,0,20,
16/10/2014,SON.,"AGUA PRIETA, SON.",0,2,2,1,0,10,
16/10/2014,SON.,"PITIQUITO, SON.",0,2,2,0,0,0,
16/10/2014,SON.,"NAVOJOA, SON.",2,0,2,2,0,117,
16/10/2014,COL.,"COL., COL.",1,0,1,0,0,0,
16/10/2014,CHIH.,"HGO. DEL PARRAL, CHIH.",0,1,1,0,0,0,
16/10/2014,SON.,"SANTA ANA, SON.",1,0,1,0,0,40,
16/10/2014,SON.,"FRONTERAS, SON.",0,1,1,0,0,0,
16/10/2014,SON.,"CAJEME, SON.",1,0,1,6,0,0,
16/10/2014,SON.,"BENITO JUAREZ, SON.",1,0,1,7,0,0,
16/10/2014,COAH.,"SALTILLO, COAH.",1,0,1,0,0,195,
16/10/2014,SIN.,"CONCORDIA, SIN.",1,0,1,0,0,0,
16/10/2014,AGS.,"SAN JOSÉ DE GRACIA, AGS.",0,0,0,1,0,170,
16/10/2014,N.L.,"SANTA CATARINA, N.L.",0,0,0,33,0,0,
16/10/2014,N.L.,"GUADALUPE, N.L.",0,0,0,0,0,100,
16/10/2014,GRO.,"ACAPULCO DE JUAREZ, GRO.",0,0,0,0,0,26,
17/10/2014,D.F.,"GUSTAVO A. MADERO, D.F.",37,0,37,0,0,70,
17/10/2014,TAMPS.,"MATAMOROS, TAMPS.",8,11,19,1,0,80,
17/10/2014,CHIS.,"COMITAN DE DOMÍNGUEZ, CHIS.",7,10,17,3,0,31,
17/10/2014,CHIS.,"TAPACHULA, CHIS.",8,3,11,0,1,67,
17/10/2014,MICH.,"ARIO, MICH.",9,0,9,0,0,530,
17/10/2014,MICH.,"ZACAPU, MICH.",5,3,8,2,0,100,
17/10/2014,MOR.,"CUERNAVACA, MOR.",4,4,8,0,1,23,
17/10/2014,CHIS.,"OCOZOCOAUTLA DE ESPINOSA, CHIS.",4,3,7,0,0,11,
17/10/2014,SON.,"HERMOSILLO, SON.",4,2,6,12,0,240,
17/10/2014,SON.,"NAVOJOA, SON.",5,1,6,5,0,0,
17/10/2014,CHIS.,"TUXTLA GUTIÉRREZ, CHIS.",3,3,6,6,3,434,
17/10/2014,SON.,"NOGALES, SON.",4,1,5,1,0,98,
17/10/2014,B.C.,"ENSENADA, B.C.",1,3,4,0,0,0,
17/10/2014,MICH.,"HGO., MICH.",3,1,4,0,0,0,
17/10/2014,MICH.,"HGO., MICH.",3,1,4,0,0,0,
17/10/2014,CHIS.,"SAN CRISTOBAL DE LAS CASAS, CHIS.",1,3,4,0,1,0,
17/10/2014,CHIS.,"PICHUCALCO, CHIS.",1,2,3,0,0,0,
17/10/2014,SON.,"CAJEME, SON.",1,1,2,0,0,0,
17/10/2014,SON.,"ALAMOS, SON.",2,0,2,0,0,0,
17/10/2014,ZAC.,"GUADALUPE, ZAC.",1,1,2,0,0,0,
17/10/2014,CHIS.,"VILLAFLORES, CHIS.",1,1,2,0,0,0,
17/10/2014,SON.,"BENITO JUAREZ, SON.",1,0,1,0,0,20,
17/10/2014,SON.,"SAHUARIPA, SON.",1,0,1,0,0,0,
17/10/2014,SON.,"GUAYMAS, SON.",1,0,1,1,0,71,
17/10/2014,SON.,"EMPALME, SON.",1,0,1,0,0,17,
17/10/2014,ZAC.,"TRINIDAD GARCIA DE LA CADENA, ZAC.",0,1,1,0,0,10,
17/10/2014,AGS.,"AGS., AGS.",1,0,1,0,0,0,
17/10/2014,JAL.,"TLAQUEPAQUE, JAL.",1,0,1,0,1,0,
17/10/2014,SON.,"CANANEA, SON.",1,0,1,0,0,0,
17/10/2014,SON.,"PUERTO PEÑASCO, SON.",1,0,1,0,0,0,
17/10/2014,COAH.,"SALTILLO, COAH.",0,0,0,0,0,109,
17/10/2014,SIN.,"CONCORDIA, SIN.",0,0,0,0,7,0,
17/10/2014,SON.,"MAGDALENA, SON.",0,0,0,1,0,0,
18/10/2014,TAMPS.,"REYNOSA, TAMPS.",10,7,17,0,0,0,
18/10/2014,CHIS.,"TAPACHULA, CHIS.",9,4,13,0,0,101,
18/10/2014,MICH.,"PATZCUARO, MICH.",8,2,10,5,0,0,
18/10/2014,CHIS.,"COMITAN DE DOMÍNGUEZ, CHIS.",5,4,9,6,0,283,
18/10/2014,MICH.,"PATZCUARO, MICH.",4,4,8,1,0,0,
18/10/2014,CHIS.,"OCOZOCOAUTLA DE ESPINOSA, CHIS.",4,4,8,0,0,138,
18/10/2014,SON.,"HERMOSILLO, SON.",4,2,6,26,0,44,
18/10/2014,CHIS.,"VILLAFLORES, CHIS.",5,1,6,0,0,0,
18/10/2014,CHIS.,"SAN CRISTOBAL DE LAS CASAS, CHIS.",1,4,5,0,0,9,
18/10/2014,SON.,"NOGALES, SON.",4,1,5,1,0,98,
18/10/2014,SON.,"SAN LUIS RIO COLORADO, SON.",5,0,5,0,0,0,
18/10/2014,MOR.,"CUERNAVACA, MOR.",3,1,4,0,2,0,
18/10/2014,CHIS.,"PICHUCALCO, CHIS.",4,0,4,0,0,0,
18/10/2014,CHIS.,"TUXTLA GUTIÉRREZ, CHIS.",3,1,4,1,1,569,
18/10/2014,CHIS.,"TONALÁ, CHIS.",1,3,4,1,0,2,
18/10/2014,CHIS.,"OCOSINGO, CHIS.",2,1,3,1,0,0,
18/10/2014,MICH.,"ZACAPU, MICH.",2,0,2,1,0,1100,
18/10/2014,SON.,"SAN MIGUEL DE HORCASITAS, SON.",2,0,2,0,0,0,
18/10/2014,SON.,"CAJEME, SON.",2,0,2,0,0,0,
18/10/2014,B.C.S.,"COMONDÚ, B.C.S.",0,1,1,0,0,0,
18/10/2014,TLAX.,"ZACATELCO, TLAX.",0,1,1,0,0,0,
18/10/2014,GRO.,"ACAPULCO DE JUAREZ, GRO.",0,1,1,0,0,0,
18/10/2014,N.L.,"SANTA CATARINA, N.L.",0,1,1,0,0,236,
18/10/2014,ZAC.,"TRINIDAD GARCIA DE LA CADENA, ZAC.",0,1,1,0,0,0,
18/10/2014,SON.,"CANANEA, SON.",1,0,1,0,0,0,
18/10/2014,SON.,"PUERTO PEÑASCO, SON.",1,0,1,0,0,0,
18/10/2014,CHIS.,"PALENQUE, CHIS.",1,0,1,0,0,131,
18/10/2014,N.L.,"GUADALUPE, N.L.",0,0,0,1,0,0,
18/10/2014,SON.,"MAGDALENA, SON.",0,0,0,1,0,0,
19/10/2014,MICH.,"ARIO, MICH.",7,6,13,0,0,1686,
19/10/2014,CHIS.,"COMITAN DE DOMÍNGUEZ, CHIS.",5,7,12,0,0,669,
19/10/2014,B.C.,"TIJUANA, B.C.",4,3,7,0,0,0,
19/10/2014,CHIS.,"VILLAFLORES, CHIS.",4,2,6,3,0,0,
19/10/2014,MOR.,"CUERNAVACA, MOR.",5,0,5,0,2,174,
19/10/2014,CHIS.,"TAPACHULA, CHIS.",4,1,5,0,0,572,
19/10/2014,GRO.,"TELOLOAPAN, GRO.",1,3,4,0,0,0,
19/10/2014,CHIS.,"TUXTLA GUTIÉRREZ, CHIS.",4,0,4,4,0,1170,
19/10/2014,MICH.,"HGO., MICH.",2,1,3,1,0,0,
19/10/2014,CHIS.,"OCOZOCOAUTLA DE ESPINOSA, CHIS.",0,3,3,0,0,68,
19/10/2014,MICH.,"PATZCUARO, MICH.",2,0,2,1,0,0,
19/10/2014,SON.,"BENITO JUAREZ, SON.",0,2,2,0,0,0,
19/10/2014,CHIS.,"SAN CRISTOBAL DE LAS CASAS, CHIS.",2,0,2,0,0,0,
19/10/2014,CHIS.,"PICHUCALCO, CHIS.",2,0,2,0,0,0,
19/10/2014,ZAC.,"TRINIDAD GARCIA DE LA CADENA, ZAC.",0,1,1,0,0,0,
19/10/2014,MICH.,"ZACAPU, MICH.",1,0,1,0,0,6240,
19/10/2014,CHIS.,"TONALÁ, CHIS.",0,1,1,0,0,40,
19/10/2014,CHIS.,"OCOSINGO, CHIS.",1,0,1,0,0,0,
19/10/2014,B.C.S.,"COMONDÚ, B.C.S.",0,1,1,0,0,0,
19/10/2014,S.L.P.,"SAN LUIS POTOSI, S.L.P.",0,0,0,0,1,0,
19/10/2014,N.L.,"GUADALUPE, N.L.",0,0,0,1,0,114,
20/10/2014,D.F.,"COYOACAN, D.F.",18,5,23,0,0,130,
20/10/2014,CHIS.,"COMITAN DE DOMÍNGUEZ, CHIS.",8,6,14,6,0,485,
20/10/2014,CHIS.,"TAPACHULA, CHIS.",10,3,13,0,0,27,
20/10/2014,CHIS.,"OCOZOCOAUTLA DE ESPINOSA, CHIS.",8,3,11,0,0,5,
20/10/2014,CHIS.,"TUXTLA GUTIÉRREZ, CHIS.",5,5,10,2,6,961,
20/10/2014,SON.,"SAN LUIS RIO COLORADO, SON.",4,3,7,2,1,33,
20/10/2014,SON.,"NOGALES, SON.",4,1,5,3,0,153,
20/10/2014,CHIS.,"SAN CRISTOBAL DE LAS CASAS, CHIS.",4,1,5,0,0,0,
20/10/2014,MICH.,"PATZCUARO, MICH.",2,2,4,4,0,0,
20/10/2014,MICH.,"HGO., MICH.",3,0,3,2,0,0,
20/10/2014,SON.,"GENERAL PLUTARCO ELIAS CALLES, SON.",1,2,3,0,0,0,
20/10/2014,SON.,"CABORCA, SON.",2,1,3,1,0,70,
20/10/2014,MICH.,"ZACAPU, MICH.",2,0,2,2,0,980,
20/10/2014,TAMPS.,"PADILLA, TAMPS.",0,2,2,0,0,0,
20/10/2014,VER.,"SOLEDAD DE DOBLADO, VER.",1,1,2,0,0,0,
20/10/2014,TLAX.,"ZACATELCO, TLAX.",2,0,2,0,0,0,
20/10/2014,SON.,"MAGDALENA, SON.",1,1,2,0,0,0,
20/10/2014,SON.,"SANTA ANA, SON.",0,2,2,2,0,50,
20/10/2014,CHIS.,"VILLAFLORES, CHIS.",1,1,2,0,0,0,
20/10/2014,COL.,"TECOMÁN, COL.",0,1,1,0,0,0,
20/10/2014,MICH.,"ARIO, MICH.",1,0,1,0,0,0,
20/10/2014,N.L.,"SANTA CATARINA, N.L.",1,0,1,0,0,98,
20/10/2014,SON.,"IMURIS, SON.",1,0,1,0,0,0,
20/10/2014,SON.,"CANANEA, SON.",1,0,1,1,0,0,
20/10/2014,SON.,"AGUA PRIETA, SON.",1,0,1,1,0,200,
20/10/2014,CHIS.,"PICHUCALCO, CHIS.",0,0,0,1,1,19,
21/10/2014,D.F.,"COYOACAN, D.F.",28,2,30,0,1,100,
21/10/2014,CHIS.,"TUXTLA GUTIÉRREZ, CHIS.",18,8,26,17,0,1724,
21/10/2014,CHIS.,"VILLAFLORES, CHIS.",7,5,12,2,0,0,
21/10/2014,MICH.,"ARIO, MICH.",5,6,11,0,0,0,
21/10/2014,CHIS.,"TAPACHULA, CHIS.",7,3,10,0,1,114,
21/10/2014,MICH.,"HGO., MICH.",8,1,9,3,0,12,
21/10/2014,CHIS.,"COMITAN DE DOMÍNGUEZ, CHIS.",7,1,8,6,0,587,
21/10/2014,MICH.,"PATZCUARO, MICH.",5,1,6,2,0,0,
21/10/2014,CHIS.,"OCOZOCOAUTLA DE ESPINOSA, CHIS.",2,4,6,1,0,8,
21/10/2014,SON.,"CABORCA, SON.",3,2,5,10,0,0,
21/10/2014,SON.,"SAN LUIS RIO COLORADO, SON.",2,3,5,1,0,53,
21/10/2014,MICH.,"ZACAPU, MICH.",3,1,4,1,0,7553,
21/10/2014,NAY.,"AHUACATLAN, NAY.",0,4,4,0,0,0,
21/10/2014,JAL.,"TLAQUEPAQUE, JAL.",2,1,3,0,0,0,
21/10/2014,COAH.,"TORREÓN, COAH.",3,0,3,0,0,0,
21/10/2014,SIN.,"CONCORDIA, SIN.",2,1,3,0,0,0,
21/10/2014,CHIS.,"TONALÁ, CHIS.",2,1,3,1,0,11,
21/10/2014,CHIS.,"SAN CRISTOBAL DE LAS CASAS, CHIS.",0,3,3,0,0,0,
21/10/2014,MOR.,"CUERNAVACA, MOR.",1,2,3,0,0,0,
21/10/2014,COAH.,"SALTILLO, COAH.",2,0,2,0,0,51,
21/10/2014,SON.,"FRONTERAS, SON.",0,2,2,0,0,0,
21/10/2014,SON.,"PITIQUITO, SON.",2,0,2,0,0,0,
21/10/2014,CHIS.,"OCOSINGO, CHIS.",2,0,2,2,0,84,
21/10/2014,GRO.,"ACAPULCO DE JUAREZ, GRO.",1,0,1,0,0,0,
21/10/2014,GRO.,"PETATLAN, GRO.",0,1,1,0,0,0,
21/10/2014,SON.,"HERMOSILLO, SON.",1,0,1,6,0,200,
21/10/2014,SON.,"CAJEME, SON.",1,0,1,0,1,0,
21/10/2014,SON.,"GUAYMAS, SON.",1,0,1,0,0,50,
21/10/2014,GRO.,"TELOLOAPAN, GRO.",1,0,1,0,0,0,
21/10/2014,SON.,"NOGALES, SON.",1,0,1,0,0,8,
21/10/2014,SON.,"AGUA PRIETA, SON.",1,0,1,0,0,0,
21/10/2014,SON.,"FRONTERAS, SON.",0,1,1,1,0,0,
21/10/2014,N.L.,"GRAL. ESCOBEDO, N.L.",0,0,0,0,0,1000,
21/10/2014,SON.,"SANTA ANA, SON.",0,0,0,12,0,0,
21/10/2014,SON.,"CANANEA, SON.",0,0,0,3,1,25,
21/10/2014,B.C.,"ENSENADA, B.C.",0,0,0,0,1,0,
22/10/2014,D.F.,"COYOACAN, D.F.",38,24,62,0,0,50,
22/10/2014,CHIS.,"TUXTLA GUTIÉRREZ, CHIS.",14,5,19,11,2,591,
22/10/2014,CHIS.,"VILLAFLORES, CHIS.",8,6,14,2,0,0,
22/10/2014,MICH.,"ARIO, MICH.",5,3,8,0,0,0,
22/10/2014,CHIS.,"COMITAN DE DOMÍNGUEZ, CHIS.",4,3,7,2,0,294,
22/10/2014,CHIS.,"TAPACHULA, CHIS.",6,1,7,10,0,611,
22/10/2014,MICH.,"PATZCUARO, MICH.",4,1,5,1,0,0,
22/10/2014,CHIS.,"OCOZOCOAUTLA DE ESPINOSA, CHIS.",3,2,5,1,0,6,
22/10/2014,MICH.,"HGO., MICH.",1,3,4,0,0,77,
22/10/2014,MICH.,"ZACAPU, MICH.",2,2,4,2,0,1015,
22/10/2014,CHIS.,"SAN CRISTOBAL DE LAS CASAS, CHIS.",2,2,4,0,0,50,
22/10/2014,MOR.,"CUERNAVACA, MOR.",3,0,3,0,1,43,
22/10/2014,AGS.,"AGS., AGS.",0,3,3,0,0,28,
22/10/2014,CHIS.,"PICHUCALCO, CHIS.",2,1,3,0,0,74,
22/10/2014,CHIS.,"TONALÁ, CHIS.",0,3,3,0,0,95,
22/10/2014,B.C.,"ENSENADA, B.C.",0,2,2,0,0,0,
22/10/2014,ZAC.,"GUADALUPE, ZAC.",0,2,2,0,0,0,
22/10/2014,VER.,"SOLEDAD DE DOBLADO, VER.",1,0,1,0,0,0,
22/10/2014,GRO.,"ACAPULCO DE JUAREZ, GRO.",0,1,1,0,0,0,
22/10/2014,GRO.,"PETATLAN, GRO.",1,0,1,0,0,0,
22/10/2014,N.L.,"APODACA, N.L.",0,0,0,1,0,130,
23/10/2014,CHIS.,"TUXTLA GUTIÉRREZ, CHIS.",20,3,23,9,0,787,
23/10/2014,D.F.,"COYOACAN, D.F.",17,3,20,0,0,500,
23/10/2014,CHIS.,"COMITAN DE DOMÍNGUEZ, CHIS.",12,5,17,0,0,698,
23/10/2014,CHIS.,"VILLAFLORES, CHIS.",9,7,16,1,0,0,
23/10/2014,MICH.,"MORELIA, MICH.",5,3,8,2,0,220,
23/10/2014,CHIS.,"OCOZOCOAUTLA DE ESPINOSA, CHIS.",2,4,6,0,0,150,
23/10/2014,SON.,"GUAYMAS, SON.",1,3,4,1,0,94,
23/10/2014,CHIH.,"JUÁREZ, CHIH.",0,4,4,0,0,0,
23/10/2014,NAY.,"AHUACATLAN, NAY.",0,4,4,0,0,0,
23/10/2014,MICH.,"ZAMORA, MICH.",2,1,3,1,0,3992,
23/10/2014,CHIS.,"OCOSINGO, CHIS.",2,1,3,0,0,55,
23/10/2014,CHIS.,"SAN CRISTOBAL DE LAS CASAS, CHIS.",0,3,3,0,0,40,
23/10/2014,CHIS.,"TAPACHULA, CHIS.",3,0,3,0,0,44,
23/10/2014,SON.,"CABORCA, SON.",2,1,3,0,0,0,
23/10/2014,SON.,"SAN LUIS RIO COLORADO, SON.",3,0,3,0,0,0,
23/10/2014,AGS.,"AGS., AGS.",2,1,3,0,0,10,
23/10/2014,MOR.,"CUERNAVACA, MOR.",0,2,2,0,6,0,
23/10/2014,SON.,"NAVOJOA, SON.",2,0,2,0,0,0,
23/10/2014,CHIS.,"TONALÁ, CHIS.",0,2,2,1,0,101,
23/10/2014,SIN.,"CONCORDIA, SIN.",1,0,1,0,4,0,
23/10/2014,COL.,"TECOMÁN, COL.",1,0,1,0,0,0,
23/10/2014,VER.,"SOLEDAD DE DOBLADO, VER.",1,0,1,0,0,0,
23/10/2014,TLAX.,"ZACATELCO, TLAX.",1,0,1,0,0,0,
23/10/2014,S.L.P.,"SAN LUIS POTOSI, S.L.P.",1,0,1,0,0,0,
23/10/2014,N.L.,"GRAL. ESCOBEDO, N.L.",1,0,1,0,0,0,
23/10/2014,SON.,"HERMOSILLO, SON.",1,0,1,10,0,0,
23/10/2014,SON.,"EMPALME, SON.",0,1,1,0,0,0,
23/10/2014,SON.,"ETCHOJOA, SON.",1,0,1,1,0,0,
23/10/2014,SON.,"NOGALES, SON.",0,1,1,6,0,1,
23/10/2014,SON.,"PUERTO PEÑASCO, SON.",1,0,1,0,0,0,
23/10/2014,SON.,"PITIQUITO, SON.",1,0,1,0,0,0,
23/10/2014,GRO.,"PETATLAN, GRO.",1,0,1,0,0,0,
23/10/2014,MICH.,"TEPALCATEPEC, MICH.",1,0,1,0,0,9,
23/10/2014,SON.,"SANTA ANA, SON.",0,0,0,7,0,0,
24/10/2014,D.F.,"COYOACAN, D.F.",18,1,19,0,0,250,
24/10/2014,CHIS.,"VILLAFLORES, CHIS.",10,6,16,0,0,0,
24/10/2014,CHIS.,"TUXTLA GUTIÉRREZ, CHIS.",11,4,15,1,2,2001,
24/10/2014,TAMPS.,"MATAMOROS, TAMPS.",10,3,13,0,0,0,
24/10/2014,CHIS.,"COMITAN DE DOMÍNGUEZ, CHIS.",3,8,11,1,1,445,
24/10/2014,CHIS.,"TAPACHULA, CHIS.",6,3,9,2,0,276,
24/10/2014,MICH.,"ZAMORA, MICH.",5,2,7,3,0,4815,
24/10/2014,NAY.,"AHUACATLAN, NAY.",1,5,6,0,0,0,
24/10/2014,SON.,"NAVOJOA, SON.",5,0,5,1,0,0,
24/10/2014,MOR.,"CUERNAVACA, MOR.",4,1,5,0,1,311,
24/10/2014,CHIS.,"PALENQUE, CHIS.",1,2,3,0,0,0,
24/10/2014,AGS.,"AGS., AGS.",2,1,3,0,0,17,
24/10/2014,CHIS.,"PICHUCALCO, CHIS.",0,3,3,0,0,89,
24/10/2014,SIN.,"CONCORDIA, SIN.",1,2,3,0,3,0,
24/10/2014,B.C.,"TIJUANA, B.C.",1,2,3,0,0,0,
24/10/2014,CHIS.,"TONALÁ, CHIS.",1,2,3,1,0,280,
24/10/2014,CHIS.,"OCOZOCOAUTLA DE ESPINOSA, CHIS.",2,1,3,0,0,68,
24/10/2014,MICH.,"MORELIA, MICH.",2,0,2,2,0,0,
24/10/2014,MICH.,"TACAMBARO, MICH.",1,1,2,0,0,400,
24/10/2014,MICH.,"TEPALCATEPEC, MICH.",2,0,2,0,0,24,
24/10/2014,SON.,"SANTA ANA, SON.",0,2,2,0,0,0,
24/10/2014,SON.,"GENERAL PLUTARCO ELIAS CALLES, SON.",1,1,2,0,0,0,
24/10/2014,TAMPS.,"PADILLA, TAMPS.",1,0,1,3,0,100,
24/10/2014,MICH.,"LAZARO CARDENAS, MICH.",1,0,1,0,0,138,
24/10/2014,ZAC.,"GUADALUPE, ZAC.",0,1,1,0,0,0,
24/10/2014,TAMPS.,"PADILLA, TAMPS.",1,0,1,3,0,190,
24/10/2014,SON.,"SAN MIGUEL DE HORCASITAS, SON.",0,1,1,0,0,0,
24/10/2014,SON.,"CAJEME, SON.",1,0,1,0,0,0,
24/10/2014,SON.,"ETCHOJOA, SON.",1,0,1,0,0,0,
24/10/2014,SON.,"NOGALES, SON.",0,1,1,1,0,153,
24/10/2014,SON.,"CANANEA, SON.",0,1,1,0,0,410,
24/10/2014,SON.,"PUERTO PEÑASCO, SON.",1,0,1,0,0,0,
24/10/2014,SON.,"CABORCA, SON.",0,1,1,0,0,0,
24/10/2014,SON.,"SAN LUIS RIO COLORADO, SON.",1,0,1,5,0,0,
24/10/2014,MOR.,"CUERNAVACA, MOR.",0,0,0,0,1,300,
24/10/2014,CHIS.,"OCOSINGO, CHIS.",0,0,0,3,0,90,
24/10/2014,SON.,"HERMOSILLO, SON.",0,0,0,11,0,910,
24/10/2014,N.L.,"GRAL. ESCOBEDO, N.L.",0,0,0,0,0,250,
25/10/2014,CHIS.,"TUXTLA GUTIÉRREZ, CHIS.",13,1,14,7,1,1090,
25/10/2014,CHIS.,"COMITAN DE DOMÍNGUEZ, CHIS.",8,4,12,2,0,27,
25/10/2014,MICH.,"MORELIA, MICH.",7,3,10,2,0,2914,
25/10/2014,TAMPS.,"MATAMOROS, TAMPS.",3,5,8,0,0,0,
25/10/2014,CHIS.,"VILLAFLORES, CHIS.",1,5,6,1,2,0,
25/10/2014,MICH.,"ZAMORA, MICH.",2,1,3,0,0,103,
25/10/2014,CHIS.,"SAN CRISTOBAL DE LAS CASAS, CHIS.",3,0,3,0,0,0,
25/10/2014,TLAX.,"ZACATELCO, TLAX.",2,1,3,1,0,0,
25/10/2014,SON.,"CANANEA, SON.",0,2,2,0,0,0,
25/10/2014,SON.,"SAN LUIS RIO COLORADO, SON.",1,1,2,0,0,0,
25/10/2014,CHIS.,"OCOSINGO, CHIS.",0,2,2,0,0,0,
25/10/2014,MICH.,"TACAMBARO, MICH.",0,2,2,0,0,500,
25/10/2014,CHIS.,"OCOZOCOAUTLA DE ESPINOSA, CHIS.",1,1,2,0,0,72,
25/10/2014,MOR.,"CUERNAVACA, MOR.",0,1,1,0,0,0,
25/10/2014,CHIS.,"PICHUCALCO, CHIS.",0,1,1,0,0,0,
25/10/2014,SON.,"SANTA ANA, SON.",0,1,1,0,0,0,
25/10/2014,SON.,"CABORCA, SON.",1,0,1,1,0,0,
25/10/2014,SON.,"PITIQUITO, SON.",1,0,1,0,0,0,
25/10/2014,GRO.,"ACAPULCO DE JUAREZ, GRO.",1,0,1,0,0,0,
25/10/2014,B.C.,"ENSENADA, B.C.",1,0,1,0,0,0,
25/10/2014,TAMPS.,"PADILLA, TAMPS.",0,1,1,0,0,106,
25/10/2014,CHIH.,"JUÁREZ, CHIH.",0,1,1,0,0,0,
25/10/2014,SON.,"HERMOSILLO, SON.",1,0,1,21,0,0,
25/10/2014,SON.,"SAN MIGUEL DE HORCASITAS, SON.",0,1,1,0,0,0,
25/10/2014,SON.,"CAJEME, SON.",0,1,1,0,0,0,
25/10/2014,SON.,"NOGALES, SON.",0,0,0,0,0,59,
25/10/2014,SON.,"AGUA PRIETA, SON.",0,0,0,0,0,60,
25/10/2014,MICH.,"LAZARO CARDENAS, MICH.",0,0,0,0,0,689,
25/10/2014,N.L.,"APODACA, N.L.",0,0,0,15,0,703,
25/10/2014,SON.,"GUAYMAS, SON.",0,0,0,1,0,38,
26/10/2014,CHIS.,"TUXTLA GUTIÉRREZ, CHIS.",5,8,13,0,2,1463,
26/10/2014,CHIS.,"COMITAN DE DOMÍNGUEZ, CHIS.",2,4,6,0,0,264,
26/10/2014,CHIS.,"TAPACHULA, CHIS.",3,3,6,2,0,745,
26/10/2014,CHIS.,"OCOZOCOAUTLA DE ESPINOSA, CHIS.",4,1,5,0,0,461,
26/10/2014,CHIS.,"VILLAFLORES, CHIS.",4,0,4,2,0,0,
26/10/2014,CHIS.,"TONALÁ, CHIS.",1,3,4,5,0,593,
26/10/2014,CHIS.,"SAN CRISTOBAL DE LAS CASAS, CHIS.",2,0,2,0,0,0,
26/10/2014,MICH.,"MORELIA, MICH.",1,1,2,1,0,3725,
26/10/2014,CHIS.,"OCOSINGO, CHIS.",0,1,1,4,0,160,
26/10/2014,N.L.,"APODACA, N.L.",0,1,1,19,0,956,
26/10/2014,TLAX.,"TEOLOCHOLCO, TLAX.",1,0,1,0,0,0,
26/10/2014,CHIS.,"PICHUCALCO, CHIS.",1,0,1,0,6,94,
27/10/2014,SIN.,"AHOME, SIN.",19,5,24,0,0,0,
27/10/2014,D.F.,"COYOACAN, D.F.",20,2,22,0,1,0,
27/10/2014,CHIS.,"TUXTLA GUTIÉRREZ, CHIS.",18,4,22,6,0,1711,
27/10/2014,CHIS.,"VILLAFLORES, CHIS.",8,6,14,0,0,0,
27/10/2014,CHIS.,"COMITAN DE DOMÍNGUEZ, CHIS.",8,5,13,3,0,63,
27/10/2014,CHIS.,"TAPACHULA, CHIS.",6,2,8,1,0,653,
27/10/2014,CHIS.,"OCOZOCOAUTLA DE ESPINOSA, CHIS.",4,4,8,5,0,346,
27/10/2014,MICH.,"MORELIA, MICH.",5,1,6,3,0,680,
27/10/2014,AGS.,"AGS., AGS.",3,1,4,3,0,0,
27/10/2014,CHIS.,"SAN CRISTOBAL DE LAS CASAS, CHIS.",2,1,3,0,0,0,
27/10/2014,SON.,"NOGALES, SON.",2,1,3,4,0,45,
27/10/2014,MOR.,"CUERNAVACA, MOR.",0,2,2,0,1,0,
27/10/2014,MICH.,"TACAMBARO, MICH.",2,0,2,0,0,0,
27/10/2014,TAMPS.,"PADILLA, TAMPS.",1,1,2,0,0,0,
27/10/2014,B.C.,"ENSENADA, B.C.",2,0,2,0,0,0,
27/10/2014,MICH.,"LAZARO CARDENAS, MICH.",2,0,2,0,0,266,
27/10/2014,SON.,"HERMOSILLO, SON.",2,0,2,18,0,50,
27/10/2014,AGS.,"AGS., AGS.",1,1,2,5,0,173,
27/10/2014,N.L.,"APODACA, N.L.",0,2,2,14,0,1320,
27/10/2014,SON.,"PUERTO PEÑASCO, SON.",2,0,2,0,0,0,
27/10/2014,SON.,"PITIQUITO, SON.",1,1,2,1,0,0,
27/10/2014,MICH.,"ZAMORA, MICH.",0,1,1,1,0,450,
27/10/2014,COL.,"TECOMÁN, COL.",0,1,1,0,0,0,
27/10/2014,COAH.,"TORREÓN, COAH.",1,0,1,0,0,0,
27/10/2014,SON.,"GUAYMAS, SON.",1,0,1,0,0,3,
27/10/2014,SIN.,"EL FUERTE, SIN.",1,0,1,0,0,0,
27/10/2014,CHIS.,"TONALÁ, CHIS.",1,0,1,7,0,388,
27/10/2014,SON.,"CANANEA, SON.",0,1,1,0,0,0,
27/10/2014,SON.,"GENERAL PLUTARCO ELIAS CALLES, SON.",1,0,1,0,0,0,
27/10/2014,COAH.,"SALTILLO, COAH.",0,0,0,0,0,77,
27/10/2014,MICH.,"APATZINGAN, MICH.",0,0,0,0,0,194,
27/10/2014,CHIS.,"PICHUCALCO, CHIS.",0,0,0,1,0,20,
27/10/2014,SON.,"CABORCA, SON.",0,0,0,1,0,50,
27/10/2014,CHIS.,"PICHUCALCO, CHIS.",0,0,0,1,0,20,
28/10/2014,SIN.,"AHOME, SIN.",21,8,29,0,1,0,
28/10/2014,CHIS.,"TUXTLA GUTIÉRREZ, CHIS.",14,6,20,21,2,1520,
28/10/2014,CHIS.,"COMITAN DE DOMÍNGUEZ, CHIS.",8,5,13,1,0,290,
28/10/2014,CHIS.,"VILLAFLORES, CHIS.",5,7,12,0,0,0,
28/10/2014,MICH.,"MORELIA, MICH.",6,4,10,2,0,645,
28/10/2014,CHIS.,"TAPACHULA, CHIS.",6,4,10,0,1,3613,
28/10/2014,CHIS.,"OCOZOCOAUTLA DE ESPINOSA, CHIS.",2,6,8,3,0,376,
28/10/2014,CHIS.,"PALENQUE, CHIS.",1,6,7,4,0,210,
28/10/2014,MICH.,"ZAMORA, MICH.",3,3,6,5,8,50,
28/10/2014,CHIS.,"SAN CRISTOBAL DE LAS CASAS, CHIS.",2,3,5,0,0,0,
28/10/2014,MICH.,"TACAMBARO, MICH.",3,2,5,0,0,280,
28/10/2014,SIN.,"EL FUERTE, SIN.",1,4,5,0,0,0,
28/10/2014,CHIS.,"TONALÁ, CHIS.",2,3,5,20,1,1463,
28/10/2014,CHIS.,"OCOSINGO, CHIS.",2,2,4,7,0,303,
28/10/2014,MICH.,"LAZARO CARDENAS, MICH.",3,0,3,3,0,826,
28/10/2014,TLAX.,"TLAX., TLAX.",1,1,2,1,0,0,
28/10/2014,SON.,"GUAYMAS, SON.",1,1,2,1,0,0,
28/10/2014,SON.,"EMPALME, SON.",2,0,2,1,0,0,
28/10/2014,SON.,"NOGALES, SON.",1,1,2,1,0,0,
28/10/2014,S.L.P.,"SAN LUIS POTOSI, S.L.P.",2,0,2,0,0,0,
28/10/2014,SON.,"HERMOSILLO, SON.",1,0,1,10,0,0,
28/10/2014,SON.,"YECORA, SON.",1,0,1,0,0,0,
28/10/2014,SON.,"HUATABAMPO, SON.",1,0,1,0,0,0,
28/10/2014,SON.,"ALAMOS, SON.",1,0,1,0,0,0,
28/10/2014,CHIS.,"PICHUCALCO, CHIS.",1,0,1,2,0,173,
28/10/2014,SON.,"MAGDALENA, SON.",1,0,1,0,0,0,
28/10/2014,SON.,"PUERTO PEÑASCO, SON.",1,0,1,1,0,60,
28/10/2014,MOR.,"CUERNAVACA, MOR.",1,0,1,0,1,0,
28/10/2014,CHIH.,"JUÁREZ, CHIH.",1,0,1,0,0,0,
28/10/2014,GRO.,"PETATLAN, GRO.",0,1,1,0,0,1,
28/10/2014,COAH.,"SALTILLO, COAH.",0,0,0,0,0,66,
28/10/2014,MICH.,"APATZINGAN, MICH.",0,0,0,0,0,500,
28/10/2014,N.L.,"APODACA, N.L.",0,0,0,14,0,1053,
28/10/2014,PUE.,"ATLIXCO, PUE.",0,0,0,0,0,237,
28/10/2014,PUE.,"SAN PEDRO CHOLULA, PUE.",0,0,0,0,0,500,
29/10/2014,D.F.,"BENITO JUAREZ, D.F.",31,18,49,0,2,90,
29/10/2014,SIN.,"AHOME, SIN.",17,8,25,0,0,0,
29/10/2014,CHIS.,"TUXTLA GUTIÉRREZ, CHIS.",7,13,20,4,15,1802,
29/10/2014,GRO.,"ACAPULCO DE JUAREZ, GRO.",10,7,17,1,2,0,
29/10/2014,SIN.,"EL FUERTE, SIN.",8,7,15,0,0,0,
29/10/2014,CHIS.,"COMITAN DE DOMÍNGUEZ, CHIS.",10,4,14,2,0,281,
29/10/2014,CHIS.,"VILLAFLORES, CHIS.",7,6,13,0,0,0,
29/10/2014,MICH.,"MORELIA, MICH.",7,1,8,4,0,447,
29/10/2014,CHIS.,"OCOZOCOAUTLA DE ESPINOSA, CHIS.",3,5,8,3,0,628,
29/10/2014,CHIS.,"TAPACHULA, CHIS.",6,0,6,9,0,1317,
29/10/2014,MICH.,"APATZINGAN, MICH.",1,4,5,3,0,750,
29/10/2014,B.C.,"ENSENADA, B.C.",0,3,3,0,0,0,
29/10/2014,SON.,"HERMOSILLO, SON.",2,0,2,18,0,80,
29/10/2014,SON.,"GUAYMAS, SON.",1,1,2,0,0,2,
29/10/2014,COAH.,"SALTILLO, COAH.",2,0,2,0,0,52,
29/10/2014,N.L.,"APODACA, N.L.",1,1,2,22,0,1238,
29/10/2014,TLAX.,"TEOLOCHOLCO, TLAX.",1,1,2,0,0,0,
29/10/2014,CHIS.,"SAN CRISTOBAL DE LAS CASAS, CHIS.",1,1,2,0,0,0,
29/10/2014,CHIS.,"OCOSINGO, CHIS.",0,2,2,2,0,467,
29/10/2014,SON.,"CAJEME, SON.",1,0,1,0,0,0,
29/10/2014,COAH.,"MONCLOVA, COAH.",1,0,1,0,0,0,
29/10/2014,COAH.,"TORREÓN, COAH.",0,1,1,0,0,0,
29/10/2014,TAMPS.,"PADILLA, TAMPS.",0,1,1,0,0,30,
29/10/2014,ZAC.,"TRINIDAD GARCIA DE LA CADENA, ZAC.",0,1,1,1,0,0,
29/10/2014,AGS.,"AGS., AGS.",1,0,1,0,0,0,
29/10/2014,PUE.,"SAN PEDRO CHOLULA, PUE.",1,0,1,1,0,61,
29/10/2014,SON.,"NOGALES, SON.",1,0,1,0,0,0,
29/10/2014,SON.,"ALTAR, SON.",1,0,1,0,0,0,
29/10/2014,SON.,"CABORCA, SON.",1,0,1,0,0,0,
29/10/2014,SON.,"PITIQUITO, SON.",0,1,1,0,0,0,
29/10/2014,SON.,"SAN LUIS RIO COLORADO, SON.",1,0,1,0,0,0,
29/10/2014,TAMPS.,"PADILLA, TAMPS.",0,0,0,0,0,340,
29/10/2014,MICH.,"ZAMORA, MICH.",0,0,0,0,0,44,
29/10/2014,MICH.,"TACAMBARO, MICH.",0,0,0,0,0,1155,
29/10/2014,CHIS.,"PICHUCALCO, CHIS.",0,0,0,2,0,221,
29/10/2014,MICH.,"LAZARO CARDENAS, MICH.",0,0,0,0,1,1480,
29/10/2014,SON.,"IMURIS, SON.",0,0,0,1,0,35,
30/10/2014,SIN.,"AHOME, SIN.",22,6,28,0,0,0,
30/10/2014,SIN.,"EL FUERTE, SIN.",9,17,26,0,0,0,
30/10/2014,D.F.,"BENITO JUAREZ, D.F.",20,6,26,0,0,25,
30/10/2014,CHIS.,"TUXTLA GUTIÉRREZ, CHIS.",13,12,25,5,6,2454,
30/10/2014,CHIS.,"COMITAN DE DOMÍNGUEZ, CHIS.",13,7,20,0,0,264,
30/10/2014,CHIS.,"VILLAFLORES, CHIS.",0,13,13,12,2,0,
30/10/2014,CHIS.,"TAPACHULA, CHIS.",9,3,12,0,0,1677,
30/10/2014,CHIS.,"OCOZOCOAUTLA DE ESPINOSA, CHIS.",6,5,11,1,0,951,
30/10/2014,CHIS.,"TONALÁ, CHIS.",3,2,5,2,0,311,
30/10/2014,NAY.,"AHUACATLAN, NAY.",1,2,3,0,0,0,
30/10/2014,TAMPS.,"PADILLA, TAMPS.",0,3,3,0,0,2700,
30/10/2014,GRO.,"BENITO JUAREZ, GRO.",0,3,3,0,0,0,
30/10/2014,SON.,"AGUA PRIETA, SON.",3,0,3,1,0,0,
30/10/2014,TLAX.,"TEOLOCHOLCO, TLAX.",1,1,2,0,0,0,
30/10/2014,N.L.,"APODACA, N.L.",0,2,2,19,0,1104,
30/10/2014,CHIS.,"PICHUCALCO, CHIS.",2,0,2,2,1,622,
30/10/2014,GRO.,"PETATLAN, GRO.",1,1,2,0,0,0,
30/10/2014,SON.,"NOGALES, SON.",1,1,2,20,0,77,
30/10/2014,CAMP.,"CARMEN, CAMP.",1,0,1,0,0,0,
30/10/2014,COAH.,"SALTILLO, COAH.",1,0,1,0,0,0,
30/10/2014,COAH.,"TORREÓN, COAH.",1,0,1,0,0,0,
30/10/2014,COAH.,"FRONTERA, COAH.",1,0,1,0,0,0,
30/10/2014,CHIS.,"SAN CRISTOBAL DE LAS CASAS, CHIS.",1,0,1,0,0,0,
30/10/2014,SON.,"PUERTO PEÑASCO, SON.",0,1,1,0,0,50,
30/10/2014,MOR.,"CUERNAVACA, MOR.",0,0,0,0,1,0,
30/10/2014,CHIS.,"OCOSINGO, CHIS.",0,0,0,9,0,556,
30/10/2014,SON.,"SANTA ANA, SON.",0,0,0,8,0,50,
30/10/2014,SON.,"CANANEA, SON.",0,0,0,0,0,71,
31/10/2014,CHIS.,"TUXTLA GUTIÉRREZ, CHIS.",21,9,30,9,5,949,
31/10/2014,CHIS.,"TAPACHULA, CHIS.",15,10,25,22,0,1234,
31/10/2014,SIN.,"AHOME, SIN.",21,3,24,0,5,0,
31/10/2014,D.F.,"BENITO JUAREZ, D.F.",16,4,20,0,0,300,
31/10/2014,CHIS.,"COMITAN DE DOMÍNGUEZ, CHIS.",9,10,19,5,1,288,
31/10/2014,SIN.,"EL FUERTE, SIN.",10,8,18,0,0,0,
31/10/2014,CHIS.,"VILLAFLORES, CHIS.",7,9,16,0,5,0,
31/10/2014,CHIS.,"TAPACHULA, CHIS.",10,3,13,0,1,3011,
31/10/2014,CHIS.,"OCOZOCOAUTLA DE ESPINOSA, CHIS.",3,5,8,0,1,146,
31/10/2014,CHIS.,"SAN CRISTOBAL DE LAS CASAS, CHIS.",5,2,7,1,0,0,
31/10/2014,CHIS.,"TONALÁ, CHIS.",3,2,5,0,0,333,
31/10/2014,SON.,"NAVOJOA, SON.",2,3,5,4,0,710,
31/10/2014,COAH.,"TORREÓN, COAH.",0,3,3,0,0,0,
31/10/2014,SON.,"HERMOSILLO, SON.",2,1,3,3,0,60,
31/10/2014,SON.,"PUERTO PEÑASCO, SON.",1,1,2,0,0,0,
31/10/2014,CHIS.,"OCOSINGO, CHIS.",1,1,2,2,0,733,
31/10/2014,GRO.,"BENITO JUAREZ, GRO.",1,1,2,0,0,0,
31/10/2014,SON.,"EMPALME, SON.",2,0,2,0,0,0,
31/10/2014,B.C.,"ENSENADA, B.C.",1,1,2,0,0,0,
31/10/2014,GRO.,"TELOLOAPAN, GRO.",1,1,2,1,0,0,
31/10/2014,MOR.,"CUERNAVACA, MOR.",0,2,2,0,0,0,
31/10/2014,SON.,"MAGDALENA, SON.",1,0,1,0,0,0,
31/10/2014,SON.,"AGUA PRIETA, SON.",0,1,1,0,0,0,
31/10/2014,SON.,"GENERAL PLUTARCO ELIAS CALLES, SON.",0,1,1,0,0,100,
31/10/2014,CAMP.,"CARMEN, CAMP.",1,0,1,0,0,0,
31/10/2014,B.C.S.,"MULEGÉ, B.C.S.",1,0,1,0,0,0,
31/10/2014,COAH.,"SALTILLO, COAH.",0,1,1,1,0,0,
31/10/2014,CHIS.,"PICHUCALCO, CHIS.",1,0,1,6,0,563,
31/10/2014,SON.,"CAJEME, SON.",0,1,1,0,0,0,
31/10/2014,N.L.,"APODACA, N.L.",0,1,1,29,0,2784,
31/10/2014,TAMPS.,"PADILLA, TAMPS.",0,1,1,0,0,0,
31/10/2014,COL.,"COL., COL.",0,0,0,0,1,9,
01/11/2014,SON.,"SAN LUIS RIO COLORADO, SON.",0,7,7,4,0,0,
01/11/2014,MOR.,"CUERNAVACA, MOR.",3,3,6,0,3,370,
01/11/2014,SON.,"NAVOJOA, SON.",3,3,6,1,1,60,
01/11/2014,SON.,"NOGALES, SON.",3,2,5,1,0,43,
01/11/2014,SON.,"HERMOSILLO, SON.",2,2,4,35,0,69,
01/11/2014,SON.,"CABORCA, SON.",1,3,4,0,0,0,
01/11/2014,SON.,"CANANEA, SON.",1,2,3,0,0,0,
01/11/2014,B.C.,"ENSENADA, B.C.",2,0,2,0,0,0,
01/11/2014,SON.,"MAGDALENA, SON.",2,0,2,0,0,0,
01/11/2014,SON.,"GUAYMAS, SON.",1,0,1,1,0,0,
01/11/2014,SON.,"HUATABAMPO, SON.",1,0,1,1,0,100,
01/11/2014,SON.,"ALAMOS, SON.",0,1,1,0,0,0,
01/11/2014,SON.,"AGUA PRIETA, SON.",0,1,1,0,0,0,
01/11/2014,SON.,"PUERTO PEÑASCO, SON.",0,1,1,0,0,0,
01/11/2014,SON.,"SANTA ANA, SON.",0,0,0,0,0,13,
02/11/2014,CHIS.,"COMITAN DE DOMÍNGUEZ, CHIS.",26,3,29,0,0,172,
02/11/2014,MOR.,"CUERNAVACA, MOR.",1,2,3,0,0,240,
02/11/2014,GRO.,"TELOLOAPAN, GRO.",2,0,2,0,0,0,
03/11/2014,SIN.,"AHOME, SIN.",14,11,25,0,0,0,
03/11/2014,SIN.,"EL FUERTE, SIN.",18,6,24,0,0,0,
03/11/2014,D.F.,"CUAJIMALPA DE MOR., D.F.",12,1,13,0,0,150,
03/11/2014,COAH.,"MÚZQUIZ, COAH.",8,1,9,0,0,24,
03/11/2014,CHIS.,"TUXTLA GUTIÉRREZ, CHIS.",4,3,7,8,1,1221,
03/11/2014,CHIS.,"VILLAFLORES, CHIS.",3,1,4,0,0,0,
03/11/2014,CHIS.,"OCOZOCOAUTLA DE ESPINOSA, CHIS.",1,3,4,0,2,521,
03/11/2014,AGS.,"AGS., AGS.",3,0,3,3,0,0,
03/11/2014,GRO.,"TELOLOAPAN, GRO.",3,0,3,0,0,0,
03/11/2014,CHIS.,"SAN CRISTOBAL DE LAS CASAS, CHIS.",1,1,2,0,0,0,
03/11/2014,GRO.,"PUNGARABATO, GRO.",0,2,2,0,0,0,
03/11/2014,COAH.,"SALTILLO, COAH.",1,0,1,0,0,140,
03/11/2014,COAH.,"FRONTERA, COAH.",1,0,1,0,0,0,
03/11/2014,COAH.,"SALTILLO, COAH.",1,0,1,0,0,0,
03/11/2014,CHIS.,"PICHUCALCO, CHIS.",0,0,0,4,0,210,
03/11/2014,CHIS.,"TAPACHULA, CHIS.",0,0,0,15,0,1719,
04/11/2014,CHIS.,"COMITAN DE DOMÍNGUEZ, CHIS.",21,3,24,1,0,276,
04/11/2014,SIN.,"AHOME, SIN.",11,6,17,0,0,0,
04/11/2014,SIN.,"EL FUERTE, SIN.",8,8,16,0,0,0,
04/11/2014,CHIS.,"TUXTLA GUTIÉRREZ, CHIS.",13,3,16,8,0,833,
04/11/2014,D.F.,"CUAJIMALPA DE MOR., D.F.",13,0,13,0,0,0,
04/11/2014,CHIS.,"OCOZOCOAUTLA DE ESPINOSA, CHIS.",6,1,7,1,0,629,
04/11/2014,CHIS.,"VILLAFLORES, CHIS.",4,1,5,0,0,83,
04/11/2014,CHIS.,"TAPACHULA, CHIS.",2,1,3,1,0,730,
04/11/2014,CHIS.,"TONALÁ, CHIS.",3,0,3,5,0,1737,
04/11/2014,GRO.,"PUNGARABATO, GRO.",1,1,2,0,0,0,
04/11/2014,GRO.,"FLORENCIO VILLARREAL, GRO.",1,1,2,0,0,0,
04/11/2014,B.C.,"ENSENADA, B.C.",0,1,1,0,0,0,
04/11/2014,N.L.,"CADEREYTA JIMENEZ, N.L.",1,0,1,0,0,0,
04/11/2014,NAY.,"AMATLAN DE CAÑAS, NAY.",0,1,1,0,0,0,
04/11/2014,GRO.,"TELOLOAPAN, GRO.",0,1,1,0,0,0,
04/11/2014,CHIS.,"PICHUCALCO, CHIS.",0,0,0,0,1,606,
04/11/2014,CHIS.,"PALENQUE, CHIS.",0,0,0,0,0,337,
04/11/2014,CHIS.,"PICHUCALCO, CHIS.",0,0,0,6,0,606,
05/11/2014,D.F.,"CUAJIMALPA DE MOR., D.F.",24,10,34,0,0,0,
05/11/2014,SIN.,"AHOME, SIN.",14,8,22,0,1,0,
05/11/2014,SIN.,"EL FUERTE, SIN.",13,4,17,0,8,0,
05/11/2014,CHIS.,"TUXTLA GUTIÉRREZ, CHIS.",6,9,15,4,1,1241,
05/11/2014,D.F.,"CUAJIMALPA DE MOR., D.F.",14,0,14,0,0,80,
05/11/2014,CHIS.,"VILLAFLORES, CHIS.",4,4,8,2,0,163,
05/11/2014,CHIS.,"COMITAN DE DOMÍNGUEZ, CHIS.",4,3,7,0,0,23,
05/11/2014,AGS.,"AGS., AGS.",4,3,7,1,0,0,
05/11/2014,CHIS.,"COMITAN DE DOMÍNGUEZ, CHIS.",4,3,7,0,0,23,
05/11/2014,NAY.,"AMATLAN DE CAÑAS, NAY.",1,3,4,0,0,0,
05/11/2014,GRO.,"PUNGARABATO, GRO.",4,0,4,0,0,0,
05/11/2014,CHIS.,"TAPACHULA, CHIS.",2,1,3,0,2,711,
05/11/2014,JAL.,"TOMATLAN, JAL.",2,1,3,0,0,0,
05/11/2014,CHIS.,"SAN CRISTOBAL DE LAS CASAS, CHIS.",2,1,3,2,0,0,
05/11/2014,CHIS.,"OCOZOCOAUTLA DE ESPINOSA, CHIS.",2,1,3,0,0,306,
05/11/2014,CHIS.,"PALENQUE, CHIS.",1,1,2,4,0,693,
05/11/2014,TLAX.,"EL CARMEN TEQUEXQUITLA, TLAX.",0,1,1,0,0,0,
05/11/2014,GRO.,"FLORENCIO VILLARREAL, GRO.",0,1,1,0,1,0,
05/11/2014,GRO.,"ATOYAC DE ALVAREZ, GRO.",0,1,1,1,0,0,
05/11/2014,GRO.,"TECPAN DE GALEANA, GRO.",0,1,1,0,0,0,
05/11/2014,CHIS.,"TONALÁ, CHIS.",0,1,1,2,0,902,
05/11/2014,SON.,"HERMOSILLO, SON.",1,0,1,1,0,0,
05/11/2014,AGS.,"SAN FRANCISCO DE LOS ROMO, AGS.",1,0,1,1,0,0,
05/11/2014,CHIS.,"PICHUCALCO, CHIS.",0,0,0,7,0,517,
05/11/2014,N.L.,"CADEREYTA JIMENEZ, N.L.",0,0,0,0,0,1950,
06/11/2014,SIN.,"AHOME, SIN.",13,11,24,0,2,0,
06/11/2014,D.F.,"CUAJIMALPA DE MOR., D.F.",16,7,23,0,0,0,
06/11/2014,CHIS.,"VILLAFLORES, CHIS.",11,3,14,2,0,122,
06/11/2014,SIN.,"EL FUERTE, SIN.",6,7,13,0,0,0,
06/11/2014,CHIS.,"TUXTLA GUTIÉRREZ, CHIS.",9,3,12,4,5,2451,
06/11/2014,GRO.,"FLORENCIO VILLARREAL, GRO.",5,4,9,0,1,0,
06/11/2014,CHIS.,"TAPACHULA, CHIS.",2,3,5,1,1,541,
06/11/2014,CHIS.,"TAPACHULA, CHIS.",2,3,5,1,1,541,
06/11/2014,AGS.,"AGS., AGS.",4,1,5,2,0,4,
06/11/2014,CHIS.,"COMITAN DE DOMÍNGUEZ, CHIS.",4,0,4,1,0,199,
06/11/2014,CHIS.,"SAN CRISTOBAL DE LAS CASAS, CHIS.",3,1,4,1,0,0,
06/11/2014,CHIS.,"OCOZOCOAUTLA DE ESPINOSA, CHIS.",2,0,2,0,0,112,
06/11/2014,GRO.,"PUNGARABATO, GRO.",2,0,2,0,0,0,
06/11/2014,GRO.,"TELOLOAPAN, GRO.",0,2,2,0,0,0,
06/11/2014,S.L.P.,"SAN LUIS POTOSI, S.L.P.",1,0,1,0,0,0,
06/11/2014,CHIS.,"PALENQUE, CHIS.",1,0,1,0,0,0,
06/11/2014,CHIH.,"JUÁREZ, CHIH.",0,1,1,0,0,0,
06/11/2014,CHIS.,"PICHUCALCO, CHIS.",0,1,1,0,0,480,
06/11/2014,JAL.,"TOMATLAN, JAL.",1,0,1,0,0,0,
06/11/2014,GRO.,"ATOYAC DE ALVAREZ, GRO.",1,0,1,0,0,0,
06/11/2014,COAH.,"SALTILLO, COAH.",0,0,0,0,0,44,
06/11/2014,PUE.,"ATLIXCO, PUE.",0,0,0,0,0,98,
07/11/2014,SIN.,"AHOME, SIN.",23,10,33,0,0,0,
07/11/2014,TAMPS.,"MATAMOROS, TAMPS.",18,6,24,0,0,0,
07/11/2014,CHIS.,"TUXTLA GUTIÉRREZ, CHIS.",15,8,23,1,0,1328,
07/11/2014,SIN.,"EL FUERTE, SIN.",9,9,18,0,0,0,
07/11/2014,D.F.,"CUAJIMALPA DE MOR., D.F.",16,1,17,0,0,30,
07/11/2014,CHIS.,"SAN CRISTOBAL DE LAS CASAS, CHIS.",8,0,8,2,0,85,
07/11/2014,CHIS.,"OCOZOCOAUTLA DE ESPINOSA, CHIS.",2,4,6,0,0,19,
07/11/2014,CHIS.,"VILLAFLORES, CHIS.",3,2,5,0,0,0,
07/11/2014,CHIS.,"COMITAN DE DOMÍNGUEZ, CHIS.",3,1,4,230,0,0,
07/11/2014,CHIS.,"TAPACHULA, CHIS.",4,0,4,6,0,1815,
07/11/2014,CHIS.,"PICHUCALCO, CHIS.",3,0,3,3,0,403,
07/11/2014,AGS.,"AGS., AGS.",2,0,2,0,0,50,
07/11/2014,CHIS.,"OCOSINGO, CHIS.",1,0,1,0,0,88,
07/11/2014,COAH.,"SALTILLO, COAH.",1,0,1,0,0,120,
07/11/2014,GRO.,"PUNGARABATO, GRO.",0,1,1,0,0,0,
07/11/2014,JAL.,"TOMATLAN, JAL.",0,1,1,0,0,0,
07/11/2014,CHIH.,"JUÁREZ, CHIH.",0,0,0,0,1,0,
08/11/2014,TAMPS.,"MATAMOROS, TAMPS.",5,6,11,0,0,0,
08/11/2014,CHIS.,"TAPACHULA, CHIS.",7,2,9,2,1,854,
08/11/2014,CHIS.,"TUXTLA GUTIÉRREZ, CHIS.",4,5,9,4,2,1419,
08/11/2014,CHIS.,"SAN CRISTOBAL DE LAS CASAS, CHIS.",7,1,8,1,0,0,
08/11/2014,CHIS.,"VILLAFLORES, CHIS.",4,1,5,0,0,0,
08/11/2014,N.L.,"CADEREYTA JIMENEZ, N.L.",3,2,5,11,0,992,
08/11/2014,TLAX.,"CALPULALPAN, TLAX.",2,1,3,0,0,0,
08/11/2014,GRO.,"ATOYAC DE ALVAREZ, GRO.",2,0,2,0,0,0,
08/11/2014,CHIS.,"COMITAN DE DOMÍNGUEZ, CHIS.",1,0,1,0,0,40,
08/11/2014,AGS.,"SAN FRANCISCO DE LOS ROMO, AGS.",1,0,1,1,0,0,
08/11/2014,CHIS.,"OCOZOCOAUTLA DE ESPINOSA, CHIS.",0,0,0,0,8,20,
08/11/2014,CHIS.,"PICHUCALCO, CHIS.",0,0,0,1,0,301,
09/11/2014,CHIS.,"TUXTLA GUTIÉRREZ, CHIS.",5,1,6,2,1,1163,
09/11/2014,CHIS.,"TONALÁ, CHIS.",3,0,3,1,0,597,
09/11/2014,CHIS.,"TAPACHULA, CHIS.",2,0,2,1,0,330,
09/11/2014,CHIS.,"OCOZOCOAUTLA DE ESPINOSA, CHIS.",2,0,2,0,0,0,
09/11/2014,CHIS.,"PALENQUE, CHIS.",0,2,2,0,0,0,
09/11/2014,TLAX.,"CALPULALPAN, TLAX.",0,1,1,0,0,0,
09/11/2014,CHIS.,"VILLAFLORES, CHIS.",1,0,1,2,0,50,
09/11/2014,CHIS.,"PICHUCALCO, CHIS.",0,1,1,0,0,0,
09/11/2014,CHIS.,"COMITAN DE DOMÍNGUEZ, CHIS.",1,0,1,0,0,0,
09/11/2014,CHIS.,"OCOSINGO, CHIS.",0,0,0,3,0,307,
10/11/2014,D.F.,"CUAUHTEMOC, D.F.",39,8,47,0,5,400,
10/11/2014,D.F.,"AZCAPOTZALCO, D.F.",15,4,19,0,0,30,
10/11/2014,CHIS.,"OCOZOCOAUTLA DE ESPINOSA, CHIS.",5,4,9,1,0,29,
10/11/2014,CHIS.,"TUXTLA GUTIÉRREZ, CHIS.",6,1,7,3,0,1587,
10/11/2014,B.C.,"TIJUANA, B.C.",4,3,7,0,0,0,
10/11/2014,CHIS.,"VILLAFLORES, CHIS.",2,2,4,0,4,0,
10/11/2014,CHIS.,"TAPACHULA, CHIS.",3,0,3,0,0,235,
10/11/2014,CHIS.,"PALENQUE, CHIS.",3,0,3,0,0,0,
10/11/2014,CHIS.,"COMITAN DE DOMÍNGUEZ, CHIS.",1,1,2,4,0,168,
10/11/2014,TLAX.,"CALPULALPAN, TLAX.",1,1,2,0,0,4,
10/11/2014,CHIS.,"SAN CRISTOBAL DE LAS CASAS, CHIS.",1,0,1,0,0,0,
10/11/2014,CHIS.,"PICHUCALCO, CHIS.",0,1,1,6,0,384,
10/11/2014,CHIS.,"OCOSINGO, CHIS.",0,1,1,1,0,88,
10/11/2014,AGS.,"AGS., AGS.",0,1,1,1,0,0,
10/11/2014,CHIS.,"TONALÁ, CHIS.",0,0,0,0,1,1274,
10/11/2014,COAH.,"SALTILLO, COAH.",0,0,0,0,0,33,
11/11/2014,D.F.,"AZCAPOTZALCO, D.F.",29,0,29,0,3,0,
11/11/2014,SIN.,"CHOIX, SIN.",8,5,13,0,0,0,
11/11/2014,CHIS.,"COMITAN DE DOMÍNGUEZ, CHIS.",10,2,12,0,0,181,
11/11/2014,SIN.,"AHOME, SIN.",5,5,10,0,0,0,
11/11/2014,CHIS.,"TUXTLA GUTIÉRREZ, CHIS.",7,2,9,5,6,327,
11/11/2014,CHIS.,"SAN CRISTOBAL DE LAS CASAS, CHIS.",5,1,6,0,0,0,
11/11/2014,SIN.,"SALVADOR ALVARADO, SIN.",2,2,4,0,0,0,
11/11/2014,CHIS.,"TAPACHULA, CHIS.",2,2,4,0,0,1180,
11/11/2014,AGS.,"AGS., AGS.",3,1,4,1,0,0,
11/11/2014,CHIS.,"OCOZOCOAUTLA DE ESPINOSA, CHIS.",1,2,3,3,0,80,
11/11/2014,B.C.,"TIJUANA, B.C.",2,1,3,0,0,0,
11/11/2014,CHIS.,"PALENQUE, CHIS.",2,0,2,1,0,181,
11/11/2014,AGS.,"CALVILLO, AGS.",1,0,1,0,0,0,
11/11/2014,B.C.S.,"LOS CABOS, B.C.S.",0,1,1,0,0,0,
11/11/2014,GRO.,"ALCOZAUCA DE GRO., GRO.",0,1,1,0,0,0,
11/11/2014,GRO.,"FLORENCIO VILLARREAL, GRO.",1,0,1,0,0,0,
11/11/2014,CHIS.,"VILLAFLORES, CHIS.",1,0,1,0,0,400,
11/11/2014,CHIH.,"JUÁREZ, CHIH.",1,0,1,0,0,0,
11/11/2014,Q. ROO,"OTHON P. BLANCO, Q. ROO",0,0,0,0,1,0,
11/11/2014,PUE.,"ATLIXCO, PUE.",0,0,0,0,0,204,
11/11/2014,CHIS.,"PICHUCALCO, CHIS.",0,0,0,2,0,242,
12/11/2014,D.F.,"AZCAPOTZALCO, D.F.",27,10,37,0,0,90,
12/11/2014,CHIS.,"TUXTLA GUTIÉRREZ, CHIS.",9,3,12,5,0,404,
12/11/2014,CHIS.,"OCOZOCOAUTLA DE ESPINOSA, CHIS.",9,2,11,0,0,23,
12/11/2014,CHIS.,"COMITAN DE DOMÍNGUEZ, CHIS.",6,0,6,0,0,75,
12/11/2014,CHIS.,"SAN CRISTOBAL DE LAS CASAS, CHIS.",0,3,3,0,0,0,
12/11/2014,CHIS.,"VILLAFLORES, CHIS.",0,1,1,0,0,305,
12/11/2014,QRO.,"AMEALCO DE BONFIL, QRO.",1,0,1,0,0,0,
12/11/2014,QRO.,"HUIMILPAN, QRO.",0,1,1,0,0,0,
12/11/2014,CHIS.,"PICHUCALCO, CHIS.",0,0,0,3,0,314,
13/11/2014,CHIS.,"COMITAN DE DOMÍNGUEZ, CHIS.",63,7,70,1,0,719,
13/11/2014,D.F.,"AZCAPOTZALCO, D.F.",28,11,39,0,0,30,
13/11/2014,SIN.,"AHOME, SIN.",20,3,23,0,2,0,
13/11/2014,SIN.,"CHOIX, SIN.",8,8,16,0,0,0,
13/11/2014,CHIS.,"TUXTLA GUTIÉRREZ, CHIS.",8,3,11,4,1,875,
13/11/2014,CHIS.,"VILLAFLORES, CHIS.",6,4,10,0,0,115,
13/11/2014,CHIS.,"TAPACHULA, CHIS.",3,3,6,0,0,3437,
13/11/2014,GRO.,"FLORENCIO VILLARREAL, GRO.",3,3,6,0,0,0,
13/11/2014,CHIS.,"SAN CRISTOBAL DE LAS CASAS, CHIS.",5,1,6,0,0,314,
13/11/2014,CHIS.,"OCOZOCOAUTLA DE ESPINOSA, CHIS.",1,3,4,0,0,1319,
13/11/2014,QRO.,"AMEALCO DE BONFIL, QRO.",2,1,3,0,0,0,
13/11/2014,SIN.,"SALVADOR ALVARADO, SIN.",1,0,1,0,0,0,
13/11/2014,AGS.,"CALVILLO, AGS.",1,0,1,0,0,0,
13/11/2014,Q. ROO,"OTHON P. BLANCO, Q. ROO",0,1,1,0,0,0,
13/11/2014,CHIH.,"JUÁREZ, CHIH.",1,0,1,0,0,0,
13/11/2014,AGS.,"AGS., AGS.",0,0,0,0,0,1800,
13/11/2014,CHIS.,"PICHUCALCO, CHIS.",0,0,0,2,0,161,
13/11/2014,COAH.,"SALTILLO, COAH.",0,0,0,0,0,102,
13/11/2014,CHIS.,"OCOSINGO, CHIS.",0,0,0,1,0,471,
14/11/2014,SIN.,"AHOME, SIN.",20,12,32,0,2,0,
14/11/2014,SIN.,"CHOIX, SIN.",10,6,16,0,0,0,
14/11/2014,SIN.,"SALVADOR ALVARADO, SIN.",4,1,5,0,0,0,
14/11/2014,AGS.,"CALVILLO, AGS.",2,2,4,1,0,0,
14/11/2014,B.C.S.,"MULEGÉ, B.C.S.",1,1,2,0,0,0,
14/11/2014,COAH.,"SALTILLO, COAH.",1,0,1,0,0,33,
14/11/2014,AGS.,"AGS., AGS.",1,0,1,6,0,0,
15/11/2014,TAMPS.,"MATAMOROS, TAMPS.",6,4,10,0,0,0,
15/11/2014,TLAX.,"HUAMANTLA, TLAX.",0,3,3,0,0,0,
15/11/2014,GRO.,"FLORENCIO VILLARREAL, GRO.",0,0,0,0,2,0,
17/11/2014,GRO.,"TELOLOAPAN, GRO.",0,3,3,0,0,0,
18/11/2014,D.F.,"LA MAGDALENA CONTRERAS, D.F.",16,2,18,0,0,0,
18/11/2014,SIN.,"CHOIX, SIN.",4,4,8,0,0,0,
18/11/2014,SIN.,"MAZATLAN, SIN.",7,1,8,0,0,0,
18/11/2014,TLAX.,"HUAMANTLA, TLAX.",0,2,2,0,0,0,
18/11/2014,SIN.,"SALVADOR ALVARADO, SIN.",1,1,2,0,5,0,
18/11/2014,AGS.,"CALVILLO, AGS.",0,1,1,0,0,0,
18/11/2014,GRO.,"TELOLOAPAN, GRO.",0,1,1,0,0,0,
19/11/2014,D.F.,"LA MAGDALENA CONTRERAS, D.F.",32,15,47,0,0,200,
19/11/2014,SIN.,"MAZATLAN, SIN.",8,2,10,0,0,0,
19/11/2014,SIN.,"CHOIX, SIN.",3,2,5,0,0,0,
19/11/2014,SIN.,"SALVADOR ALVARADO, SIN.",1,3,4,0,0,0,
19/11/2014,JAL.,"GUADALAJARA, JAL.",0,3,3,0,0,0,
19/11/2014,AGS.,"CALVILLO, AGS.",2,0,2,0,0,0,
19/11/2014,GRO.,"ACAPULCO DE JUAREZ, GRO.",1,1,2,0,0,0,
19/11/2014,CHIH.,"JUÁREZ, CHIH.",1,0,1,0,0,0,
19/11/2014,N.L.,"GUADALUPE, N.L.",0,0,0,1,0,0,
19/11/2014,N.L.,"SANTA CATARINA, N.L.",0,0,0,0,0,1000,
20/11/2014,D.F.,"LA MAGDALENA CONTRERAS, D.F.",14,7,21,0,1,0,
20/11/2014,SIN.,"CHOIX, SIN.",4,3,7,0,0,0,
20/11/2014,SIN.,"SALVADOR ALVARADO, SIN.",3,2,5,0,4,0,
20/11/2014,SIN.,"MAZATLAN, SIN.",5,0,5,0,2,0,
20/11/2014,N.L.,"SANTA CATARINA, N.L.",0,0,0,0,1,0,
21/11/2014,D.F.,"LA MAGDALENA CONTRERAS, D.F.",22,6,28,0,0,60,
21/11/2014,SIN.,"MAZATLAN, SIN.",8,11,19,0,0,0,
21/11/2014,TAMPS.,"MATAMOROS, TAMPS.",7,10,17,0,0,0,
21/11/2014,SIN.,"CHOIX, SIN.",3,4,7,0,0,0,
21/11/2014,SIN.,"SALVADOR ALVARADO, SIN.",2,4,6,0,6,0,
21/11/2014,HGO.,"HUASCA DE OCAMPO, HGO.",0,1,1,0,0,0,
21/11/2014,COAH.,"SALTILLO, COAH.",0,1,1,0,0,0,
21/11/2014,N.L.,"GUADALUPE, N.L.",1,0,1,0,0,0,
21/11/2014,Q. ROO,"OTHON P. BLANCO, Q. ROO",0,0,0,0,4,0,
21/11/2014,PUE.,"ATLIXCO, PUE.",0,0,0,0,0,465,
22/11/2014,TAMPS.,"MATAMOROS, TAMPS.",10,7,17,0,0,0,
22/11/2014,N.L.,"GUADALUPE, N.L.",0,0,0,10,0,200,
24/11/2014,D.F.,"VENUSTIANO CARRANZA, D.F.",26,14,40,0,0,0,
24/11/2014,GTO.,"CELAYA, GTO.",17,18,35,0,7,19,
24/11/2014,SIN.,"MAZATLAN, SIN.",8,7,15,0,0,0,
24/11/2014,HGO.,"HUEJUTLA DE REYES, HGO.",2,0,2,0,0,0,
25/11/2014,GTO.,"CELAYA, GTO.",40,27,67,0,5,0,
25/11/2014,D.F.,"VENUSTIANO CARRANZA, D.F.",17,4,21,0,0,0,
25/11/2014,SIN.,"MAZATLAN, SIN.",12,5,17,0,0,0,
25/11/2014,PUE.,"ATLIXCO, PUE.",2,1,3,3,0,134,
26/11/2014,GTO.,"CELAYA, GTO.",45,11,56,0,7,0,
26/11/2014,D.F.,"VENUSTIANO CARRANZA, D.F.",29,3,32,0,0,80,
26/11/2014,SIN.,"MAZATLAN, SIN.",12,3,15,0,1,0,
26/11/2014,HGO.,"HUEJUTLA DE REYES, HGO.",3,0,3,0,0,0,
26/11/2014,ZAC.,"JALPA, ZAC.",0,1,1,0,0,0,
26/11/2014,GRO.,"ZIHUATANEJO DE AZUETA, GRO.",1,0,1,0,0,0,
26/11/2014,N.L.,"SABINAS HGO., N.L.",0,1,1,0,0,0,
26/11/2014,COAH.,"SALTILLO, COAH.",0,0,0,6,0,89,
27/11/2014,GTO.,"CELAYA, GTO.",40,22,62,0,3,0,
27/11/2014,GRO.,"TAXCO DE ALARCON, GRO.",2,1,3,2,0,0,
27/11/2014,GRO.,"ZIHUATANEJO DE AZUETA, GRO.",1,0,1,0,0,0,
28/11/2014,GTO.,"CELAYA, GTO.",50,28,78,0,5,0,
28/11/2014,D.F.,"VENUSTIANO CARRANZA, D.F.",33,6,39,0,0,100,
28/11/2014,SIN.,"MAZATLAN, SIN.",17,4,21,0,0,0,
28/11/2014,TAMPS.,"MATAMOROS, TAMPS.",3,7,10,0,0,0,
28/11/2014,NAY.,"ACAPONETA, NAY.",2,2,4,0,0,0,
28/11/2014,HGO.,"HUASCA DE OCAMPO, HGO.",1,0,1,0,3,0,
28/11/2014,N.L.,"SABINAS HGO., N.L.",0,1,1,2,0,28,
28/11/2014,ZAC.,"JALPA, ZAC.",0,1,1,0,0,0,
28/11/2014,COAH.,"SALTILLO, COAH.",0,0,0,0,0,45,
28/11/2014,HGO.,"HUEJUTLA DE REYES, HGO.",0,0,0,0,4,16,
29/11/2014,GTO.,"CELAYA, GTO.",61,40,101,0,9,0,
29/11/2014,HGO.,"HUASCA DE OCAMPO, HGO.",2,1,3,0,0,0,
29/11/2014,HGO.,"HUEJUTLA DE REYES, HGO.",0,0,0,0,0,200,
01/12/2014,GTO.,"CELAYA, GTO.",20,12,32,0,0,0,
01/12/2014,GTO.,"LEON, GTO.",15,5,20,0,1,0,
01/12/2014,N.L.,"MONTERREY, N.L.",7,0,7,5,0,1077,
01/12/2014,GRO.,"HUITZUCO DE LOS FIGUEROA, GRO.",1,0,1,0,0,165,
02/12/2014,D.F.,"ALVARO OBREGON, D.F.",43,4,47,0,0,100,
02/12/2014,GTO.,"LEON, GTO.",27,12,39,0,2,0,
02/12/2014,N.L.,"MONTERREY, N.L.",2,6,8,2,0,470,
02/12/2014,ZAC.,"TRINIDAD GARCIA DE LA CADENA, ZAC.",0,1,1,0,0,0,
03/12/2014,GTO.,"LEON, GTO.",37,21,58,0,7,0,
03/12/2014,D.F.,"ALVARO OBREGON, D.F.",36,17,53,0,0,50,
03/12/2014,N.L.,"MONTERREY, N.L.",5,4,9,31,0,484,
03/12/2014,GRO.,"HUITZUCO DE LOS FIGUEROA, GRO.",1,0,1,0,0,0,
03/12/2014,N.L.,"ANAHUAC, N.L.",0,1,1,0,0,0,
03/12/2014,GRO.,"TELOLOAPAN, GRO.",0,0,0,0,1,0,
04/12/2014,GTO.,"LEON, GTO.",49,19,68,0,1,0,
04/12/2014,D.F.,"ALVARO OBREGON, D.F.",41,6,47,0,2,50,
04/12/2014,N.L.,"ANAHUAC, N.L.",2,6,8,4,0,204,
04/12/2014,N.L.,"MONTERREY, N.L.",5,1,6,0,0,1917,
04/12/2014,GRO.,"HUITZUCO DE LOS FIGUEROA, GRO.",1,0,1,1,0,0,
04/12/2014,TAMPS.,"MATAMOROS, TAMPS.",0,1,1,0,0,48,
04/12/2014,GRO.,"FLORENCIO VILLARREAL, GRO.",1,0,1,0,0,0,
04/12/2014,COAH.,"ACUÑA, COAH.",0,0,0,0,0,25,
05/12/2014,D.F.,"ALVARO OBREGON, D.F.",69,33,102,0,1,60,
05/12/2014,GTO.,"LEON, GTO.",23,9,32,0,1,0,
05/12/2014,TAMPS.,"MATAMOROS, TAMPS.",15,17,32,0,0,55,
05/12/2014,N.L.,"MONTERREY, N.L.",2,3,5,4,0,936,
05/12/2014,NAY.,"ACAPONETA, NAY.",2,0,2,0,0,0,
05/12/2014,B.C.S.,"LOS CABOS, B.C.S.",0,2,2,0,0,0,
05/12/2014,GRO.,"ACAPULCO DE JUAREZ, GRO.",1,0,1,0,0,0,
05/12/2014,COAH.,"SALTILLO, COAH.",0,0,0,0,0,15,
06/12/2014,N.L.,"MONTERREY, N.L.",2,6,8,50,0,364,
06/12/2014,N.L.,"ANAHUAC, N.L.",1,4,5,1,0,300,
06/12/2014,B.C.S.,"LOS CABOS, B.C.S.",1,2,3,0,0,0,
07/12/2014,JAL.,"TOMATLAN, JAL.",0,2,2,0,0,0,
08/12/2014,D.F.,"CUAUHTEMOC, D.F.",25,6,31,0,0,0,
08/12/2014,N.L.,"MONTERREY, N.L.",8,3,11,49,0,5370,
08/12/2014,COAH.,"ACUÑA, COAH.",1,0,1,0,0,0,
08/12/2014,COL.,"COL., COL.",0,1,1,0,0,0,
08/12/2014,GRO.,"ACAPULCO DE JUAREZ, GRO.",1,0,1,0,0,0,
08/12/2014,COAH.,"SALTILLO, COAH.",0,0,0,0,0,20,
08/12/2014,Q. ROO,"COZUMEL, Q. ROO",0,0,0,0,0,130,
09/12/2014,D.F.,"CUAUHTEMOC, D.F.",39,7,46,0,2,150,
09/12/2014,TAMPS.,"MATAMOROS, TAMPS.",9,7,16,0,0,0,
09/12/2014,COL.,"COL., COL.",1,0,1,0,0,0,
09/12/2014,Q. ROO,"COZUMEL, Q. ROO",0,0,0,0,0,33,
10/12/2014,TAMPS.,"MATAMOROS, TAMPS.",11,2,13,0,0,43,
10/12/2014,CHIS.,"BENEMÉRITO DE LAS AMÉRICAS, CHIS.",2,2,4,2,0,0,
10/12/2014,COAH.,"ACUÑA, COAH.",1,0,1,0,0,0,
10/12/2014,N.L.,"MONTERREY, N.L.",0,1,1,18,0,638,
10/12/2014,PUE.,"ATLIXCO, PUE.",0,0,0,0,0,270,
11/12/2014,D.F.,"CUAUHTEMOC, D.F.",43,10,53,0,0,350,
11/12/2014,COAH.,"TORREÓN, COAH.",2,0,2,0,0,0,
11/12/2014,CHIS.,"BENEMÉRITO DE LAS AMÉRICAS, CHIS.",1,0,1,0,0,0,
11/12/2014,GRO.,"ACAPULCO DE JUAREZ, GRO.",1,0,1,0,0,0,
12/12/2014,D.F.,"CUAUHTEMOC, D.F.",38,26,64,0,0,300,
12/12/2014,TAMPS.,"MATAMOROS, TAMPS.",8,5,13,0,0,0,
12/12/2014,N.L.,"MONTERREY, N.L.",4,1,5,10,0,1350,
12/12/2014,NAY.,"ACAPONETA, NAY.",2,0,2,0,0,0,
12/12/2014,CHIS.,"BENEMÉRITO DE LAS AMÉRICAS, CHIS.",0,1,1,0,0,0,
12/12/2014,CHIH.,"HGO. DEL PARRAL, CHIH.",0,1,1,0,0,0,
12/12/2014,GRO.,"TELOLOAPAN, GRO.",1,0,1,0,0,0,
12/12/2014,TAMPS.,"NUEVO LAREDO, TAMPS.",1,0,1,1,0,65,
13/12/2014,D.F.,"CUAUHTEMOC, D.F.",33,2,35,0,0,200,
13/12/2014,TAMPS.,"MATAMOROS, TAMPS.",7,5,12,0,0,0,
13/12/2014,N.L.,"MONTERREY, N.L.",9,0,9,38,0,1520,
13/12/2014,COAH.,"TORREÓN, COAH.",1,0,1,0,0,0,
13/12/2014,CHIH.,"HGO. DEL PARRAL, CHIH.",0,1,1,0,0,0,
14/12/2014,D.F.,"CUAUHTEMOC, D.F.",64,15,79,0,0,50,
14/12/2014,N.L.,"MONTERREY, N.L.",6,0,6,63,0,11167,
15/12/2014,D.F.,"CUAUHTEMOC, D.F.",34,16,50,0,0,600,
15/12/2014,N.L.,"MONTERREY, N.L.",5,9,14,0,0,6795,
15/12/2014,N.L.,"MONTERREY, N.L.",2,4,6,73,0,8070,
15/12/2014,CHIS.,"BENEMÉRITO DE LAS AMÉRICAS, CHIS.",1,1,2,0,0,0,
15/12/2014,TAMPS.,"MATAMOROS, TAMPS.",1,0,1,0,0,0,
15/12/2014,GRO.,"TELOLOAPAN, GRO.",0,1,1,0,0,0,
16/12/2014,D.F.,"CUAUHTEMOC, D.F.",34,3,37,0,0,150,
16/12/2014,TAMPS.,"MATAMOROS, TAMPS.",7,6,13,3,0,70,
16/12/2014,DGO.,"DGO., DGO.",11,0,11,6,3,0,
16/12/2014,CHIS.,"BENEMÉRITO DE LAS AMÉRICAS, CHIS.",2,2,4,0,0,0,
16/12/2014,N.L.,"MONTERREY, N.L.",3,0,3,82,0,12986,
16/12/2014,DGO.,"GOMEZ PALACIO, DGO.",0,2,2,0,0,0,
16/12/2014,B.C.S.,"LA PAZ, B.C.S.",1,1,2,0,0,0,
16/12/2014,N.L.,"SAN NICOLAS DE LOS GARZA, N.L.",1,0,1,4,0,62,
16/12/2014,COAH.,"SALTILLO, COAH.",0,0,0,0,0,30,
17/12/2014,DGO.,"LERDO, DGO.",13,6,19,1,0,0,
17/12/2014,DGO.,"GOMEZ PALACIO, DGO.",11,6,17,1,0,0,
17/12/2014,DGO.,"DGO., DGO.",5,1,6,19,11,0,
17/12/2014,COAH.,"TORREÓN, COAH.",2,0,2,0,0,0,
18/12/2014,D.F.,"CUAUHTEMOC, D.F.",34,16,50,0,0,250,
18/12/2014,TAMPS.,"MATAMOROS, TAMPS.",7,8,15,0,0,0,
18/12/2014,N.L.,"MONTERREY, N.L.",3,4,7,89,0,19520,
18/12/2014,GRO.,"ACAPULCO DE JUAREZ, GRO.",0,4,4,0,0,390,
18/12/2014,DGO.,"DGO., DGO.",2,1,3,1,3,0,
18/12/2014,COAH.,"ACUÑA, COAH.",1,1,2,0,0,0,
18/12/2014,COAH.,"SALTILLO, COAH.",0,0,0,0,0,28,
18/12/2014,N.L.,"SAN NICOLAS DE LOS GARZA, N.L.",0,0,0,3,0,0,
19/12/2014,D.F.,"CUAUHTEMOC, D.F.",52,19,71,0,0,50,
19/12/2014,DGO.,"GOMEZ PALACIO, DGO.",3,7,10,2,0,0,
19/12/2014,DGO.,"LERDO, DGO.",3,3,6,1,0,0,
19/12/2014,N.L.,"MONTERREY, N.L.",3,3,6,104,0,21138,
19/12/2014,TAMPS.,"MATAMOROS, TAMPS.",1,5,6,0,0,0,
19/12/2014,COAH.,"TORREÓN, COAH.",4,0,4,0,0,0,
19/12/2014,CHIS.,"BENEMÉRITO DE LAS AMÉRICAS, CHIS.",1,2,3,0,0,0,
19/12/2014,GRO.,"ATOYAC DE ALVAREZ, GRO.",2,1,3,0,0,0,
19/12/2014,DGO.,"DGO., DGO.",2,0,2,8,4,0,
19/12/2014,B.C.S.,"COMONDÚ, B.C.S.",1,0,1,0,0,0,
19/12/2014,COAH.,"ACUÑA, COAH.",1,0,1,0,0,0,
20/12/2014,DGO.,"GOMEZ PALACIO, DGO.",4,7,11,4,0,0,
20/12/2014,TAMPS.,"MATAMOROS, TAMPS.",7,2,9,0,0,0,
20/12/2014,N.L.,"MONTERREY, N.L.",4,3,7,113,0,38125,
20/12/2014,DGO.,"LERDO, DGO.",0,4,4,0,2,0,
20/12/2014,DGO.,"DGO., DGO.",4,0,4,4,0,0,
20/12/2014,N.L.,"SAN NICOLAS DE LOS GARZA, N.L.",3,0,3,8,0,128,
20/12/2014,GRO.,"IGUALA DE LA INDEPENDENCIA, GRO.",2,1,3,0,1,0,
20/12/2014,COAH.,"TORREÓN, COAH.",0,2,2,0,0,0,
20/12/2014,GRO.,"ACAPULCO DE JUAREZ, GRO.",0,2,2,4,0,116,
20/12/2014,DGO.,"DGO., DGO.",0,2,2,10,1,0,
21/12/2014,GRO.,"IGUALA DE LA INDEPENDENCIA, GRO.",3,3,6,0,0,0,
22/12/2014,GRO.,"IGUALA DE LA INDEPENDENCIA, GRO.",8,5,13,0,0,0,
22/12/2014,TAMPS.,"MATAMOROS, TAMPS.",7,3,10,0,0,0,
22/12/2014,DGO.,"DGO., DGO.",5,2,7,1,3,0,
22/12/2014,CHIS.,"BENEMÉRITO DE LAS AMÉRICAS, CHIS.",1,1,2,0,0,0,
23/12/2014,DGO.,"DGO., DGO.",8,1,9,4,0,0,
23/12/2014,TAB.,"TEAPA, TAB.",1,1,2,0,0,0,
23/12/2014,GRO.,"ACAPULCO DE JUAREZ, GRO.",0,1,1,0,0,0,
24/12/2014,DGO.,"GOMEZ PALACIO, DGO.",8,11,19,0,0,0,
24/12/2014,TAMPS.,"MATAMOROS, TAMPS.",8,7,15,0,0,0,
24/12/2014,DGO.,"DGO., DGO.",11,1,12,10,5,0,
24/12/2014,DGO.,"LERDO, DGO.",6,0,6,0,0,0,
25/12/2014,SON.,"HERMOSILLO, SON.",34,16,50,377,3,2777,
25/12/2014,DGO.,"LERDO, DGO.",1,4,5,0,0,0,
25/12/2014,DGO.,"GOMEZ PALACIO, DGO.",0,2,2,0,0,0,
25/12/2014,DGO.,"DGO., DGO.",1,0,1,4,0,0,
26/12/2014,TAMPS.,"MATAMOROS, TAMPS.",8,9,17,0,0,0,
26/12/2014,DGO.,"GOMEZ PALACIO, DGO.",8,2,10,3,1,0,
26/12/2014,DGO.,"LERDO, DGO.",3,6,9,0,1,0,
26/12/2014,DGO.,"DGO., DGO.",2,2,4,1,0,0,
26/12/2014,CHIS.,"BENEMÉRITO DE LAS AMÉRICAS, CHIS.",0,1,1,0,0,0,
26/12/2014,COAH.,"TORREÓN, COAH.",1,0,1,0,0,0,
27/12/2014,DGO.,"DGO., DGO.",7,1,8,0,1,0,
27/12/2014,DGO.,"GOMEZ PALACIO, DGO.",3,2,5,0,0,0,
27/12/2014,COAH.,"TORREÓN, COAH.",2,0,2,0,1,0,
27/12/2014,CHIS.,"MARQUÉS DE COMILLAS, CHIS.",0,1,1,0,0,0,
28/12/2014,DGO.,"DGO., DGO.",9,2,11,0,0,0,
28/12/2014,DGO.,"GOMEZ PALACIO, DGO.",1,7,8,1,2,0,
28/12/2014,DGO.,"LERDO, DGO.",2,2,4,3,0,0,
28/12/2014,TAMPS.,"MATAMOROS, TAMPS.",2,1,3,0,0,0,
29/12/2014,TAMPS.,"MATAMOROS, TAMPS.",8,6,14,0,0,6,
29/12/2014,DGO.,"DGO., DGO.",7,3,10,2,0,1,
29/12/2014,DGO.,"LERDO, DGO.",3,2,5,0,0,0,
29/12/2014,DGO.,"GOMEZ PALACIO, DGO.",2,2,4,0,0,0,
30/12/2014,TAMPS.,"MATAMOROS, TAMPS.",9,8,17,0,0,0,
30/12/2014,DGO.,"DGO., DGO.",4,4,8,0,0,0,
30/12/2014,CHIS.,"MARQUÉS DE COMILLAS, CHIS.",1,2,3,0,0,0,
30/12/2014,CHIS.,"BENEMÉRITO DE LAS AMÉRICAS, CHIS.",1,1,2,1,0,0,
30/12/2014,PUE.,"ATLIXCO, PUE.",1,0,1,0,0,0,
31/12/2014,DGO.,"LERDO, DGO.",10,1,11,2,0,0,
31/12/2014,DGO.,"GOMEZ PALACIO, DGO.",8,1,9,20,1,0,
31/12/2014,CHIS.,"BENEMÉRITO DE LAS AMÉRICAS, CHIS.",0,1,1,0,0,0,
02/01/2015,DGO.,"GOMEZ PALACIO, DGO.",4,5,9,0,0,0,
02/01/2015,DGO.,"LERDO, DGO.",0,3,3,6,0,0,
02/01/2015,PUE.,"ATLIXCO, PUE.",2,0,2,0,0,0,
02/01/2015,CHIS.,"BENEMÉRITO DE LAS AMÉRICAS, CHIS.",0,1,1,0,0,0,
03/01/2015,VER.,"TUXPAM, VER.",1,0,1,0,0,9,
03/01/2015,PUE.,"ATLIXCO, PUE.",1,0,1,0,0,0,
03/01/2015,DGO.,"DGO., DGO.",0,0,0,0,1,0,
04/01/2015,DGO.,"LERDO, DGO.",1,3,4,0,0,0,
04/01/2015,DGO.,"GOMEZ PALACIO, DGO.",2,1,3,1,0,0,
04/01/2015,DGO.,"DGO., DGO.",0,1,1,0,0,0,
05/01/2015,DGO.,"LERDO, DGO.",4,2,6,0,0,0,
05/01/2015,DGO.,"DGO., DGO.",4,0,4,0,0,0,
05/01/2015,CHIS.,"BENEMÉRITO DE LAS AMÉRICAS, CHIS.",3,0,3,0,0,0,
06/01/2015,DGO.,"LERDO, DGO.",15,5,20,1,0,0,
06/01/2015,DGO.,"GOMEZ PALACIO, DGO.",8,3,11,0,0,0,
06/01/2015,DGO.,"DGO., DGO.",9,1,10,3,0,0,
06/01/2015,CHIS.,"MARQUÉS DE COMILLAS, CHIS.",1,1,2,0,0,0,
07/01/2015,DGO.,"DGO., DGO.",1,1,2,0,1,0,
07/01/2015,COL.,"COL., COL.",0,1,1,0,0,0,
08/01/2015,COL.,"TECOMÁN, COL.",1,0,1,0,0,0,
08/01/2015,DGO.,"DGO., DGO.",0,1,1,0,0,0,
09/01/2015,TAMPS.,"MATAMOROS, TAMPS.",5,6,11,0,0,0,
09/01/2015,DGO.,"DGO., DGO.",1,1,2,0,0,0,
10/01/2015,TAMPS.,"MATAMOROS, TAMPS.",0,7,7,0,0,0,
10/01/2015,DGO.,"DGO., DGO.",3,3,6,2,0,0,
11/01/2015,DGO.,"DGO., DGO.",1,0,1,0,0,0,
12/01/2015,DGO.,"DGO., DGO.",2,0,2,0,0,0,
12/01/2015,TAB.,"TENOSIQUE, TAB.",1,0,1,0,0,0,
13/01/2015,DGO.,"DGO., DGO.",1,0,1,14,0,0,
13/01/2015,ZAC.,"TRINIDAD GARCIA DE LA CADENA, ZAC.",1,0,1,0,0,0,
14/01/2015,DGO.,"DGO., DGO.",4,1,5,0,0,0,
14/01/2015,COAH.,"SALTILLO, COAH.",2,0,2,0,0,36,
14/01/2015,CHIS.,"MARQUÉS DE COMILLAS, CHIS.",0,1,1,0,0,0,
15/01/2015,DGO.,"DGO., DGO.",2,1,3,1,0,0,
16/01/2015,TAMPS.,"MATAMOROS, TAMPS.",5,2,7,1,0,0,
17/01/2015,VER.,"LA ANTIGUA, VER.",2,0,2,0,0,0,
17/01/2015,DGO.,"DGO., DGO.",1,0,1,0,0,0,
18/01/2015,TAMPS.,"MATAMOROS, TAMPS.",5,5,10,0,0,0,
18/01/2015,DGO.,"DGO., DGO.",6,1,7,3,0,0,
19/01/2015,DGO.,"DGO., DGO.",2,1,3,1,0,0,
19/01/2015,COAH.,"ACUÑA, COAH.",0,1,1,0,0,0,
20/01/2015,DGO.,"DGO., DGO.",3,0,3,1,0,0,
20/01/2015,CHIS.,"MARQUÉS DE COMILLAS, CHIS.",0,1,1,0,0,0,
22/01/2015,DGO.,"DGO., DGO.",3,0,3,4,5,0,
22/01/2015,COL.,"COL., COL.",1,1,2,0,0,0,
23/01/2015,COL.,"COL., COL.",2,1,3,0,0,0,
23/01/2015,CHIS.,"MARAVILLA TENEJAPA, CHIS.",0,1,1,0,0,0,
23/01/2015,COAH.,"ACUÑA, COAH.",1,0,1,0,0,0,
23/01/2015,PUE.,"TEHUACAN, PUE.",1,0,1,0,0,0,
23/01/2015,PUE.,"TEHUACAN, PUE.",1,0,1,0,0,0,
23/01/2015,COAH.,"SALTILLO, COAH.",0,0,0,0,0,140,
24/01/2015,TAMPS.,"MATAMOROS, TAMPS.",2,9,11,0,0,0,
24/01/2015,DGO.,"DGO., DGO.",5,0,5,3,0,0,
25/01/2015,B.C.,"TIJUANA, B.C.",5,1,6,0,0,0,
25/01/2015,PUE.,"ATLIXCO, PUE.",0,1,1,0,0,0,
26/01/2015,B.C.,"TIJUANA, B.C.",5,3,8,0,0,0,
26/01/2015,DGO.,"DGO., DGO.",2,2,4,1,0,0,
26/01/2015,COL.,"COL., COL.",2,0,2,0,0,0,
26/01/2015,CHIS.,"BENEMÉRITO DE LAS AMÉRICAS, CHIS.",1,1,2,0,0,0,
26/01/2015,COAH.,"SALTILLO, COAH.",0,0,0,0,0,4,
27/01/2015,PUE.,"ATLIXCO, PUE.",0,0,0,0,0,60,
28/01/2015,CHIS.,"BENEMÉRITO DE LAS AMÉRICAS, CHIS.",2,1,3,0,0,0,
28/01/2015,PUE.,"ATLIXCO, PUE.",3,0,3,0,0,0,
28/01/2015,COL.,"COL., COL.",2,0,2,0,0,0,
28/01/2015,DGO.,"DGO., DGO.",1,0,1,0,0,0,
29/01/2015,B.C.,"TIJUANA, B.C.",5,1,6,0,0,0,
29/01/2015,DGO.,"DGO., DGO.",3,0,3,3,2,0,
29/01/2015,CHIS.,"BENEMÉRITO DE LAS AMÉRICAS, CHIS.",1,1,2,0,0,0,
29/01/2015,JAL.,"LAGOS DE MORENO, JAL.",1,1,2,0,0,0,
29/01/2015,PUE.,"TEHUACAN, PUE.",2,0,2,0,0,0,
30/01/2015,TAMPS.,"MATAMOROS, TAMPS.",8,7,15,0,0,0,
30/01/2015,CHIS.,"BENEMÉRITO DE LAS AMÉRICAS, CHIS.",3,2,5,0,0,0,
30/01/2015,PUE.,"TEHUACAN, PUE.",1,1,2,0,0,21,
30/01/2015,PUE.,"TEHUACAN, PUE.",0,1,1,0,0,21,
31/01/2015,B.C.,"TIJUANA, B.C.",9,6,15,0,0,0,
31/01/2015,TAMPS.,"MATAMOROS, TAMPS.",5,7,12,0,0,0,
31/01/2015,PUE.,"TEHUACAN, PUE.",1,0,1,0,0,0,
01/02/2015,B.C.,"TIJUANA, B.C.",5,7,12,0,0,0,
02/02/2015,DGO.,"DGO., DGO.",1,0,1,8,1,0,
03/02/2015,B.C.,"TIJUANA, B.C.",4,2,6,0,0,0,
03/02/2015,NAY.,"TEPIC, NAY.",1,1,2,0,0,0,
04/02/2015,B.C.,"MEXICALI, B.C.",1,4,5,0,0,0,
04/02/2015,B.C.,"ENSENADA, B.C.",1,0,1,0,0,0,
04/02/2015,DGO.,"DGO., DGO.",0,1,1,0,0,0,
04/02/2015,CHIS.,"BENEMÉRITO DE LAS AMÉRICAS, CHIS.",1,0,1,0,0,0,
05/02/2015,B.C.,"MEXICALI, B.C.",3,4,7,0,0,0,
05/02/2015,CHIS.,"BENEMÉRITO DE LAS AMÉRICAS, CHIS.",1,0,1,0,0,0,
05/02/2015,CHIS.,"BENEMÉRITO DE LAS AMÉRICAS, CHIS.",0,1,1,0,0,0,
05/02/2015,PUE.,"TEHUACAN, PUE.",0,1,1,0,0,0,
05/02/2015,COAH.,"ACUÑA, COAH.",1,0,1,0,0,0,
05/02/2015,B.C.,"ENSENADA, B.C.",1,0,1,0,0,0,
05/02/2015,TAMPS.,"NUEVO LAREDO, TAMPS.",0,1,1,0,0,0,
05/02/2015,GRO.,"ACAPULCO DE JUAREZ, GRO.",0,1,1,0,0,0,
05/02/2015,NAY.,"TEPIC, NAY.",1,0,1,0,1,0,
06/02/2015,TAMPS.,"MATAMOROS, TAMPS.",8,12,20,200,0,0,
06/02/2015,B.C.,"MEXICALI, B.C.",0,3,3,0,0,0,
06/02/2015,B.C.,"TIJUANA, B.C.",0,1,1,0,0,0,
06/02/2015,B.C.,"ENSENADA, B.C.",1,0,1,0,0,0,
06/02/2015,GRO.,"IGUALA DE LA INDEPENDENCIA, GRO.",1,0,1,0,0,0,
06/02/2015,COAH.,"ACUÑA, COAH.",0,0,0,1,0,0,
06/02/2015,PUE.,"TEHUACAN, PUE.",0,0,0,0,0,18,
07/02/2015,B.C.,"TIJUANA, B.C.",2,2,4,0,0,0,
07/02/2015,TAMPS.,"NUEVO LAREDO, TAMPS.",0,1,1,0,0,50,
07/02/2015,GRO.,"IGUALA DE LA INDEPENDENCIA, GRO.",0,1,1,0,0,0,
07/02/2015,B.C.,"ENSENADA, B.C.",1,0,1,0,0,0,
08/02/2015,B.C.,"ENSENADA, B.C.",1,0,1,0,0,0,
08/02/2015,GRO.,"IGUALA DE LA INDEPENDENCIA, GRO.",1,0,1,0,0,0,
08/02/2015,COAH.,"ACUÑA, COAH.",0,0,0,0,0,35,
09/02/2015,D.F.,"IZTAPALAPA, D.F.",6,12,18,0,1,0,
09/02/2015,B.C.,"TIJUANA, B.C.",5,2,7,0,0,0,
10/02/2015,D.F.,"IZTAPALAPA, D.F.",6,11,17,0,1,0,
10/02/2015,B.C.,"TIJUANA, B.C.",3,0,3,0,0,0,
10/02/2015,PUE.,"TEHUACAN, PUE.",2,0,2,0,0,0,
10/02/2015,YUC.,"TEKAL DE VENEGAS, YUC.",0,1,1,0,0,0,
10/02/2015,NAY.,"TEPIC, NAY.",1,0,1,0,0,0,
11/02/2015,D.F.,"IZTAPALAPA, D.F.",23,6,29,0,0,2000,
11/02/2015,YUC.,"TEKAL DE VENEGAS, YUC.",1,1,2,0,0,0,
11/02/2015,NAY.,"TEPIC, NAY.",2,0,2,0,0,0,
11/02/2015,GRO.,"IGUALA DE LA INDEPENDENCIA, GRO.",1,0,1,0,0,0,
11/02/2015,COAH.,"FRONTERA, COAH.",0,0,0,0,1,0,
12/02/2015,D.F.,"IZTAPALAPA, D.F.",25,12,37,0,0,1000,
12/02/2015,B.C.,"TIJUANA, B.C.",4,3,7,0,0,0,
12/02/2015,CHIS.,"BENEMÉRITO DE LAS AMÉRICAS, CHIS.",1,0,1,0,0,0,
12/02/2015,ZAC.,"TEUL DE GONZALEZ ORTEGA, ZAC.",1,0,1,0,0,0,
12/02/2015,GRO.,"ACAPULCO DE JUAREZ, GRO.",0,0,0,0,0,17,
12/02/2015,Q. ROO,"OTHON P. BLANCO, Q. ROO",0,0,0,0,5,0,
13/02/2015,D.F.,"IZTAPALAPA, D.F.",23,17,40,0,1,1000,
13/02/2015,TAMPS.,"MATAMOROS, TAMPS.",14,12,26,6,0,0,
13/02/2015,NAY.,"TEPIC, NAY.",2,0,2,0,0,0,
13/02/2015,COAH.,"ACUÑA, COAH.",1,0,1,0,0,0,
13/02/2015,PUE.,"ATLIXCO, PUE.",1,0,1,0,0,0,
14/02/2015,TAMPS.,"MATAMOROS, TAMPS.",10,8,18,0,0,200,
14/02/2015,B.C.,"MEXICALI, B.C.",2,6,8,0,0,0,
14/02/2015,B.C.,"ENSENADA, B.C.",1,0,1,0,0,0,
15/02/2015,B.C.,"MEXICALI, B.C.",7,0,7,0,0,0,
15/02/2015,TAMPS.,"NUEVO LAREDO, TAMPS.",1,0,1,0,0,0,
15/02/2015,Q. ROO,"OTHON P. BLANCO, Q. ROO",0,0,0,0,5,0,
16/02/2015,D.F.,"IZTAPALAPA, D.F.",21,8,29,0,0,250,
17/02/2015,D.F.,"IZTAPALAPA, D.F.",24,13,37,0,0,200,
17/02/2015,B.C.,"TIJUANA, B.C.",5,2,7,0,0,0,
17/02/2015,B.C.,"ENSENADA, B.C.",3,2,5,0,0,0,
17/02/2015,NAY.,"TEPIC, NAY.",2,0,2,0,0,2,
17/02/2015,COAH.,"TORREÓN, COAH.",0,1,1,0,0,0,
18/02/2015,D.F.,"IZTAPALAPA, D.F.",24,16,40,0,0,200,
18/02/2015,B.C.,"TIJUANA, B.C.",4,4,8,0,0,0,
18/02/2015,B.C.,"MEXICALI, B.C.",2,0,2,0,0,0,
19/02/2015,D.F.,"IZTAPALAPA, D.F.",27,13,40,0,0,150,
19/02/2015,B.C.,"MEXICALI, B.C.",2,2,4,0,0,0,
19/02/2015,YUC.,"TEMAX, YUC.",1,2,3,0,0,0,
20/02/2015,D.F.,"IZTAPALAPA, D.F.",30,15,45,0,0,100,
20/02/2015,TAMPS.,"MATAMOROS, TAMPS.",8,12,20,0,0,100,
20/02/2015,B.C.,"TIJUANA, B.C.",3,1,4,0,0,0,
20/02/2015,GRO.,"ACAPULCO DE JUAREZ, GRO.",4,0,4,0,0,0,
20/02/2015,VER.,"ALAMO, VER.",3,0,3,0,0,0,
20/02/2015,YUC.,"TEMAX, YUC.",2,0,2,0,0,0,
20/02/2015,B.C.,"ENSENADA, B.C.",0,2,2,0,0,0,
20/02/2015,COL.,"COL., COL.",1,0,1,0,0,0,
20/02/2015,PUE.,"ATLIXCO, PUE.",1,0,1,0,0,0,
20/02/2015,Q. ROO,"OTHON P. BLANCO, Q. ROO",0,0,0,1,0,59,
21/02/2015,TAMPS.,"MATAMOROS, TAMPS.",0,8,8,0,0,0,
21/02/2015,B.C.,"TIJUANA, B.C.",2,3,5,0,0,0,
21/02/2015,B.C.,"MEXICALI, B.C.",0,2,2,0,0,0,
21/02/2015,PUE.,"ATLIXCO, PUE.",0,0,0,0,0,345,
22/02/2015,ZAC.,"TEUL DE GONZALEZ ORTEGA, ZAC.",0,0,0,0,0,250,
23/02/2015,D.F.,"IZTAPALAPA, D.F.",29,14,43,0,2,70,
23/02/2015,ZAC.,"TEUL DE GONZALEZ ORTEGA, ZAC.",0,0,0,0,0,250,
24/02/2015,D.F.,"IZTAPALAPA, D.F.",31,17,48,0,0,30,
24/02/2015,COAH.,"ACUÑA, COAH.",3,2,5,0,0,0,
24/02/2015,B.C.,"MEXICALI, B.C.",1,2,3,0,0,0,
24/02/2015,PUE.,"TEHUACAN, PUE.",0,0,0,0,0,86,
25/02/2015,D.F.,"IZTAPALAPA, D.F.",27,18,45,0,0,40,
25/02/2015,HGO.,"PACHUCA DE SOTO, HGO.",4,0,4,0,0,500,
25/02/2015,B.C.,"ENSENADA, B.C.",0,2,2,0,0,0,
26/02/2015,D.F.,"IZTAPALAPA, D.F.",35,14,49,0,0,0,
26/02/2015,B.C.,"ENSENADA, B.C.",0,4,4,0,0,0,
26/02/2015,PUE.,"TEHUACAN, PUE.",2,0,2,0,0,0,
27/02/2015,D.F.,"IZTAPALAPA, D.F.",31,15,46,0,0,0,
27/02/2015,TAMPS.,"MATAMOROS, TAMPS.",6,7,13,0,0,0,
27/02/2015,HGO.,"PACHUCA DE SOTO, HGO.",1,1,2,0,3,0,
27/02/2015,COAH.,"TORREÓN, COAH.",0,2,2,0,0,0,
27/02/2015,PUE.,"ATLIXCO, PUE.",0,0,0,0,0,73,
28/02/2015,TAMPS.,"MATAMOROS, TAMPS.",5,5,10,0,0,0,
28/02/2015,VER.,"ALAMO, VER.",2,1,3,0,0,0,
28/02/2015,HGO.,"PACHUCA DE SOTO, HGO.",1,0,1,0,0,200,
28/02/2015,PUE.,"TEHUACAN, PUE.",0,0,0,0,0,39,
02/03/2015,D.F.,"IZTAPALAPA, D.F.",28,9,37,0,0,70,
02/03/2015,GTO.,"SALAMANCA, GTO.",17,4,21,0,0,0,
02/03/2015,HGO.,"CHAPULHUACAN, HGO.",4,1,5,0,0,0,
02/03/2015,GRO.,"ACAPULCO DE JUAREZ, GRO.",1,0,1,0,0,0,
03/03/2015,D.F.,"IZTAPALAPA, D.F.",34,15,49,0,0,350,
03/03/2015,GTO.,"SALAMANCA, GTO.",16,4,20,0,0,0,
03/03/2015,B.C.,"MEXICALI, B.C.",0,2,2,0,0,0,
03/03/2015,VER.,"POZA RICA DE HGO., VER.",0,1,1,0,0,0,
03/03/2015,CHIS.,"MARAVILLA TENEJAPA, CHIS.",1,0,1,0,0,0,
03/03/2015,HGO.,"PACHUCA DE SOTO, HGO.",0,0,0,0,0,17,
04/03/2015,D.F.,"IZTAPALAPA, D.F.",36,11,47,0,2,250,
04/03/2015,GTO.,"SALAMANCA, GTO.",13,4,17,0,0,0,
04/03/2015,B.C.,"MEXICALI, B.C.",1,3,4,0,0,0,
04/03/2015,VER.,"POZA RICA DE HGO., VER.",2,1,3,2,0,125,
04/03/2015,CHIS.,"BENEMÉRITO DE LAS AMÉRICAS, CHIS.",0,1,1,0,0,0,
04/03/2015,B.C.,"ENSENADA, B.C.",0,1,1,0,0,0,
04/03/2015,HGO.,"PACHUCA DE SOTO, HGO.",0,0,0,0,0,67,
04/03/2015,TAB.,"JALAPA, TAB.",0,0,0,1,0,99,
05/03/2015,D.F.,"IZTAPALAPA, D.F.",27,15,42,0,0,25,
05/03/2015,GTO.,"SALAMANCA, GTO.",11,5,16,0,0,0,
05/03/2015,CAMP.,"CAMP., CAMP.",1,2,3,0,0,0,
05/03/2015,B.C.,"TIJUANA, B.C.",1,2,3,0,0,0,
05/03/2015,B.C.,"MEXICALI, B.C.",2,0,2,0,0,0,
05/03/2015,ZAC.,"FRESNILLO, ZAC.",1,0,1,0,0,0,
05/03/2015,GRO.,"HUITZUCO DE LOS FIGUEROA, GRO.",0,1,1,0,0,0,
05/03/2015,HGO.,"PACHUCA DE SOTO, HGO.",0,1,1,0,0,0,
05/03/2015,PUE.,"TEHUACAN, PUE.",1,0,1,0,0,12,
06/03/2015,D.F.,"IZTAPALAPA, D.F.",29,15,44,0,1,150,
06/03/2015,CAMP.,"CAMP., CAMP.",1,2,3,0,0,0,
06/03/2015,HGO.,"PACHUCA DE SOTO, HGO.",1,1,2,0,11,17,
06/03/2015,TAMPS.,"MATAMOROS, TAMPS.",0,1,1,0,0,0,
06/03/2015,VER.,"POZA RICA DE HGO., VER.",1,0,1,3,0,304,
06/03/2015,CHIS.,"MARAVILLA TENEJAPA, CHIS.",1,0,1,0,0,0,
06/03/2015,TAB.,"JALAPA, TAB.",0,0,0,0,0,56,
07/03/2015,B.C.,"TIJUANA, B.C.",3,3,6,0,0,0,
07/03/2015,HGO.,"PACHUCA DE SOTO, HGO.",0,2,2,0,0,0,
09/03/2015,B.C.,"TIJUANA, B.C.",2,1,3,0,0,0,
09/03/2015,B.C.,"ENSENADA, B.C.",1,1,2,0,0,0,
09/03/2015,TAB.,"COMALCALCO, TAB.",1,0,1,0,0,0,
10/03/2015,D.F.,"IZTACALCO, D.F.",28,21,49,0,0,0,
10/03/2015,CAMP.,"CAMP., CAMP.",1,1,2,0,0,0,
10/03/2015,PUE.,"TEHUACAN, PUE.",1,0,1,0,0,20,
10/03/2015,TAMPS.,"TAMPICO, TAMPS.",1,0,1,0,0,0,
11/03/2015,D.F.,"IZTACALCO, D.F.",25,16,41,0,0,150,
11/03/2015,OAX.,"OAX. DE JUAREZ, OAX.",2,3,5,4,0,0,
11/03/2015,DGO.,"GOMEZ PALACIO, DGO.",5,0,5,0,0,0,
11/03/2015,B.C.,"MEXICALI, B.C.",1,3,4,0,0,0,
11/03/2015,CAMP.,"CAMP., CAMP.",1,1,2,0,0,0,
11/03/2015,B.C.,"TIJUANA, B.C.",1,1,2,0,0,0,
11/03/2015,OAX.,"MIAHUATLAN DE PORFIRIO DIAZ, OAX.",1,0,1,0,7,0,
11/03/2015,TAB.,"COMALCALCO, TAB.",1,0,1,0,0,0,
11/03/2015,COAH.,"TORREÓN, COAH.",1,0,1,0,0,0,
11/03/2015,CHIS.,"REFORMA, CHIS.",0,0,0,0,0,25,
12/03/2015,D.F.,"IZTACALCO, D.F.",28,16,44,0,1,0,
12/03/2015,B.C.,"MEXICALI, B.C.",1,3,4,0,0,0,
12/03/2015,CAMP.,"CAMP., CAMP.",1,1,2,0,0,0,
12/03/2015,NAY.,"COMPOSTELA, NAY.",1,0,1,0,0,0,
12/03/2015,OAX.,"MIAHUATLAN DE PORFIRIO DIAZ, OAX.",0,1,1,0,0,0,
12/03/2015,B.C.,"TIJUANA, B.C.",0,1,1,0,0,0,
13/03/2015,D.F.,"IZTACALCO, D.F.",31,12,43,0,0,0,
13/03/2015,DGO.,"GOMEZ PALACIO, DGO.",7,0,7,0,0,0,
13/03/2015,OAX.,"MIAHUATLAN DE PORFIRIO DIAZ, OAX.",4,1,5,0,0,0,
13/03/2015,CAMP.,"CAMP., CAMP.",1,1,2,0,0,0,
13/03/2015,YUC.,"TUNKAS, YUC.",0,1,1,0,0,0,
13/03/2015,DGO.,"LERDO, DGO.",1,0,1,0,1,0,
14/03/2015,TAMPS.,"MATAMOROS, TAMPS.",3,7,10,0,5,656,
14/03/2015,OAX.,"OAX. DE JUAREZ, OAX.",2,0,2,0,0,0,
15/03/2015,CAMP.,"CAMP., CAMP.",1,1,2,0,0,0,
16/03/2015,DGO.,"GOMEZ PALACIO, DGO.",1,2,3,0,0,0,
16/03/2015,CAMP.,"CAMP., CAMP.",1,1,2,0,0,0,
16/03/2015,DGO.,"LERDO, DGO.",1,0,1,0,0,0,
17/03/2015,D.F.,"IZTACALCO, D.F.",29,14,43,0,0,20,
17/03/2015,OAX.,"OAX. DE JUAREZ, OAX.",3,6,9,3,0,693,
17/03/2015,CAMP.,"CAMP., CAMP.",3,2,5,0,0,0,
17/03/2015,YUC.,"XOCCHEL, YUC.",1,4,5,6,0,70,
17/03/2015,OAX.,"CIUDAD IXTEPEC, OAX.",1,3,4,0,0,0,
18/03/2015,D.F.,"IZTACALCO, D.F.",30,18,48,0,0,30,
18/03/2015,CAMP.,"CAMP., CAMP.",3,2,5,0,0,0,
18/03/2015,DGO.,"GOMEZ PALACIO, DGO.",2,2,4,0,2,0,
18/03/2015,OAX.,"OAX. DE JUAREZ, OAX.",3,0,3,4,0,92,
18/03/2015,OAX.,"CIUDAD IXTEPEC, OAX.",0,2,2,0,0,0,
18/03/2015,PUE.,"TEHUACAN, PUE.",0,1,1,0,0,177,
18/03/2015,COL.,"COL., COL.",1,0,1,0,0,0,
18/03/2015,OAX.,"SALINA CRUZ, OAX.",1,0,1,0,0,0,
18/03/2015,OAX.,"MIAHUATLAN DE PORFIRIO DIAZ, OAX.",0,1,1,4,0,0,
18/03/2015,GRO.,"LA UNION DE ISIDORO MONTES DE OCA, GRO.",0,1,1,0,0,0,
18/03/2015,TAMPS.,"TAMPICO, TAMPS.",0,0,0,1,0,22,
19/03/2015,D.F.,"IZTACALCO, D.F.",32,16,48,0,0,100,
19/03/2015,DGO.,"GOMEZ PALACIO, DGO.",1,1,2,0,0,0,
19/03/2015,CHIS.,"BENEMÉRITO DE LAS AMÉRICAS, CHIS.",1,0,1,0,0,0,
19/03/2015,CHIS.,"REFORMA, CHIS.",1,0,1,0,0,0,
19/03/2015,OAX.,"SALINA CRUZ, OAX.",1,0,1,40,0,0,
19/03/2015,PUE.,"ATLIXCO, PUE.",0,0,0,1,0,18,
20/03/2015,D.F.,"IZTACALCO, D.F.",38,11,49,0,0,100,
20/03/2015,TAMPS.,"MATAMOROS, TAMPS.",2,4,6,0,0,0,
20/03/2015,OAX.,"OAX. DE JUAREZ, OAX.",0,4,4,4,0,89,
20/03/2015,HGO.,"TULA DE ALLENDE, HGO.",1,1,2,0,0,0,
20/03/2015,OAX.,"MIAHUATLAN DE PORFIRIO DIAZ, OAX.",0,1,1,0,0,0,
20/03/2015,OAX.,"SALINA CRUZ, OAX.",1,0,1,0,0,0,
21/03/2015,TAMPS.,"NUEVO LAREDO, TAMPS.",0,0,0,3,0,44,
22/03/2015,PUE.,"TEHUACAN, PUE.",1,1,2,0,0,0,
22/03/2015,CHIS.,"REFORMA, CHIS.",0,0,0,1,0,105,
23/03/2015,D.F.,"LA MAGDALENA CONTRERAS, D.F.",24,27,51,0,0,100,
23/03/2015,TAMPS.,"NUEVO LAREDO, TAMPS.",15,15,30,3,0,44,
23/03/2015,OAX.,"MIAHUATLAN DE PORFIRIO DIAZ, OAX.",1,2,3,9,0,0,
23/03/2015,HGO.,"TEPEJI DEL RIO DE OCAMPO, HGO.",1,0,1,0,0,0,
23/03/2015,OAX.,"CIUDAD IXTEPEC, OAX.",0,1,1,0,0,0,
24/03/2015,D.F.,"LA MAGDALENA CONTRERAS, D.F.",19,15,34,0,0,0,
24/03/2015,DGO.,"GOMEZ PALACIO, DGO.",4,3,7,0,0,0,
24/03/2015,DGO.,"LERDO, DGO.",5,1,6,0,0,0,
24/03/2015,OAX.,"MIAHUATLAN DE PORFIRIO DIAZ, OAX.",1,2,3,0,1,0,
24/03/2015,OAX.,"OAX. DE JUAREZ, OAX.",0,3,3,0,0,0,
24/03/2015,YUC.,"CUZAMA, YUC.",2,1,3,0,0,47,
24/03/2015,B.C.,"ENSENADA, B.C.",0,1,1,0,0,0,
24/03/2015,OAX.,"CIUDAD IXTEPEC, OAX.",0,1,1,0,0,0,
24/03/2015,HGO.,"TULA DE ALLENDE, HGO.",1,0,1,0,0,0,
24/03/2015,HGO.,"TEPEJI DEL RIO DE OCAMPO, HGO.",1,0,1,0,0,0,
25/03/2015,D.F.,"LA MAGDALENA CONTRERAS, D.F.",36,14,50,0,1,70,
25/03/2015,DGO.,"GOMEZ PALACIO, DGO.",12,0,12,0,0,0,
25/03/2015,OAX.,"OAX. DE JUAREZ, OAX.",3,8,11,0,0,216,
25/03/2015,YUC.,"MERIDA, YUC.",8,3,11,0,0,403,
25/03/2015,B.C.,"MEXICALI, B.C.",3,3,6,0,0,0,
25/03/2015,HGO.,"TEPEJI DEL RIO DE OCAMPO, HGO.",2,2,4,0,0,0,
25/03/2015,OAX.,"MIAHUATLAN DE PORFIRIO DIAZ, OAX.",1,1,2,0,0,0,
25/03/2015,PUE.,"TEHUACAN, PUE.",1,0,1,0,0,0,
26/03/2015,D.F.,"LA MAGDALENA CONTRERAS, D.F.",16,7,23,2,0,65,
26/03/2015,YUC.,"MERIDA, YUC.",17,2,19,0,0,760,
26/03/2015,DGO.,"GOMEZ PALACIO, DGO.",3,2,5,0,0,0,
26/03/2015,GRO.,"BENITO JUAREZ, GRO.",2,1,3,0,0,0,
26/03/2015,OAX.,"MIAHUATLAN DE PORFIRIO DIAZ, OAX.",2,0,2,1,0,25,
26/03/2015,OAX.,"CIUDAD IXTEPEC, OAX.",0,1,1,0,0,112,
26/03/2015,B.C.,"MEXICALI, B.C.",1,0,1,0,0,0,
26/03/2015,OAX.,"OAX. DE JUAREZ, OAX.",0,0,0,0,0,12,
26/03/2015,DGO.,"LERDO, DGO.",0,0,0,0,1,0,
27/03/2015,D.F.,"LA MAGDALENA CONTRERAS, D.F.",22,11,33,0,1,600,
27/03/2015,YUC.,"MERIDA, YUC.",9,8,17,0,0,1254,
27/03/2015,DGO.,"GOMEZ PALACIO, DGO.",0,5,5,0,0,0,
27/03/2015,OAX.,"OAX. DE JUAREZ, OAX.",0,4,4,6,0,119,
27/03/2015,OAX.,"MIAHUATLAN DE PORFIRIO DIAZ, OAX.",2,1,3,5,0,0,
27/03/2015,HGO.,"TULA DE ALLENDE, HGO.",1,0,1,0,0,0,
28/03/2015,OAX.,"OAX. DE JUAREZ, OAX.",3,10,13,0,0,30,
28/03/2015,OAX.,"PINOTEPA DE DON LUIS, OAX.",6,0,6,4,0,0,
28/03/2015,DGO.,"LERDO, DGO.",5,0,5,0,5,0,
28/03/2015,DGO.,"GOMEZ PALACIO, DGO.",3,0,3,12,0,0,
28/03/2015,HGO.,"TULA DE ALLENDE, HGO.",2,0,2,0,0,0,
28/03/2015,HGO.,"TEPEJI DEL RIO DE OCAMPO, HGO.",0,1,1,0,0,0,
29/03/2015,DGO.,"GOMEZ PALACIO, DGO.",4,2,6,0,0,0,
29/03/2015,OAX.,"OAX. DE JUAREZ, OAX.",0,4,4,2,0,0,
29/03/2015,DGO.,"LERDO, DGO.",2,1,3,0,0,0,
01/08/2015,GRO.,"IGUALA DE LA INDEPENDENCIA, GRO.",2,0,2,0,0,0,
01/08/2015,CHIH.,"HGO. DEL PARRAL, CHIH.",0,1,1,0,0,0,
01/08/2015,CHIS.,"TAPACHULA, CHIS.",0,0,0,0,0,80,
01/08/2015,CHIS.,"TONALÁ, CHIS.",0,0,0,0,0,89,
02/08/2015,TAMPS.,"MATAMOROS, TAMPS.",2,2,4,0,0,0,
02/08/2015,GRO.,"ACAPULCO DE JUAREZ, GRO.",1,0,1,1,1,0,
02/08/2015,GRO.,"PETATLAN, GRO.",0,1,1,0,0,10,
02/08/2015,JAL.,"PUERTO VALLARTA, JAL.",1,0,1,0,0,0,
03/08/2015,D.F.,"MIGUEL HGO., D.F.",15,2,17,0,1,0,
03/08/2015,MEX.,"NAUCALPAN DE JUAREZ, MEX.",7,0,7,1,1,11,
03/08/2015,MEX.,"METEPEC, MEX.",3,2,5,2,0,0,
03/08/2015,GRO.,"ACAPULCO DE JUAREZ, GRO.",0,3,3,0,0,0,
03/08/2015,GRO.,"COYUCA DE BENITEZ, GRO.",2,1,3,0,0,63,
03/08/2015,OAX.,"OAX. DE JUAREZ, OAX.",0,2,2,0,0,0,
03/08/2015,MEX.,"TEXCOCO, MEX.",2,0,2,0,5,0,
03/08/2015,GRO.,"EDUARDO NERI, GRO.",1,0,1,0,0,0,
03/08/2015,COAH.,"MONCLOVA, COAH.",1,0,1,0,0,0,
03/08/2015,VER.,"MISANTLA, VER.",1,0,1,0,0,0,
03/08/2015,OAX.,"SAN JUAN BAUTISTA TUXTEPEC, OAX.",1,0,1,0,0,0,
03/08/2015,OAX.,"PINOTEPA DE DON LUIS, OAX.",1,0,1,0,0,0,
03/08/2015,MEX.,"HUEHUETOCA, MEX.",1,0,1,1,0,0,
03/08/2015,OAX.,"MIAHUATLAN DE PORFIRIO DIAZ, OAX.",0,0,0,0,0,1,
03/08/2015,Q. ROO,"OTHON P. BLANCO, Q. ROO",0,0,0,0,0,83,
04/08/2015,D.F.,"MIGUEL HGO., D.F.",9,4,13,0,1,0,
04/08/2015,CHIH.,"CUAUHTÉMOC, CHIH.",7,3,10,0,0,168,
04/08/2015,MEX.,"NAUCALPAN DE JUAREZ, MEX.",7,2,9,0,1,0,
04/08/2015,MEX.,"METEPEC, MEX.",4,2,6,9,0,82,
04/08/2015,MEX.,"TEXCOCO, MEX.",4,0,4,0,0,120,
04/08/2015,OAX.,"OAX. DE JUAREZ, OAX.",1,3,4,0,0,0,
04/08/2015,OAX.,"MIAHUATLAN DE PORFIRIO DIAZ, OAX.",3,0,3,1,0,29,
04/08/2015,COAH.,"MÚZQUIZ, COAH.",2,1,3,0,0,0,
04/08/2015,GRO.,"COYUCA DE BENITEZ, GRO.",0,2,2,0,1,0,
04/08/2015,Q. ROO,"OTHON P. BLANCO, Q. ROO",2,0,2,1,0,64,
04/08/2015,PUE.,"PUE., PUE.",1,0,1,0,0,56,
04/08/2015,HGO.,"APAN, HGO.",1,0,1,0,0,0,
04/08/2015,CHIS.,"BENEMÉRITO DE LAS AMÉRICAS, CHIS.",1,0,1,0,0,0,
04/08/2015,B.C.S.,"MULEGÉ, B.C.S.",0,1,1,0,0,0,
05/08/2015,D.F.,"MIGUEL HGO., D.F.",11,0,11,0,3,0,
05/08/2015,MEX.,"TEXCOCO, MEX.",7,2,9,0,9,0,
05/08/2015,MEX.,"METEPEC, MEX.",8,0,8,1,0,121,
05/08/2015,OAX.,"OAX. DE JUAREZ, OAX.",0,5,5,0,0,0,
05/08/2015,PUE.,"PUE., PUE.",4,1,5,0,0,94,
05/08/2015,MEX.,"NAUCALPAN DE JUAREZ, MEX.",3,1,4,2,0,8,
05/08/2015,COAH.,"MÚZQUIZ, COAH.",3,0,3,2,0,0,
05/08/2015,OAX.,"MIAHUATLAN DE PORFIRIO DIAZ, OAX.",2,0,2,2,0,0,
05/08/2015,VER.,"MISANTLA, VER.",1,1,2,0,0,0,
05/08/2015,Q. ROO,"OTHON P. BLANCO, Q. ROO",0,2,2,0,6,368,
05/08/2015,NAY.,"JALA, NAY.",1,1,2,0,0,0,
05/08/2015,OAX.,"SAN JUAN BAUTISTA ATATLAHUCA, OAX.",0,1,1,0,0,0,
05/08/2015,OAX.,"SAN JUAN BAUTISTA TUXTEPEC, OAX.",1,0,1,0,0,36,
05/08/2015,B.C.S.,"MULEGÉ, B.C.S.",0,1,1,0,0,0,
05/08/2015,MEX.,"HUEHUETOCA, MEX.",0,1,1,0,0,150,
05/08/2015,TAB.,"NACAJUCA, TAB.",0,0,0,0,0,46,
05/08/2015,GRO.,"EDUARDO NERI, GRO.",0,0,0,0,1,0,
05/08/2015,CHIH.,"JANOS, CHIH.",0,0,0,0,0,21,
06/08/2015,D.F.,"MIGUEL HGO., D.F.",19,5,24,0,0,36,
06/08/2015,MEX.,"NAUCALPAN DE JUAREZ, MEX.",7,3,10,1,1,50,
06/08/2015,MEX.,"TEXCOCO, MEX.",5,2,7,0,11,0,
06/08/2015,MEX.,"METEPEC, MEX.",2,2,4,0,1,0,
06/08/2015,MEX.,"HUEHUETOCA, MEX.",3,1,4,3,0,0,
06/08/2015,GRO.,"PETATLAN, GRO.",1,2,3,0,0,0,
06/08/2015,CHIS.,"TONALÁ, CHIS.",2,0,2,0,0,84,
06/08/2015,ZAC.,"JEREZ, ZAC.",1,1,2,0,0,0,
06/08/2015,PUE.,"PUE., PUE.",2,0,2,0,0,72,
06/08/2015,HGO.,"APAN, HGO.",0,1,1,0,0,70,
06/08/2015,OAX.,"MIAHUATLAN DE PORFIRIO DIAZ, OAX.",0,1,1,15,0,0,
06/08/2015,OAX.,"SAN JUAN BAUTISTA LO DE SOTO, OAX.",0,1,1,0,0,0,
06/08/2015,OAX.,"SAN PEDRO POCHUTLA, OAX.",1,0,1,0,0,0,
06/08/2015,CHIH.,"JANOS, CHIH.",1,0,1,0,0,0,
06/08/2015,GRO.,"COYUCA DE BENITEZ, GRO.",1,0,1,0,0,140,
06/08/2015,COAH.,"TORREÓN, COAH.",1,0,1,0,0,0,
06/08/2015,COAH.,"MONCLOVA, COAH.",1,0,1,0,0,20,
06/08/2015,VER.,"MISANTLA, VER.",0,1,1,0,0,0,
06/08/2015,CHIH.,"CUAUHTÉMOC, CHIH.",1,0,1,0,0,0,
06/08/2015,GRO.,"EDUARDO NERI, GRO.",0,0,0,0,3,3,
06/08/2015,Q. ROO,"OTHON P. BLANCO, Q. ROO",0,0,0,0,0,298,
07/08/2015,D.F.,"MIGUEL HGO., D.F.",21,1,22,0,15,0,
07/08/2015,COAH.,"ACUÑA, COAH.",1,9,10,0,0,0,
07/08/2015,MEX.,"TEXCOCO, MEX.",7,2,9,0,33,88,
07/08/2015,MEX.,"NAUCALPAN DE JUAREZ, MEX.",6,2,8,1,15,0,
07/08/2015,COAH.,"MONCLOVA, COAH.",3,1,4,1,0,280,
07/08/2015,MEX.,"METEPEC, MEX.",3,0,3,3,0,21,
07/08/2015,TAMPS.,"REYNOSA, TAMPS.",1,1,2,0,0,0,
07/08/2015,CHIH.,"CUAUHTÉMOC, CHIH.",2,0,2,0,0,0,
07/08/2015,GRO.,"ACAPULCO DE JUAREZ, GRO.",0,1,1,0,0,0,
07/08/2015,GRO.,"COYUCA DE BENITEZ, GRO.",1,0,1,0,0,0,
07/08/2015,ZAC.,"JEREZ, ZAC.",1,0,1,0,0,0,
07/08/2015,OAX.,"OAX. DE JUAREZ, OAX.",1,0,1,1,0,0,
07/08/2015,TAMPS.,"VICTORIA, TAMPS.",1,0,1,0,0,105,
07/08/2015,GRO.,"EDUARDO NERI, GRO.",1,0,1,0,3,10,
07/08/2015,MEX.,"HUEHUETOCA, MEX.",1,0,1,0,0,0,
07/08/2015,CHIS.,"TONALÁ, CHIS.",0,0,0,0,0,99,
07/08/2015,Q. ROO,"OTHON P. BLANCO, Q. ROO",0,0,0,0,0,251,
07/08/2015,TAMPS.,"MIER, TAMPS.",0,0,0,8,0,228,
08/08/2015,MEX.,"TEXCOCO, MEX.",8,4,12,0,1,0,
08/08/2015,MEX.,"NAUCALPAN DE JUAREZ, MEX.",9,1,10,61,4,708,
08/08/2015,TAMPS.,"MATAMOROS, TAMPS.",4,3,7,0,0,10,
08/08/2015,DGO.,"DGO., DGO.",6,0,6,0,0,0,
08/08/2015,COAH.,"MONCLOVA, COAH.",3,3,6,0,0,225,
08/08/2015,PUE.,"PUE., PUE.",5,0,5,1,0,216,
08/08/2015,OAX.,"OAX. DE JUAREZ, OAX.",1,3,4,2,0,0,
08/08/2015,MEX.,"METEPEC, MEX.",4,0,4,2,0,5,
08/08/2015,MEX.,"HUEHUETOCA, MEX.",2,1,3,0,0,15,
08/08/2015,DGO.,"TLAHUALILO, DGO.",2,1,3,0,0,0,
08/08/2015,S.L.P.,"CIUDAD VALLES, S.L.P.",2,0,2,0,0,0,
08/08/2015,ZAC.,"JEREZ, ZAC.",0,1,1,0,0,0,
08/08/2015,JAL.,"TOMATLAN, JAL.",1,0,1,0,0,0,
08/08/2015,DGO.,"GOMEZ PALACIO, DGO.",1,0,1,0,3,0,
08/08/2015,DGO.,"LERDO, DGO.",1,0,1,0,0,0,
08/08/2015,Q. ROO,"OTHON P. BLANCO, Q. ROO",0,0,0,0,0,42,
08/08/2015,COAH.,"TORREÓN, COAH.",0,0,0,0,0,47,
08/08/2015,GRO.,"PETATLAN, GRO.",0,0,0,0,0,120,
09/08/2015,DGO.,"DGO., DGO.",5,3,8,16,0,0,
09/08/2015,DGO.,"TLAHUALILO, DGO.",4,4,8,0,0,0,
09/08/2015,TAMPS.,"VICTORIA, TAMPS.",7,1,8,5,0,356,
09/08/2015,TAMPS.,"REYNOSA, TAMPS.",2,0,2,3,0,200,
09/08/2015,DGO.,"LERDO, DGO.",0,1,1,0,1,2,
09/08/2015,DGO.,"MAPIMI, DGO.",0,1,1,0,0,0,
09/08/2015,JAL.,"TOMATLAN, JAL.",1,0,1,0,0,0,
09/08/2015,TAB.,"BALANCAN, TAB.",0,1,1,0,0,0,
09/08/2015,TAMPS.,"GRO., TAMPS.",1,0,1,0,0,0,
10/08/2015,SIN.,"AHOME, SIN.",11,6,17,0,0,0,
10/08/2015,D.F.,"MIGUEL HGO., D.F.",12,4,16,0,2,0,
10/08/2015,DGO.,"DGO., DGO.",12,1,13,2,1,0,
10/08/2015,MEX.,"TLALNEPANTLA DE BAZ, MEX.",4,2,6,1,5,219,
10/08/2015,SIN.,"SALVADOR ALVARADO, SIN.",2,3,5,0,0,0,
10/08/2015,TLAX.,"APIZACO, TLAX.",4,1,5,0,0,0,
10/08/2015,GRO.,"ACAPULCO DE JUAREZ, GRO.",4,0,4,0,0,0,
10/08/2015,COAH.,"SALTILLO, COAH.",3,1,4,0,0,27,
10/08/2015,COAH.,"SABINAS, COAH.",2,2,4,0,0,100,
10/08/2015,TAMPS.,"GUSTAVO DIAZ ORDAZ, TAMPS.",0,4,4,0,0,0,
10/08/2015,MEX.,"TOLUCA, MEX.",3,0,3,1,0,56,
10/08/2015,CHIH.,"HGO. DEL PARRAL, CHIH.",2,1,3,0,0,92,
10/08/2015,TAMPS.,"VICTORIA, TAMPS.",3,0,3,0,0,300,
10/08/2015,SIN.,"CULIACAN, SIN.",2,0,2,1,6,0,
10/08/2015,TLAX.,"TLAX., TLAX.",1,1,2,0,0,0,
10/08/2015,COAH.,"TORREÓN, COAH.",1,1,2,0,0,69,
10/08/2015,CHIH.,"JANOS, CHIH.",1,1,2,0,0,0,
10/08/2015,B.C.S.,"MULEGÉ, B.C.S.",0,1,1,0,0,0,
10/08/2015,SIN.,"MAZATLAN, SIN.",1,0,1,0,0,0,
10/08/2015,VER.,"OZULUAMA DE MASCARE±AS, VER.",0,1,1,0,0,0,
10/08/2015,VER.,"MISANTLA, VER.",0,1,1,0,0,0,
10/08/2015,CHIS.,"BENEMÉRITO DE LAS AMÉRICAS, CHIS.",0,1,1,0,0,0,
10/08/2015,OAX.,"MIAHUATLAN DE PORFIRIO DIAZ, OAX.",1,0,1,0,0,0,
10/08/2015,OAX.,"OAX. DE JUAREZ, OAX.",1,0,1,1,0,2,
10/08/2015,GRO.,"LEONARDO BRAVO, GRO.",1,0,1,0,0,0,
10/08/2015,HGO.,"APAN, HGO.",0,0,0,0,0,103,
10/08/2015,Q. ROO,"OTHON P. BLANCO, Q. ROO",0,0,0,0,4,492,
10/08/2015,COAH.,"MONCLOVA, COAH.",0,0,0,1,0,42,
10/08/2015,COAH.,"MÚZQUIZ, COAH.",0,0,0,0,0,180,
10/08/2015,CHIH.,"CHIH., CHIH.",0,0,0,0,1,51,
11/08/2015,SIN.,"AHOME, SIN.",10,15,25,0,0,0,
11/08/2015,MEX.,"AMECAMECA, MEX.",11,12,23,0,8,22,
11/08/2015,MEX.,"TLALNEPANTLA DE BAZ, MEX.",11,6,17,0,2,33,
11/08/2015,D.F.,"MIGUEL HGO., D.F.",12,2,14,0,0,0,
11/08/2015,DGO.,"DGO., DGO.",9,4,13,13,3,0,
11/08/2015,COAH.,"ACUÑA, COAH.",11,2,13,0,0,0,
11/08/2015,SIN.,"CULIACAN, SIN.",8,3,11,0,0,0,
11/08/2015,SIN.,"MAZATLAN, SIN.",8,2,10,0,0,0,
11/08/2015,SIN.,"SALVADOR ALVARADO, SIN.",3,5,8,0,0,0,
11/08/2015,COAH.,"SALTILLO, COAH.",8,0,8,10,2,385,
11/08/2015,DGO.,"GOMEZ PALACIO, DGO.",5,2,7,0,3,0,
11/08/2015,MEX.,"ZUMPANGO, MEX.",4,3,7,0,0,7,
11/08/2015,MEX.,"TOLUCA, MEX.",5,1,6,4,0,0,
11/08/2015,OAX.,"OAX. DE JUAREZ, OAX.",0,4,4,0,0,0,
11/08/2015,COAH.,"TORREÓN, COAH.",3,1,4,6,0,34,
11/08/2015,COAH.,"TORREÓN, COAH.",3,1,4,6,0,34,
11/08/2015,COAH.,"MONCLOVA, COAH.",3,1,4,0,1,10,
11/08/2015,HGO.,"APAN, HGO.",3,0,3,0,0,167,
11/08/2015,PUE.,"PUE., PUE.",3,0,3,0,0,54,
11/08/2015,TLAX.,"TLAX., TLAX.",2,1,3,1,0,0,
11/08/2015,TLAX.,"APIZACO, TLAX.",3,0,3,1,0,3,
11/08/2015,GRO.,"LEONARDO BRAVO, GRO.",0,3,3,0,0,0,
11/08/2015,TAMPS.,"NUEVO LAREDO, TAMPS.",2,1,3,0,0,144,
11/08/2015,GRO.,"COCHOAPA EL GRANDE, GRO.",2,1,3,0,0,0,
11/08/2015,CHIH.,"HGO. DEL PARRAL, CHIH.",1,1,2,0,0,0,
11/08/2015,DGO.,"TLAHUALILO, DGO.",1,1,2,0,0,0,
11/08/2015,CHIH.,"CHIH., CHIH.",1,1,2,0,0,279,
11/08/2015,CHIS.,"BENEMÉRITO DE LAS AMÉRICAS, CHIS.",1,0,1,0,0,0,
11/08/2015,OAX.,"SAN JUAN BAUTISTA TUXTEPEC, OAX.",1,0,1,1,0,0,
11/08/2015,CHIS.,"TONALÁ, CHIS.",1,0,1,0,0,0,
11/08/2015,OAX.,"SANTA MARIA ZACATEPEC, OAX.",0,1,1,0,0,0,
11/08/2015,QRO.,"AMEALCO DE BONFIL, QRO.",0,1,1,0,0,0,
11/08/2015,TAB.,"CENTRO, TAB.",1,0,1,0,0,58,
11/08/2015,COAH.,"MÚZQUIZ, COAH.",0,1,1,0,0,0,
11/08/2015,TAMPS.,"VICTORIA, TAMPS.",0,1,1,3,0,11,
11/08/2015,GRO.,"COAHUAYUTLA DE JOSE MARIA IZAZAGA, GRO.",0,1,1,0,0,0,
11/08/2015,OAX.,"MIAHUATLAN DE PORFIRIO DIAZ, OAX.",0,0,0,0,0,33,
11/08/2015,DGO.,"LERDO, DGO.",0,0,0,0,4,0,
11/08/2015,AGS.,"CALVILLO, AGS.",0,0,0,49,0,228,
11/08/2015,QRO.,"AMEALCO DE BONFIL, QRO.",0,0,0,0,0,0,
11/08/2015,GRO.,"ACAPULCO DE JUAREZ, GRO.",0,0,0,0,0,0,
11/08/2015,GRO.,"PETATLAN, GRO.",0,0,0,2,0,15,
12/08/2015,SIN.,"AHOME, SIN.",28,18,46,0,2,0,
12/08/2015,D.F.,"MIGUEL HGO., D.F.",15,2,17,0,0,0,
12/08/2015,SIN.,"CULIACAN, SIN.",13,3,16,0,1,0,
12/08/2015,MEX.,"TLALNEPANTLA DE BAZ, MEX.",12,3,15,0,1,240,
12/08/2015,CHIH.,"CHIH., CHIH.",13,1,14,7,1,216,
12/08/2015,MEX.,"TOLUCA, MEX.",9,5,14,4,0,0,
12/08/2015,DGO.,"DGO., DGO.",10,3,13,8,2,0,
12/08/2015,SIN.,"MAZATLAN, SIN.",3,9,12,0,0,0,
12/08/2015,COAH.,"PIEDRAS NEGRAS, COAH.",6,4,10,0,0,393,
12/08/2015,COAH.,"SABINAS, COAH.",10,0,10,0,0,0,
12/08/2015,MEX.,"ZUMPANGO, MEX.",8,1,9,0,6,5,
12/08/2015,OAX.,"OAX. DE JUAREZ, OAX.",0,7,7,0,0,400,
12/08/2015,COAH.,"SALTILLO, COAH.",6,1,7,0,0,117,
12/08/2015,DGO.,"GOMEZ PALACIO, DGO.",4,3,7,0,0,0,
12/08/2015,SIN.,"SALVADOR ALVARADO, SIN.",4,3,7,0,1,0,
12/08/2015,MEX.,"AMECAMECA, MEX.",5,2,7,0,0,0,
12/08/2015,OAX.,"CIUDAD IXTEPEC, OAX.",6,0,6,1,0,0,
12/08/2015,COAH.,"TORREÓN, COAH.",3,3,6,0,0,0,
12/08/2015,TLAX.,"APIZACO, TLAX.",4,2,6,1,0,16,
12/08/2015,OAX.,"MIAHUATLAN DE PORFIRIO DIAZ, OAX.",4,0,4,0,0,0,
12/08/2015,GRO.,"ACAPULCO DE JUAREZ, GRO.",1,3,4,0,0,0,
12/08/2015,TAMPS.,"MIER, TAMPS.",3,1,4,2,0,32,
12/08/2015,GRO.,"COCHOAPA EL GRANDE, GRO.",2,1,3,0,0,0,
12/08/2015,TLAX.,"TLAX., TLAX.",1,2,3,0,0,0,
12/08/2015,OAX.,"SANTA MARIA ZACATEPEC, OAX.",1,1,2,0,0,0,
12/08/2015,VER.,"MISANTLA, VER.",0,2,2,0,0,0,
12/08/2015,B.C.S.,"LA PAZ, B.C.S.",2,0,2,0,0,0,
12/08/2015,PUE.,"PUE., PUE.",2,0,2,0,0,0,
12/08/2015,CHIS.,"BENEMÉRITO DE LAS AMÉRICAS, CHIS.",1,0,1,0,0,0,
12/08/2015,COAH.,"MONCLOVA, COAH.",1,0,1,0,0,0,
12/08/2015,COAH.,"MÚZQUIZ, COAH.",0,1,1,0,0,0,
12/08/2015,DGO.,"TLAHUALILO, DGO.",1,0,1,0,0,0,
12/08/2015,GRO.,"PETATLAN, GRO.",0,1,1,0,0,0,
12/08/2015,GRO.,"COAHUAYUTLA DE JOSE MARIA IZAZAGA, GRO.",0,1,1,1,0,1,
12/08/2015,TAMPS.,"NUEVO LAREDO, TAMPS.",1,0,1,5,0,329,
12/08/2015,TAMPS.,"EL MANTE, TAMPS.",1,0,1,0,0,0,
12/08/2015,HGO.,"APAN, HGO.",0,0,0,0,0,132,
12/08/2015,CHIS.,"TAPACHULA, CHIS.",0,0,0,0,1,0,
13/08/2015,SIN.,"AHOME, SIN.",27,6,33,0,0,0,
13/08/2015,TAMPS.,"NUEVO LAREDO, TAMPS.",8,8,16,18,1,1649,
13/08/2015,MEX.,"TLALNEPANTLA DE BAZ, MEX.",7,7,14,0,0,40,
13/08/2015,SIN.,"CULIACAN, SIN.",7,6,13,0,0,0,
13/08/2015,SIN.,"MAZATLAN, SIN.",10,2,12,0,5,0,
13/08/2015,DGO.,"DGO., DGO.",8,2,10,8,0,0,
13/08/2015,COAH.,"TORREÓN, COAH.",6,2,8,0,0,0,
13/08/2015,COAH.,"TORREÓN, COAH.",6,2,8,0,0,0,
13/08/2015,MEX.,"AMECAMECA, MEX.",5,3,8,0,0,0,
13/08/2015,MEX.,"TOLUCA, MEX.",5,2,7,2,0,0,
13/08/2015,CHIH.,"OJINAGA, CHIH.",1,6,7,0,0,237,
13/08/2015,CHIH.,"CHIH., CHIH.",6,0,6,0,0,466,
13/08/2015,CHIH.,"CHIH., CHIH.",4,2,6,0,0,225,
13/08/2015,COAH.,"PIEDRAS NEGRAS, COAH.",4,1,5,21,0,263,
13/08/2015,COAH.,"SABINAS, COAH.",2,3,5,0,0,0,
13/08/2015,MEX.,"ZUMPANGO, MEX.",5,0,5,1,0,0,
13/08/2015,SIN.,"SALVADOR ALVARADO, SIN.",4,1,5,0,1,0,
13/08/2015,DGO.,"GOMEZ PALACIO, DGO.",3,1,4,1,0,0,
13/08/2015,COAH.,"MONCLOVA, COAH.",3,1,4,0,0,0,
13/08/2015,GRO.,"ACAPULCO DE JUAREZ, GRO.",4,0,4,0,0,22,
13/08/2015,COAH.,"SALTILLO, COAH.",2,1,3,0,0,228,
13/08/2015,OAX.,"MIAHUATLAN DE PORFIRIO DIAZ, OAX.",0,3,3,3,0,0,
13/08/2015,TAMPS.,"MIER, TAMPS.",0,3,3,4,0,36,
13/08/2015,TAMPS.,"GUSTAVO DIAZ ORDAZ, TAMPS.",3,0,3,0,0,0,
13/08/2015,VER.,"PAPANTLA, VER.",2,0,2,0,1,133,
13/08/2015,GRO.,"LEONARDO BRAVO, GRO.",2,0,2,0,0,0,
13/08/2015,SON.,"CAJEME, SON.",2,0,2,2,0,253,
13/08/2015,OAX.,"SANTA MARIA ZACATEPEC, OAX.",0,2,2,0,0,0,
13/08/2015,GRO.,"COAHUAYUTLA DE JOSE MARIA IZAZAGA, GRO.",0,2,2,0,0,0,
13/08/2015,HGO.,"APAN, HGO.",1,0,1,0,4,0,
13/08/2015,HGO.,"HUEHUETLA, HGO.",1,0,1,0,0,0,
13/08/2015,PUE.,"PUE., PUE.",1,0,1,0,0,26,
13/08/2015,CHIH.,"HGO. DEL PARRAL, CHIH.",1,0,1,0,0,13,
13/08/2015,B.C.S.,"LA PAZ, B.C.S.",1,0,1,0,0,0,
13/08/2015,DGO.,"TLAHUALILO, DGO.",0,1,1,1,0,0,
13/08/2015,CHIH.,"JULIMES, CHIH.",1,0,1,0,0,0,
13/08/2015,CHIH.,"JANOS, CHIH.",1,0,1,0,0,0,
13/08/2015,TLAX.,"TLAX., TLAX.",1,0,1,0,0,0,
13/08/2015,SON.,"CAJEME, SON.",1,0,1,0,0,0,
13/08/2015,TAMPS.,"EL MANTE, TAMPS.",0,0,0,0,0,40,
14/08/2015,SIN.,"AHOME, SIN.",27,14,41,0,12,0,
14/08/2015,SIN.,"MAZATLAN, SIN.",12,2,14,0,0,0,
14/08/2015,SIN.,"CULIACAN, SIN.",11,3,14,0,2,0,
14/08/2015,MEX.,"TLALNEPANTLA DE BAZ, MEX.",9,3,12,0,3,0,
14/08/2015,COAH.,"SALTILLO, COAH.",10,2,12,2,2,53,
14/08/2015,MEX.,"TOLUCA, MEX.",6,2,8,1,1,0,
14/08/2015,MEX.,"ZUMPANGO, MEX.",7,0,7,0,0,100,
14/08/2015,COAH.,"MONCLOVA, COAH.",6,1,7,0,0,37,
14/08/2015,SIN.,"SALVADOR ALVARADO, SIN.",5,1,6,0,0,0,
14/08/2015,DGO.,"DGO., DGO.",5,0,5,4,0,0,
14/08/2015,MEX.,"AMECAMECA, MEX.",5,0,5,0,0,0,
14/08/2015,COAH.,"TORREÓN, COAH.",2,3,5,0,0,0,
14/08/2015,GRO.,"COCHOAPA EL GRANDE, GRO.",3,1,4,0,0,0,
14/08/2015,OAX.,"MIAHUATLAN DE PORFIRIO DIAZ, OAX.",2,1,3,7,0,5,
14/08/2015,B.C.S.,"LA PAZ, B.C.S.",3,0,3,0,0,0,
14/08/2015,TLAX.,"APIZACO, TLAX.",2,1,3,0,0,0,
14/08/2015,TAB.,"CENTRO, TAB.",2,0,2,0,1,217,
14/08/2015,COAH.,"ACUÑA, COAH.",1,1,2,0,0,0,
14/08/2015,TAMPS.,"VICTORIA, TAMPS.",1,1,2,11,0,20,
14/08/2015,VER.,"PAPANTLA, VER.",0,1,1,0,0,93,
14/08/2015,ZAC.,"JEREZ, ZAC.",0,1,1,0,0,0,
14/08/2015,HGO.,"APAN, HGO.",1,0,1,0,0,517,
14/08/2015,GRO.,"COAHUAYUTLA DE JOSE MARIA IZAZAGA, GRO.",0,1,1,0,0,0,
14/08/2015,VER.,"NARANJOS AMATLAN, VER.",1,0,1,0,0,0,
14/08/2015,COAH.,"SABINAS, COAH.",0,1,1,0,0,0,
14/08/2015,TAMPS.,"EL MANTE, TAMPS.",1,0,1,0,0,0,
14/08/2015,PUE.,"PUE., PUE.",1,0,1,1,0,46,
14/08/2015,CHIS.,"TONALÁ, CHIS.",0,0,0,0,0,59,
14/08/2015,TAMPS.,"NUEVO LAREDO, TAMPS.",0,0,0,0,0,0,
15/08/2015,MEX.,"TOLUCA, MEX.",27,9,36,3,0,0,
15/08/2015,MEX.,"TLALNEPANTLA DE BAZ, MEX.",9,10,19,0,0,200,
15/08/2015,MEX.,"ZUMPANGO, MEX.",9,5,14,0,0,50,
15/08/2015,COAH.,"SALTILLO, COAH.",5,8,13,0,0,117,
15/08/2015,TAMPS.,"MATAMOROS, TAMPS.",5,4,9,0,0,0,
15/08/2015,DGO.,"TLAHUALILO, DGO.",1,2,3,0,0,0,
15/08/2015,MEX.,"AMECAMECA, MEX.",1,2,3,0,1,0,
15/08/2015,DGO.,"DGO., DGO.",2,0,2,0,4,0,
15/08/2015,DGO.,"GOMEZ PALACIO, DGO.",2,0,2,0,0,0,
15/08/2015,HGO.,"EMILIANO ZAPATA, HGO.",2,0,2,0,0,0,
15/08/2015,YUC.,"IZAMAL, YUC.",0,1,1,0,0,0,
15/08/2015,CHIH.,"HGO. DEL PARRAL, CHIH.",1,0,1,0,0,0,
15/08/2015,PUE.,"PUE., PUE.",1,0,1,1,0,0,
15/08/2015,DGO.,"LERDO, DGO.",1,0,1,0,0,0,
15/08/2015,ZAC.,"GUADALUPE, ZAC.",0,1,1,0,0,0,
15/08/2015,TAMPS.,"NUEVO LAREDO, TAMPS.",0,1,1,7,0,637,
15/08/2015,TAMPS.,"EL MANTE, TAMPS.",1,0,1,0,0,0,
15/08/2015,SON.,"CAJEME, SON.",0,0,0,0,0,250,
15/08/2015,TAMPS.,"VICTORIA, TAMPS.",0,0,0,1,0,20,
16/08/2015,DGO.,"DGO., DGO.",3,1,4,5,1,0,
16/08/2015,DGO.,"LERDO, DGO.",0,3,3,0,0,0,
16/08/2015,B.C.,"ENSENADA, B.C.",3,0,3,0,0,0,
16/08/2015,VER.,"NARANJOS AMATLAN, VER.",2,0,2,2,0,0,
16/08/2015,JAL.,"TOMATLAN, JAL.",0,1,1,0,0,0,
16/08/2015,CHIH.,"HGO. DEL PARRAL, CHIH.",1,0,1,0,0,0,
16/08/2015,DGO.,"GOMEZ PALACIO, DGO.",1,0,1,0,0,17,
16/08/2015,DGO.,"TLAHUALILO, DGO.",0,1,1,0,0,0,
16/08/2015,TLAX.,"APIZACO, TLAX.",0,1,1,0,1,0,
16/08/2015,TLAX.,"CALPULALPAN, TLAX.",0,1,1,0,0,0,
16/08/2015,TAB.,"CENTRO, TAB.",1,0,1,0,0,0,
17/08/2015,SIN.,"AHOME, SIN.",15,20,35,0,10,0,
17/08/2015,SIN.,"CULIACAN, SIN.",21,1,22,0,0,0,
17/08/2015,D.F.,"TLAHUAC, D.F.",20,1,21,0,0,0,
17/08/2015,SIN.,"MAZATLAN, SIN.",3,17,20,0,0,0,
17/08/2015,CHIH.,"CHIH., CHIH.",9,5,14,8,0,455,
17/08/2015,DGO.,"DGO., DGO.",8,2,10,9,7,0,
17/08/2015,COAH.,"SALTILLO, COAH.",5,5,10,3,0,182,
17/08/2015,COAH.,"SABINAS, COAH.",6,3,9,0,0,0,
17/08/2015,COAH.,"MONCLOVA, COAH.",5,3,8,0,0,100,
17/08/2015,MEX.,"LERMA, MEX.",3,1,4,2,1,0,
17/08/2015,CHIH.,"ALDAMA, CHIH.",0,4,4,0,0,0,
17/08/2015,SIN.,"SALVADOR ALVARADO, SIN.",2,2,4,0,0,0,
17/08/2015,DGO.,"GOMEZ PALACIO, DGO.",4,0,4,0,0,0,
17/08/2015,TLAX.,"CALPULALPAN, TLAX.",2,1,3,0,0,0,
17/08/2015,CHIH.,"HGO. DEL PARRAL, CHIH.",1,2,3,0,0,30,
17/08/2015,MEX.,"CUAUTITLAN, MEX.",1,2,3,0,3,0,
17/08/2015,DGO.,"TLAHUALILO, DGO.",2,1,3,1,0,0,
17/08/2015,TLAX.,"TLAX., TLAX.",2,0,2,0,0,0,
17/08/2015,COAH.,"TORREÓN, COAH.",1,1,2,0,0,13,
17/08/2015,MEX.,"CUAUTITLAN IZCALLI, MEX.",2,0,2,0,0,0,
17/08/2015,ZAC.,"JEREZ, ZAC.",2,0,2,0,0,550,
17/08/2015,DGO.,"LERDO, DGO.",2,0,2,0,0,0,
17/08/2015,VER.,"XALAPA, VER.",0,1,1,0,0,0,
17/08/2015,VER.,"JUCHIQUE DE FERRER, VER.",1,0,1,0,0,0,
17/08/2015,OAX.,"SAN JUAN BAUTISTA TUXTEPEC, OAX.",1,0,1,0,0,0,
17/08/2015,COAH.,"MÚZQUIZ, COAH.",0,1,1,0,0,200,
17/08/2015,DGO.,"GOMEZ PALACIO, DGO.",1,0,1,0,0,0,
17/08/2015,DGO.,"TLAHUALILO, DGO.",1,0,1,0,0,0,
17/08/2015,TAB.,"CENTRO, TAB.",0,0,0,1,0,173,
17/08/2015,AGS.,"CALVILLO, AGS.",0,0,0,2,0,223,
17/08/2015,TAMPS.,"EL MANTE, TAMPS.",0,0,0,1,0,57,
17/08/2015,OAX.,"MIAHUATLAN DE PORFIRIO DIAZ, OAX.",0,0,0,1,0,30,
17/08/2015,DGO.,"LERDO, DGO.",0,0,0,0,0,0,
18/08/2015,D.F.,"TLAHUAC, D.F.",24,1,25,0,3,0,
18/08/2015,COAH.,"PIEDRAS NEGRAS, COAH.",4,12,16,0,0,216,
18/08/2015,SIN.,"MAZATLAN, SIN.",11,4,15,0,0,0,
18/08/2015,COAH.,"SALTILLO, COAH.",9,3,12,0,1,0,
18/08/2015,MEX.,"LERMA, MEX.",10,2,12,2,0,0,
18/08/2015,SIN.,"AHOME, SIN.",6,3,9,0,1,0,
18/08/2015,COAH.,"TORREÓN, COAH.",7,1,8,0,0,1400,
18/08/2015,DGO.,"DGO., DGO.",5,2,7,3,4,0,
18/08/2015,COAH.,"MONCLOVA, COAH.",5,2,7,0,0,164,
18/08/2015,MEX.,"CUAUTITLAN, MEX.",7,0,7,0,1,0,
18/08/2015,TAB.,"CENTRO, TAB.",2,3,5,0,0,29,
18/08/2015,SIN.,"SALVADOR ALVARADO, SIN.",5,0,5,0,0,0,
18/08/2015,MEX.,"CUAUTITLAN IZCALLI, MEX.",5,0,5,0,1,0,
18/08/2015,SIN.,"CULIACAN, SIN.",0,4,4,0,0,0,
18/08/2015,Q. ROO,"COZUMEL, Q. ROO",1,2,3,0,0,45,
18/08/2015,CHIH.,"HGO. DEL PARRAL, CHIH.",3,0,3,0,0,0,
18/08/2015,CHIH.,"CHIH., CHIH.",2,1,3,2,1,287,
18/08/2015,TLAX.,"CALPULALPAN, TLAX.",1,2,3,0,0,0,
18/08/2015,HGO.,"EMILIANO ZAPATA, HGO.",2,0,2,0,0,0,
18/08/2015,OAX.,"MIAHUATLAN DE PORFIRIO DIAZ, OAX.",2,0,2,1,0,10,
18/08/2015,COAH.,"RAMOS ARIZPE, COAH.",2,0,2,0,0,0,
18/08/2015,CHIH.,"NUEVO CASAS GRANDES, CHIH.",2,0,2,0,0,47,
18/08/2015,GRO.,"SAN MARCOS, GRO.",1,1,2,0,0,0,
18/08/2015,SON.,"HERMOSILLO, SON.",2,0,2,14,0,170,
18/08/2015,OAX.,"SANTA MARIA ZACATEPEC, OAX.",1,0,1,0,0,0,
18/08/2015,VER.,"PAPANTLA, VER.",0,1,1,0,0,0,
18/08/2015,VER.,"VILLA ALDAMA, VER.",0,1,1,0,0,0,
18/08/2015,CHIS.,"BENEMÉRITO DE LAS AMÉRICAS, CHIS.",1,0,1,0,0,0,
18/08/2015,COAH.,"MÚZQUIZ, COAH.",1,0,1,0,0,0,
18/08/2015,COAH.,"SABINAS, COAH.",0,1,1,0,0,0,
18/08/2015,COAH.,"ACUÑA, COAH.",0,1,1,3,0,0,
18/08/2015,TAMPS.,"TAMPICO, TAMPS.",1,0,1,0,0,0,
18/08/2015,ZAC.,"GUADALUPE, ZAC.",0,1,1,0,0,107,
18/08/2015,MEX.,"IXTAPAN DE LA SAL, MEX.",1,0,1,1,0,0,
18/08/2015,S.L.P.,"CIUDAD VALLES, S.L.P.",0,0,0,0,0,53,
18/08/2015,TAB.,"TENOSIQUE, TAB.",0,0,0,0,1,0,
18/08/2015,AGS.,"CALVILLO, AGS.",0,0,0,0,0,447,
18/08/2015,SON.,"CAJEME, SON.",0,0,0,0,1,9050,
19/08/2015,D.F.,"TLAHUAC, D.F.",34,2,36,0,1,0,
19/08/2015,SIN.,"AHOME, SIN.",26,5,31,0,2,0,
19/08/2015,OAX.,"OAX. DE JUAREZ, OAX.",2,17,19,1,0,128,
19/08/2015,COAH.,"PIEDRAS NEGRAS, COAH.",6,4,10,3,0,0,
19/08/2015,COAH.,"SALTILLO, COAH.",1,7,8,3,0,217,
19/08/2015,SIN.,"MAZATLAN, SIN.",7,1,8,0,12,0,
19/08/2015,SIN.,"CULIACAN, SIN.",5,3,8,0,2,0,
19/08/2015,DGO.,"GOMEZ PALACIO, DGO.",4,4,8,0,0,0,
19/08/2015,COAH.,"TORREÓN, COAH.",4,3,7,2,0,0,
19/08/2015,COAH.,"MONCLOVA, COAH.",5,2,7,0,0,164,
19/08/2015,MEX.,"CUAUTITLAN IZCALLI, MEX.",6,1,7,0,1,0,
19/08/2015,DGO.,"DGO., DGO.",3,3,6,1,0,0,
19/08/2015,MEX.,"LERMA, MEX.",6,0,6,3,0,0,
19/08/2015,SIN.,"SALVADOR ALVARADO, SIN.",4,1,5,0,0,0,
19/08/2015,CHIH.,"HGO. DEL PARRAL, CHIH.",5,0,5,30,0,0,
19/08/2015,COAH.,"SABINAS, COAH.",1,3,4,0,0,0,
19/08/2015,MEX.,"CUAUTITLAN, MEX.",4,0,4,0,0,0,
19/08/2015,TAMPS.,"MIER, TAMPS.",1,3,4,14,0,342,
19/08/2015,SON.,"HERMOSILLO, SON.",3,0,3,6,0,0,
19/08/2015,QRO.,"CORREGIDORA, QRO.",2,1,3,0,4,0,
19/08/2015,VER.,"NARANJOS AMATLAN, VER.",2,1,3,1,0,0,
19/08/2015,TLAX.,"CALPULALPAN, TLAX.",0,2,2,0,0,0,
19/08/2015,OAX.,"SAN JUAN BAUTISTA TUXTEPEC, OAX.",2,0,2,0,0,39,
19/08/2015,OAX.,"MIAHUATLAN DE PORFIRIO DIAZ, OAX.",2,0,2,2,0,5,
19/08/2015,SON.,"CAJEME, SON.",1,0,1,0,0,300,
19/08/2015,COAH.,"RAMOS ARIZPE, COAH.",0,1,1,0,0,0,
19/08/2015,HGO.,"EMILIANO ZAPATA, HGO.",1,0,1,0,0,0,
19/08/2015,MEX.,"IXTAPAN DE LA SAL, MEX.",1,0,1,0,0,0,
19/08/2015,TLAX.,"TLAX., TLAX.",1,0,1,2,0,0,
19/08/2015,PUE.,"PUE., PUE.",1,0,1,1,0,0,
19/08/2015,OAX.,"PINOTEPA DE DON LUIS, OAX.",1,0,1,3,0,0,
19/08/2015,DGO.,"LERDO, DGO.",0,1,1,1,0,0,
19/08/2015,TAMPS.,"EL MANTE, TAMPS.",1,0,1,1,0,50,
20/08/2015,SIN.,"AHOME, SIN.",27,20,47,0,0,0,
20/08/2015,D.F.,"TLAHUAC, D.F.",28,7,35,0,1,0,
20/08/2015,COAH.,"SALTILLO, COAH.",11,3,14,0,0,830,
20/08/2015,DGO.,"DGO., DGO.",14,0,14,1,0,0,
20/08/2015,COAH.,"SALTILLO, COAH.",10,3,13,2,0,188,
20/08/2015,COAH.,"MONCLOVA, COAH.",10,3,13,0,0,191,
20/08/2015,SIN.,"MAZATLAN, SIN.",9,2,11,0,4,0,
20/08/2015,COAH.,"TORREÓN, COAH.",8,1,9,0,0,191,
20/08/2015,COAH.,"TORREÓN, COAH.",9,0,9,3,0,35,
20/08/2015,SIN.,"CULIACAN, SIN.",6,2,8,0,0,0,
20/08/2015,OAX.,"OAX. DE JUAREZ, OAX.",0,7,7,0,0,0,
20/08/2015,MEX.,"CUAUTITLAN, MEX.",7,0,7,0,5,50,
20/08/2015,CHIH.,"HGO. DEL PARRAL, CHIH.",6,0,6,0,0,0,
20/08/2015,SIN.,"SALVADOR ALVARADO, SIN.",4,1,5,0,0,0,
20/08/2015,COAH.,"PIEDRAS NEGRAS, COAH.",1,4,5,0,0,0,
20/08/2015,COAH.,"MONCLOVA, COAH.",4,1,5,3,1,57,
20/08/2015,MEX.,"LERMA, MEX.",2,2,4,2,0,0,
20/08/2015,TLAX.,"CALPULALPAN, TLAX.",1,2,3,0,0,0,
20/08/2015,CHIH.,"CHIH., CHIH.",1,2,3,0,5,832,
20/08/2015,OAX.,"MIAHUATLAN DE PORFIRIO DIAZ, OAX.",0,3,3,0,0,0,
20/08/2015,COAH.,"PIEDRAS NEGRAS, COAH.",0,3,3,0,0,0,
20/08/2015,MEX.,"CUAUTITLAN IZCALLI, MEX.",3,0,3,0,0,40,
20/08/2015,PUE.,"TEHUACAN, PUE.",1,1,2,0,0,0,
20/08/2015,QRO.,"CORREGIDORA, QRO.",2,0,2,0,1,0,
20/08/2015,SON.,"HERMOSILLO, SON.",1,1,2,7,0,0,
20/08/2015,TAB.,"CENTRO, TAB.",2,0,2,0,0,271,
20/08/2015,DGO.,"GOMEZ PALACIO, DGO.",1,1,2,0,0,0,
20/08/2015,COAH.,"SABINAS, COAH.",2,0,2,0,0,0,
20/08/2015,COAH.,"MÚZQUIZ, COAH.",2,0,2,0,0,0,
20/08/2015,TAMPS.,"EL MANTE, TAMPS.",0,1,1,1,0,0,
20/08/2015,SON.,"CAJEME, SON.",1,0,1,0,0,500,
20/08/2015,TAMPS.,"MIER, TAMPS.",0,1,1,0,0,0,
20/08/2015,DGO.,"LERDO, DGO.",1,0,1,1,0,0,
20/08/2015,DGO.,"TLAHUALILO, DGO.",0,1,1,0,0,0,
20/08/2015,COAH.,"ACUÑA, COAH.",1,0,1,0,0,0,
20/08/2015,MEX.,"IXTAPAN DE LA SAL, MEX.",1,0,1,1,0,0,
20/08/2015,TLAX.,"TLAX., TLAX.",1,0,1,0,0,0,
20/08/2015,CHIH.,"CASAS GRANDES, CHIH.",1,0,1,0,0,9,
20/08/2015,COAH.,"SABINAS, COAH.",0,1,1,0,0,0,
20/08/2015,COAH.,"RAMOS ARIZPE, COAH.",1,0,1,0,0,0,
20/08/2015,COAH.,"ACUÑA, COAH.",1,0,1,1,0,0,
20/08/2015,CAMP.,"CAMP., CAMP.",1,0,1,0,0,0,
20/08/2015,GRO.,"TECPAN DE GALEANA, GRO.",0,1,1,0,0,0,
20/08/2015,VER.,"PAPANTLA, VER.",0,1,1,0,0,0,
20/08/2015,AGS.,"CALVILLO, AGS.",0,0,0,10,0,0,
20/08/2015,HGO.,"EMILIANO ZAPATA, HGO.",0,0,0,0,0,18,
20/08/2015,ZAC.,"JEREZ, ZAC.",0,0,0,6,0,300,
21/08/2015,SIN.,"AHOME, SIN.",30,14,44,0,5,0,
21/08/2015,D.F.,"TLAHUAC, D.F.",28,7,35,0,1,101,
21/08/2015,SIN.,"MAZATLAN, SIN.",16,4,20,0,4,0,
21/08/2015,SIN.,"CULIACAN, SIN.",10,2,12,0,10,0,
21/08/2015,MEX.,"LERMA, MEX.",7,5,12,0,5,0,
21/08/2015,MEX.,"CUAUTITLAN, MEX.",4,4,8,4,0,0,
21/08/2015,MEX.,"IXTAPAN DE LA SAL, MEX.",3,1,4,0,0,128,
21/08/2015,CHIH.,"CHIH., CHIH.",1,3,4,18,3,2102,
21/08/2015,CHIH.,"HGO. DEL PARRAL, CHIH.",4,0,4,0,0,0,
21/08/2015,TLAX.,"CALPULALPAN, TLAX.",1,3,4,0,0,0,
21/08/2015,SIN.,"SALVADOR ALVARADO, SIN.",2,1,3,0,0,0,
21/08/2015,GRO.,"TECPAN DE GALEANA, GRO.",2,1,3,0,0,0,
21/08/2015,MEX.,"CUAUTITLAN IZCALLI, MEX.",1,2,3,0,0,0,
21/08/2015,VER.,"TUXPAM, VER.",2,0,2,0,0,0,
21/08/2015,OAX.,"MIAHUATLAN DE PORFIRIO DIAZ, OAX.",2,0,2,0,0,0,
21/08/2015,VER.,"JALACINGO, VER.",1,1,2,1,0,0,
21/08/2015,QRO.,"CORREGIDORA, QRO.",2,0,2,0,1,0,
21/08/2015,DGO.,"DGO., DGO.",2,0,2,0,0,0,
21/08/2015,TAB.,"CENTRO, TAB.",2,0,2,3,1,50,
21/08/2015,GRO.,"SAN MARCOS, GRO.",2,0,2,0,0,0,
21/08/2015,VER.,"NARANJOS AMATLAN, VER.",0,1,1,0,0,0,
21/08/2015,VER.,"TANTOYUCA, VER.",0,1,1,0,0,0,
21/08/2015,OAX.,"PINOTEPA DE DON LUIS, OAX.",1,0,1,3,0,0,
21/08/2015,TAB.,"BALANCAN, TAB.",0,1,1,0,0,0,
21/08/2015,CHIS.,"TAPACHULA, CHIS.",1,0,1,0,0,47,
21/08/2015,CHIH.,"NUEVO CASAS GRANDES, CHIH.",1,0,1,0,0,50,
21/08/2015,AGS.,"CALVILLO, AGS.",0,0,0,0,0,447,
21/08/2015,TAMPS.,"EL MANTE, TAMPS.",0,0,0,0,0,50,
21/08/2015,Q. ROO,"COZUMEL, Q. ROO",0,0,0,0,0,392,
21/08/2015,GRO.,"CHILAPA DE ALVAREZ, GRO.",0,0,0,0,1,0,
21/08/2015,QRO.,"CORREGIDORA, QRO.",0,0,0,0,0,0,
22/08/2015,MEX.,"LERMA, MEX.",14,0,14,0,0,0,
22/08/2015,DGO.,"DGO., DGO.",5,5,10,22,0,0,
22/08/2015,MEX.,"CUAUTITLAN IZCALLI, MEX.",8,0,8,0,0,53,
22/08/2015,TAMPS.,"MATAMOROS, TAMPS.",4,2,6,1,0,28,
22/08/2015,TLAX.,"CALPULALPAN, TLAX.",1,4,5,0,0,0,
22/08/2015,MEX.,"CUAUTITLAN, MEX.",5,0,5,0,0,0,
22/08/2015,DGO.,"TLAHUALILO, DGO.",3,0,3,0,0,0,
22/08/2015,DGO.,"GOMEZ PALACIO, DGO.",1,1,2,0,1,0,
22/08/2015,MEX.,"IXTAPAN DE LA SAL, MEX.",2,0,2,0,0,0,
22/08/2015,VER.,"NARANJOS AMATLAN, VER.",0,1,1,1,0,0,
22/08/2015,VER.,"TEMPOAL, VER.",1,0,1,0,0,0,
22/08/2015,GRO.,"TECPAN DE GALEANA, GRO.",0,1,1,0,0,0,
22/08/2015,TAMPS.,"VICTORIA, TAMPS.",1,0,1,0,0,103,
22/08/2015,HGO.,"EMILIANO ZAPATA, HGO.",0,0,0,0,1,0,
22/08/2015,DGO.,"LERDO, DGO.",0,0,0,0,1,0,
23/08/2015,TLAX.,"CALPULALPAN, TLAX.",1,2,3,0,0,0,
23/08/2015,DGO.,"DGO., DGO.",3,0,3,11,0,0,
23/08/2015,DGO.,"GOMEZ PALACIO, DGO.",1,1,2,9,0,0,
23/08/2015,DGO.,"TLAHUALILO, DGO.",2,0,2,0,0,0,
23/08/2015,DGO.,"LERDO, DGO.",1,0,1,0,0,0,
23/08/2015,TLAX.,"TLAX., TLAX.",1,0,1,0,0,0,
23/08/2015,CHIH.,"HGO. DEL PARRAL, CHIH.",1,0,1,0,0,0,
24/08/2015,D.F.,"TLAHUAC, D.F.",30,1,31,0,0,0,
24/08/2015,SIN.,"AHOME, SIN.",18,13,31,0,6,0,
24/08/2015,B.C.,"TIJUANA, B.C.",15,8,23,0,0,0,
24/08/2015,COAH.,"TORREÓN, COAH.",12,2,14,1,0,158,
24/08/2015,COAH.,"MONCLOVA, COAH.",9,5,14,2,0,595,
24/08/2015,COAH.,"SALTILLO, COAH.",6,6,12,2,0,420,
24/08/2015,SIN.,"MAZATLAN, SIN.",7,1,8,0,2,0,
24/08/2015,SIN.,"SALVADOR ALVARADO, SIN.",6,2,8,0,0,0,
24/08/2015,SIN.,"CULIACAN, SIN.",7,1,8,0,11,0,
24/08/2015,COAH.,"PIEDRAS NEGRAS, COAH.",3,4,7,2,0,118,
24/08/2015,MEX.,"TULTEPEC, MEX.",7,0,7,3,0,50,
24/08/2015,MEX.,"SAN MATEO ATENCO, MEX.",4,0,4,4,0,0,
24/08/2015,COAH.,"SABINAS, COAH.",2,2,4,0,0,0,
24/08/2015,TAMPS.,"MIGUEL ALEMAN, TAMPS.",1,3,4,0,0,0,
24/08/2015,MEX.,"CHICONCUAC, MEX.",4,0,4,0,0,0,
24/08/2015,COAH.,"MÚZQUIZ, COAH.",1,2,3,0,0,0,
24/08/2015,GRO.,"COYUCA DE BENITEZ, GRO.",0,3,3,0,0,115,
24/08/2015,DGO.,"DGO., DGO.",1,1,2,0,0,0,
24/08/2015,VER.,"NARANJOS AMATLAN, VER.",0,2,2,0,0,5,
24/08/2015,COAH.,"ACUÑA, COAH.",1,1,2,0,0,0,
24/08/2015,MEX.,"MEXICALTZINGO, MEX.",1,0,1,0,0,0,
24/08/2015,DGO.,"GOMEZ PALACIO, DGO.",0,1,1,1,0,0,
24/08/2015,TLAX.,"TLAX., TLAX.",0,1,1,0,0,0,
24/08/2015,CHIS.,"BENEMÉRITO DE LAS AMÉRICAS, CHIS.",1,0,1,0,0,0,
24/08/2015,TAB.,"CARDENAS, TAB.",0,1,1,1,0,0,
24/08/2015,VER.,"TUXPAM, VER.",1,0,1,0,0,0,
24/08/2015,CHIH.,"NUEVO CASAS GRANDES, CHIH.",1,0,1,0,0,0,
24/08/2015,QRO.,"CORREGIDORA, QRO.",1,0,1,0,0,0,
24/08/2015,SON.,"HERMOSILLO, SON.",1,0,1,0,0,0,
24/08/2015,SON.,"CAJEME, SON.",1,0,1,0,0,0,
24/08/2015,DGO.,"LERDO, DGO.",0,1,1,0,0,0,
24/08/2015,DGO.,"MAPIMI, DGO.",1,0,1,0,0,0,
24/08/2015,OAX.,"MIAHUATLAN DE PORFIRIO DIAZ, OAX.",0,0,0,1,0,25,
24/08/2015,TAB.,"CENTRO, TAB.",0,0,0,1,1,50,
24/08/2015,CHIH.,"CHIH., CHIH.",0,0,0,8,1,1855,
24/08/2015,CHIH.,"GUADALUPE, CHIH.",0,0,0,0,0,142,
24/08/2015,TAMPS.,"VICTORIA, TAMPS.",0,0,0,0,0,75,
25/08/2015,D.F.,"TLAHUAC, D.F.",36,7,43,0,4,19,
25/08/2015,SIN.,"AHOME, SIN.",18,7,25,0,6,0,
25/08/2015,MEX.,"CHICONCUAC, MEX.",11,5,16,0,3,130,
25/08/2015,SIN.,"MAZATLAN, SIN.",8,5,13,0,9,0,
25/08/2015,COAH.,"MONCLOVA, COAH.",10,2,12,11,0,100,
25/08/2015,COAH.,"SALTILLO, COAH.",8,3,11,2,0,929,
25/08/2015,DGO.,"GOMEZ PALACIO, DGO.",3,5,8,0,0,0,
25/08/2015,DGO.,"DGO., DGO.",3,4,7,60,1,0,
25/08/2015,COAH.,"TORREÓN, COAH.",6,1,7,0,0,38,
25/08/2015,QRO.,"CORREGIDORA, QRO.",2,3,5,0,0,0,
25/08/2015,SIN.,"SALVADOR ALVARADO, SIN.",4,1,5,0,0,0,
25/08/2015,COAH.,"SABINAS, COAH.",5,0,5,0,0,0,
25/08/2015,SON.,"CAJEME, SON.",4,0,4,1,0,0,
25/08/2015,MEX.,"TULTEPEC, MEX.",3,1,4,1,0,0,
25/08/2015,OAX.,"MIAHUATLAN DE PORFIRIO DIAZ, OAX.",1,2,3,0,0,0,
25/08/2015,CHIH.,"CHIH., CHIH.",3,0,3,0,0,1296,
25/08/2015,COAH.,"MÚZQUIZ, COAH.",3,0,3,0,0,0,
25/08/2015,COAH.,"ACUÑA, COAH.",1,2,3,0,0,0,
25/08/2015,SIN.,"CULIACAN, SIN.",2,0,2,0,1,0,
25/08/2015,TLAX.,"CHIAUTEMPAN, TLAX.",2,0,2,0,0,0,
25/08/2015,ZAC.,"JEREZ, ZAC.",0,2,2,0,0,559,
25/08/2015,COAH.,"PIEDRAS NEGRAS, COAH.",0,2,2,0,0,0,
25/08/2015,MEX.,"SAN MATEO ATENCO, MEX.",2,0,2,1,0,0,
25/08/2015,COL.,"TECOMÁN, COL.",1,0,1,0,0,0,
25/08/2015,VER.,"TUXPAM, VER.",1,0,1,0,0,0,
25/08/2015,VER.,"NARANJOS AMATLAN, VER.",1,0,1,2,0,0,
25/08/2015,TAB.,"CENTRO, TAB.",1,0,1,0,0,0,
25/08/2015,DGO.,"LERDO, DGO.",1,0,1,0,0,0,
25/08/2015,DGO.,"TLAHUALILO, DGO.",0,1,1,0,0,0,
25/08/2015,MEX.,"MEXICALTZINGO, MEX.",0,1,1,0,0,0,
25/08/2015,Q. ROO,"BACALAR, Q. ROO",0,0,0,0,0,106,
25/08/2015,B.C.S.,"COMONDÚ, B.C.S.",0,0,0,0,0,154,
25/08/2015,TAMPS.,"TAMPICO, TAMPS.",0,0,0,0,0,200,
25/08/2015,CHIH.,"NUEVO CASAS GRANDES, CHIH.",0,0,0,0,0,30,
26/08/2015,D.F.,"TLAHUAC, D.F.",31,10,41,208,10,0,
26/08/2015,SIN.,"AHOME, SIN.",26,15,41,0,14,0,
26/08/2015,OAX.,"OAX. DE JUAREZ, OAX.",3,11,14,0,0,0,
26/08/2015,DGO.,"DGO., DGO.",4,5,9,5,0,0,
26/08/2015,MEX.,"TULTEPEC, MEX.",9,0,9,0,1,0,
26/08/2015,COAH.,"SALTILLO, COAH.",6,2,8,0,2,400,
26/08/2015,ZAC.,"ZAC., ZAC.",8,0,8,0,0,268,
26/08/2015,SON.,"HERMOSILLO, SON.",3,2,5,0,0,0,
26/08/2015,SIN.,"CULIACAN, SIN.",3,2,5,0,5,0,
26/08/2015,MEX.,"CHICONCUAC, MEX.",3,2,5,0,4,0,
26/08/2015,MEX.,"MEXICALTZINGO, MEX.",2,2,4,0,0,0,
26/08/2015,TLAX.,"CHIAUTEMPAN, TLAX.",2,1,3,0,0,0,
26/08/2015,CHIH.,"CHIH., CHIH.",3,0,3,13,0,0,
26/08/2015,SIN.,"MAZATLAN, SIN.",1,2,3,0,12,0,
26/08/2015,SIN.,"SALVADOR ALVARADO, SIN.",0,3,3,0,0,0,
26/08/2015,VER.,"NARANJOS AMATLAN, VER.",0,2,2,2,0,0,
26/08/2015,MEX.,"SAN MATEO ATENCO, MEX.",1,1,2,0,1,0,
26/08/2015,DGO.,"GOMEZ PALACIO, DGO.",2,0,2,1,0,0,
26/08/2015,COAH.,"MONCLOVA, COAH.",2,0,2,0,0,112,
26/08/2015,COAH.,"SABINAS, COAH.",1,1,2,0,0,0,
26/08/2015,B.C.,"MEXICALI, B.C.",0,2,2,0,0,0,
26/08/2015,GRO.,"COYUCA DE BENITEZ, GRO.",2,0,2,0,0,192,
26/08/2015,VER.,"TIHUATLAN, VER.",0,1,1,0,0,0,
26/08/2015,VER.,"CAMERINO Z. MENDOZA, VER.",1,0,1,0,0,0,
26/08/2015,TAB.,"BALANCAN, TAB.",0,1,1,0,0,0,
26/08/2015,CHIH.,"HGO. DEL PARRAL, CHIH.",1,0,1,0,0,0,
26/08/2015,OAX.,"SANTIAGO JAMILTEPEC, OAX.",1,0,1,4,0,0,
26/08/2015,COAH.,"TORREÓN, COAH.",1,0,1,0,0,35,
26/08/2015,N.L.,"GARCIA, N.L.",1,0,1,0,2,98,
26/08/2015,TAMPS.,"MIER, TAMPS.",0,1,1,0,0,0,
26/08/2015,TAMPS.,"RIO BRAVO, TAMPS.",1,0,1,0,0,0,
26/08/2015,B.C.,"TIJUANA, B.C.",1,0,1,0,0,0,
26/08/2015,SON.,"CAJEME, SON.",0,1,1,0,0,122,
26/08/2015,ZAC.,"JEREZ, ZAC.",0,1,1,0,0,0,
26/08/2015,PUE.,"PUE., PUE.",1,0,1,0,0,0,
26/08/2015,B.C.S.,"COMONDÚ, B.C.S.",0,1,1,0,0,0,
26/08/2015,VER.,"CAMERINO Z. MENDOZA, VER.",1,0,1,0,0,0,
26/08/2015,TAB.,"BALANCAN, TAB.",0,1,1,0,0,0,
26/08/2015,Q. ROO,"BACALAR, Q. ROO",0,0,0,0,5,167,
26/08/2015,OAX.,"MIAHUATLAN DE PORFIRIO DIAZ, OAX.",0,0,0,0,0,53,
26/08/2015,TAMPS.,"NUEVO LAREDO, TAMPS.",0,0,0,0,0,132,
26/08/2015,TAB.,"CENTRO, TAB.",0,0,0,0,0,20,
26/08/2015,CHIS.,"TAPACHULA, CHIS.",0,0,0,0,0,114,
27/08/2015,D.F.,"TLAHUAC, D.F.",34,4,38,0,1,0,
27/08/2015,SIN.,"AHOME, SIN.",26,7,33,0,4,0,
27/08/2015,OAX.,"OAX. DE JUAREZ, OAX.",0,14,14,0,0,0,
27/08/2015,SIN.,"MAZATLAN, SIN.",11,2,13,0,9,0,
27/08/2015,COAH.,"MONCLOVA, COAH.",9,1,10,2,0,121,
27/08/2015,COAH.,"SALTILLO, COAH.",6,3,9,1,2,387,
27/08/2015,SON.,"HERMOSILLO, SON.",5,3,8,0,0,0,
27/08/2015,DGO.,"GOMEZ PALACIO, DGO.",4,4,8,1,0,0,
27/08/2015,DGO.,"DGO., DGO.",5,1,6,9,2,0,
27/08/2015,SIN.,"CULIACAN, SIN.",4,1,5,0,1,0,
27/08/2015,SON.,"CAJEME, SON.",3,0,3,1,0,0,
27/08/2015,SIN.,"SALVADOR ALVARADO, SIN.",2,1,3,0,1,0,
27/08/2015,TAMPS.,"EL MANTE, TAMPS.",0,2,2,0,0,0,
27/08/2015,ZAC.,"JEREZ, ZAC.",1,1,2,32,0,464,
27/08/2015,YUC.,"PROGRESO, YUC.",1,1,2,0,0,0,
27/08/2015,DGO.,"LERDO, DGO.",1,1,2,0,0,0,
27/08/2015,MEX.,"MEXICALTZINGO, MEX.",0,2,2,0,0,0,
27/08/2015,COAH.,"RAMOS ARIZPE, COAH.",1,0,1,0,0,0,
27/08/2015,COAH.,"ACUÑA, COAH.",1,0,1,0,0,0,
27/08/2015,QRO.,"CORREGIDORA, QRO.",1,0,1,0,0,0,
27/08/2015,VER.,"TUXPAM, VER.",1,0,1,0,0,0,
27/08/2015,CHIH.,"HGO. DEL PARRAL, CHIH.",0,1,1,0,0,30,
27/08/2015,PUE.,"PUE., PUE.",0,1,1,0,0,0,
27/08/2015,MEX.,"SAN MATEO ATENCO, MEX.",1,0,1,1,0,0,
27/08/2015,TAMPS.,"VICTORIA, TAMPS.",0,0,0,1,0,119,
27/08/2015,Q. ROO,"BACALAR, Q. ROO",0,0,0,0,0,139,
27/08/2015,N.L.,"MONTERREY, N.L.",0,0,0,16,0,4700,
28/08/2015,SIN.,"AHOME, SIN.",44,10,54,0,7,0,
28/08/2015,D.F.,"TLAHUAC, D.F.",38,4,42,0,0,0,
28/08/2015,SIN.,"CULIACAN, SIN.",10,7,17,0,4,0,
28/08/2015,B.C.,"MEXICALI, B.C.",7,8,15,0,0,0,
28/08/2015,MEX.,"CHICONCUAC, MEX.",8,3,11,0,0,0,
28/08/2015,SIN.,"MAZATLAN, SIN.",8,2,10,0,7,0,
28/08/2015,MEX.,"SAN MATEO ATENCO, MEX.",7,2,9,0,0,0,
28/08/2015,COAH.,"SALTILLO, COAH.",4,4,8,3,3,403,
28/08/2015,SIN.,"SALVADOR ALVARADO, SIN.",3,5,8,0,0,8,
28/08/2015,DGO.,"GOMEZ PALACIO, DGO.",8,0,8,3,0,0,
28/08/2015,COAH.,"SABINAS, COAH.",5,1,6,0,0,0,
28/08/2015,OAX.,"CIUDAD IXTEPEC, OAX.",4,2,6,1,0,0,
28/08/2015,MEX.,"TULTEPEC, MEX.",5,0,5,0,0,0,
28/08/2015,B.C.,"TIJUANA, B.C.",2,3,5,0,0,0,
28/08/2015,COAH.,"MONCLOVA, COAH.",2,2,4,1,0,30,
28/08/2015,COAH.,"ACUÑA, COAH.",3,1,4,1,0,0,
28/08/2015,GRO.,"GENERAL HELIODORO CASTILLO, GRO.",4,0,4,0,0,0,
28/08/2015,QRO.,"CORREGIDORA, QRO.",1,2,3,0,0,0,
28/08/2015,CHIH.,"HGO. DEL PARRAL, CHIH.",2,1,3,0,0,35,
28/08/2015,B.C.,"ENSENADA, B.C.",1,2,3,0,0,0,
28/08/2015,DGO.,"TLAHUALILO, DGO.",1,2,3,0,0,0,
28/08/2015,MEX.,"MEXICALTZINGO, MEX.",2,0,2,1,0,0,
28/08/2015,ZAC.,"FRESNILLO, ZAC.",0,2,2,0,0,0,
28/08/2015,DGO.,"DGO., DGO.",2,0,2,0,0,0,
28/08/2015,GRO.,"PUNGARABATO, GRO.",2,0,2,0,0,0,
28/08/2015,VER.,"TANTOYUCA, VER.",1,1,2,0,0,0,
28/08/2015,SON.,"HERMOSILLO, SON.",2,0,2,3,0,0,
28/08/2015,CHIH.,"CHIH., CHIH.",1,1,2,21,0,2537,
28/08/2015,COAH.,"MÚZQUIZ, COAH.",1,0,1,0,1,0,
28/08/2015,OAX.,"SANTIAGO JAMILTEPEC, OAX.",0,1,1,0,0,0,
28/08/2015,CHIS.,"BENEMÉRITO DE LAS AMÉRICAS, CHIS.",1,0,1,0,0,0,
28/08/2015,TAB.,"JONUTA, TAB.",1,0,1,0,0,0,
28/08/2015,VER.,"ALAMO, VER.",0,1,1,0,0,0,
28/08/2015,CHIH.,"GUADALUPE, CHIH.",1,0,1,0,0,0,
28/08/2015,PUE.,"PUE., PUE.",1,0,1,0,0,0,
28/08/2015,TAB.,"CENTRO, TAB.",1,0,1,0,0,0,
28/08/2015,DGO.,"LERDO, DGO.",0,1,1,0,0,0,
28/08/2015,ZAC.,"JEREZ, ZAC.",0,0,0,9,0,100,
28/08/2015,COL.,"COL., COL.",0,0,0,0,0,20,
28/08/2015,N.L.,"GARCIA, N.L.",0,0,0,0,0,30,
28/08/2015,TAMPS.,"MATAMOROS, TAMPS.",0,0,0,1,0,103,
28/08/2015,COAH.,"TORREÓN, COAH.",0,0,0,0,0,42,
28/08/2015,OAX.,"MIAHUATLAN DE PORFIRIO DIAZ, OAX.",0,0,0,3,0,60,
28/08/2015,CHIS.,"TAPACHULA, CHIS.",0,0,0,0,0,57,
28/08/2015,CHIS.,"TONALÁ, CHIS.",0,0,0,2,0,0,
29/08/2015,B.C.,"MEXICALI, B.C.",9,7,16,0,0,0,
29/08/2015,MEX.,"CHICONCUAC, MEX.",10,1,11,0,9,0,
29/08/2015,COAH.,"PIEDRAS NEGRAS, COAH.",2,9,11,0,0,30,
29/08/2015,TAMPS.,"RIO BRAVO, TAMPS.",4,3,7,0,0,22,
29/08/2015,DGO.,"DGO., DGO.",3,3,6,0,0,0,
29/08/2015,DGO.,"GOMEZ PALACIO, DGO.",6,0,6,0,0,0,
29/08/2015,MEX.,"SAN MATEO ATENCO, MEX.",3,0,3,2,0,0,
29/08/2015,MEX.,"TULTEPEC, MEX.",2,1,3,0,0,0,
29/08/2015,MEX.,"MEXICALTZINGO, MEX.",1,1,2,0,0,0,
29/08/2015,COAH.,"MONCLOVA, COAH.",2,0,2,0,0,50,
29/08/2015,DGO.,"TLAHUALILO, DGO.",1,1,2,0,0,0,
29/08/2015,TAB.,"CENTRO, TAB.",1,0,1,0,0,0,
29/08/2015,GRO.,"PUNGARABATO, GRO.",1,0,1,0,0,0,
29/08/2015,ZAC.,"ZAC., ZAC.",1,0,1,0,0,0,
29/08/2015,GRO.,"ACAPULCO DE JUAREZ, GRO.",1,0,1,0,0,0,
29/08/2015,N.L.,"MONTERREY, N.L.",1,0,1,0,0,350,
29/08/2015,Q. ROO,"BACALAR, Q. ROO",0,0,0,0,0,202,
29/08/2015,CHIS.,"TAPACHULA, CHIS.",0,0,0,0,0,30,
29/08/2015,PUE.,"PUE., PUE.",0,0,0,1,0,0,
29/08/2015,PUE.,"TEHUACAN, PUE.",0,0,0,0,0,99,
29/08/2015,SON.,"CAJEME, SON.",0,0,0,0,0,17,
30/08/2015,TAMPS.,"MATAMOROS, TAMPS.",4,2,6,0,0,100,
30/08/2015,DGO.,"DGO., DGO.",4,1,5,0,3,0,
30/08/2015,N.L.,"MONTERREY, N.L.",2,0,2,40,0,580,
30/08/2015,B.C.,"TIJUANA, B.C.",1,1,2,0,0,0,
30/08/2015,TAMPS.,"MIGUEL ALEMAN, TAMPS.",0,1,1,0,0,0,
30/08/2015,N.L.,"GARCIA, N.L.",0,0,0,8,0,287,
31/08/2015,D.F.,"TLALPAN, D.F.",36,2,38,0,11,49,
31/08/2015,MEX.,"ATIZAPAN DE ZARAGOZA, MEX.",20,2,22,1,5,187,
31/08/2015,COAH.,"TORREÓN, COAH.",11,2,13,5,0,24,
31/08/2015,MEX.,"COYOTEPEC, MEX.",9,2,11,2,0,68,
31/08/2015,COAH.,"SALTILLO, COAH.",9,1,10,0,3,444,
31/08/2015,SIN.,"COSALA, SIN.",3,4,7,0,0,0,
31/08/2015,SIN.,"MAZATLAN, SIN.",4,2,6,0,3,0,
31/08/2015,B.C.,"TIJUANA, B.C.",3,3,6,0,0,0,
31/08/2015,COAH.,"MONCLOVA, COAH.",4,1,5,0,0,43,
31/08/2015,CHIH.,"CHIH., CHIH.",3,1,4,6,0,869,
31/08/2015,SON.,"HERMOSILLO, SON.",3,1,4,0,0,0,
31/08/2015,B.C.,"MEXICALI, B.C.",3,1,4,0,0,0,
31/08/2015,SIN.,"ROSARIO, SIN.",2,1,3,0,0,0,
31/08/2015,SIN.,"ANGOSTURA, SIN.",2,1,3,0,0,0,
31/08/2015,ZAC.,"FRESNILLO, ZAC.",2,0,2,0,0,0,
31/08/2015,COAH.,"MÚZQUIZ, COAH.",1,1,2,0,0,0,
31/08/2015,COAH.,"SABINAS, COAH.",2,0,2,0,1,0,
31/08/2015,CHIH.,"HGO. DEL PARRAL, CHIH.",2,0,2,0,0,0,
31/08/2015,MEX.,"HUIXQUILUCAN, MEX.",2,0,2,2,0,0,
31/08/2015,DGO.,"DGO., DGO.",1,0,1,0,0,0,
31/08/2015,CHIH.,"GUADALUPE, CHIH.",1,0,1,0,0,8,
31/08/2015,SIN.,"CULIACAN, SIN.",0,1,1,0,0,0,
31/08/2015,COAH.,"PIEDRAS NEGRAS, COAH.",1,0,1,0,0,0,
31/08/2015,TAB.,"TENOSIQUE, TAB.",1,0,1,0,0,0,
31/08/2015,GRO.,"PUNGARABATO, GRO.",1,0,1,0,0,0,
31/08/2015,GRO.,"GENERAL HELIODORO CASTILLO, GRO.",0,1,1,0,0,0,
31/08/2015,VER.,"ALAMO, VER.",1,0,1,0,0,0,
31/08/2015,VER.,"TANTOYUCA, VER.",0,1,1,0,0,0,
31/08/2015,COL.,"TECOMÁN, COL.",1,0,1,0,0,0,
31/08/2015,MEX.,"COACALCO DE BERRIOZABAL, MEX.",1,0,1,0,5,0,
31/08/2015,N.L.,"MONTERREY, N.L.",0,0,0,50,0,1300,
31/08/2015,N.L.,"GARCIA, N.L.",0,0,0,27,0,1862,
31/08/2015,OAX.,"MIAHUATLAN DE PORFIRIO DIAZ, OAX.",0,0,0,3,0,90,
31/08/2015,Q. ROO,"BACALAR, Q. ROO",0,0,0,0,0,221,
31/08/2015,TAMPS.,"VICTORIA, TAMPS.",0,0,0,5,0,148,
01/09/2015,D.F.,"TLALPAN, D.F.",33,1,34,0,5,0,
01/09/2015,SIN.,"CHOIX, SIN.",21,5,26,0,2,0,
01/09/2015,MEX.,"ATIZAPAN DE ZARAGOZA, MEX.",12,4,16,0,9,1571,
01/09/2015,MEX.,"COYOTEPEC, MEX.",9,4,13,0,0,0,
01/09/2015,DGO.,"DGO., DGO.",8,2,10,11,0,0,
01/09/2015,COAH.,"TORREÓN, COAH.",8,1,9,0,0,209,
01/09/2015,COAH.,"SALTILLO, COAH.",8,0,8,3,2,173,
01/09/2015,OAX.,"OAX. DE JUAREZ, OAX.",0,7,7,0,0,0,
01/09/2015,COAH.,"SABINAS, COAH.",3,3,6,0,0,0,
01/09/2015,SIN.,"ROSARIO, SIN.",3,3,6,0,0,0,
01/09/2015,CHIH.,"CHIH., CHIH.",3,3,6,2,0,298,
01/09/2015,SIN.,"MAZATLAN, SIN.",3,2,5,0,0,0,
01/09/2015,COAH.,"MONCLOVA, COAH.",4,0,4,1,0,2,
01/09/2015,GRO.,"CHILPANCINGO DE LOS BRAVO, GRO.",1,3,4,0,0,0,
01/09/2015,CHIH.,"GUADALUPE, CHIH.",1,3,4,0,0,0,
01/09/2015,B.C.,"TIJUANA, B.C.",2,1,3,0,0,0,
01/09/2015,OAX.,"SALINA CRUZ, OAX.",1,1,2,0,0,1,
01/09/2015,SIN.,"COSALA, SIN.",1,1,2,0,5,0,
01/09/2015,COAH.,"MÚZQUIZ, COAH.",0,1,1,0,0,0,
01/09/2015,COAH.,"ACUÑA, COAH.",1,0,1,0,0,10,
01/09/2015,OAX.,"MIAHUATLAN DE PORFIRIO DIAZ, OAX.",0,1,1,0,0,0,
01/09/2015,CHIS.,"BENEMÉRITO DE LAS AMÉRICAS, CHIS.",0,1,1,0,0,0,
01/09/2015,N.L.,"GRAL. ESCOBEDO, N.L.",1,0,1,0,0,0,
01/09/2015,SIN.,"ANGOSTURA, SIN.",1,0,1,0,0,0,
01/09/2015,SIN.,"CULIACAN, SIN.",0,1,1,0,5,0,
01/09/2015,Q. ROO,"BACALAR, Q. ROO",0,0,0,0,0,141,
01/09/2015,TAB.,"CENTRO, TAB.",0,0,0,0,0,200,
01/09/2015,N.L.,"MONTERREY, N.L.",0,0,0,51,0,100,
01/09/2015,CHIS.,"HUIXTLA, CHIS.",0,0,0,0,0,95,
01/09/2015,CHIH.,"ASCENSIÓN, CHIH.",0,0,0,0,0,10,
02/09/2015,D.F.,"TLALPAN, D.F.",40,1,41,81,2,214,
02/09/2015,SIN.,"MAZATLAN, SIN.",11,7,18,0,11,0,
02/09/2015,MEX.,"ATIZAPAN DE ZARAGOZA, MEX.",17,1,18,6,6,415,
02/09/2015,MEX.,"COYOTEPEC, MEX.",12,2,14,0,0,0,
02/09/2015,COAH.,"PIEDRAS NEGRAS, COAH.",7,5,12,0,3,103,
02/09/2015,COAH.,"SALTILLO, COAH.",9,2,11,0,2,390,
02/09/2015,SIN.,"CHOIX, SIN.",4,5,9,0,1,0,
02/09/2015,OAX.,"OAX. DE JUAREZ, OAX.",2,6,8,3,0,86,
02/09/2015,COAH.,"TORREÓN, COAH.",6,0,6,2,0,39,
02/09/2015,DGO.,"GOMEZ PALACIO, DGO.",5,1,6,0,0,0,
02/09/2015,B.C.,"MEXICALI, B.C.",3,3,6,0,0,0,
02/09/2015,DGO.,"DGO., DGO.",3,2,5,0,0,0,
02/09/2015,SIN.,"ROSARIO, SIN.",3,1,4,0,0,0,
02/09/2015,SIN.,"COSALA, SIN.",2,2,4,0,1,0,
02/09/2015,CHIH.,"CHIH., CHIH.",3,1,4,6,1,712,
02/09/2015,MEX.,"COACALCO DE BERRIOZABAL, MEX.",3,1,4,3,6,0,
02/09/2015,B.C.,"ENSENADA, B.C.",2,1,3,0,0,0,
02/09/2015,COAH.,"MONCLOVA, COAH.",3,0,3,0,0,18,
02/09/2015,SIN.,"CULIACAN, SIN.",0,2,2,0,11,0,
02/09/2015,VER.,"TIERRA BLANCA, VER.",2,0,2,0,0,0,
02/09/2015,DGO.,"TLAHUALILO, DGO.",1,1,2,0,0,0,
02/09/2015,DGO.,"MAPIMI, DGO.",1,1,2,0,0,0,
02/09/2015,B.C.,"TIJUANA, B.C.",2,0,2,0,0,0,
02/09/2015,MEX.,"HUIXQUILUCAN, MEX.",1,1,2,0,0,0,
02/09/2015,VER.,"PAPANTLA, VER.",1,0,1,2,0,50,
02/09/2015,OAX.,"MIAHUATLAN DE PORFIRIO DIAZ, OAX.",1,0,1,4,0,139,
02/09/2015,GRO.,"TLAPEHUALA, GRO.",1,0,1,0,0,0,
02/09/2015,CHIH.,"HGO. DEL PARRAL, CHIH.",1,0,1,0,0,100,
02/09/2015,GRO.,"ZIHUATANEJO DE AZUETA, GRO.",1,0,1,0,0,0,
02/09/2015,TAMPS.,"VICTORIA, TAMPS.",1,0,1,0,0,170,
02/09/2015,TAMPS.,"EL MANTE, TAMPS.",1,0,1,0,0,110,
02/09/2015,CHIH.,"NUEVO CASAS GRANDES, CHIH.",1,0,1,0,0,6,
02/09/2015,N.L.,"MONTERREY, N.L.",0,1,1,29,0,1150,
02/09/2015,N.L.,"GRAL. ESCOBEDO, N.L.",1,0,1,1,0,0,
02/09/2015,SON.,"HERMOSILLO, SON.",1,0,1,0,0,0,
02/09/2015,SON.,"CAJEME, SON.",1,0,1,0,0,0,
02/09/2015,COAH.,"RAMOS ARIZPE, COAH.",1,0,1,0,0,0,
02/09/2015,SIN.,"ANGOSTURA, SIN.",0,0,0,0,1,0,
02/09/2015,TAB.,"CENTRO, TAB.",0,0,0,1,0,64,
02/09/2015,TAMPS.,"NUEVO LAREDO, TAMPS.",0,0,0,3,0,15,
02/09/2015,N.L.,"GARCIA, N.L.",0,0,0,31,0,1950,
03/09/2015,D.F.,"TLALPAN, D.F.",33,1,34,0,3,0,
03/09/2015,MEX.,"ATIZAPAN, MEX.",11,5,16,4,0,5800,
03/09/2015,MEX.,"COYOTEPEC, MEX.",13,2,15,0,0,0,
03/09/2015,COAH.,"SALTILLO, COAH.",11,2,13,0,0,150,
03/09/2015,COAH.,"TORREÓN, COAH.",5,6,11,0,0,16,
03/09/2015,COAH.,"TORREÓN, COAH.",5,6,11,0,0,16,
03/09/2015,SIN.,"MAZATLAN, SIN.",9,1,10,0,5,0,
03/09/2015,DGO.,"GOMEZ PALACIO, DGO.",7,1,8,0,0,0,
03/09/2015,SIN.,"CULIACAN, SIN.",7,0,7,0,0,0,
03/09/2015,COAH.,"MONCLOVA, COAH.",7,0,7,3,0,326,
03/09/2015,MEX.,"COACALCO DE BERRIOZABAL, MEX.",3,3,6,0,2,0,
03/09/2015,OAX.,"OAX. DE JUAREZ, OAX.",0,4,4,2,0,0,
03/09/2015,B.C.,"TIJUANA, B.C.",1,3,4,0,0,0,
03/09/2015,SIN.,"ROSARIO, SIN.",2,1,3,0,0,0,
03/09/2015,SIN.,"COSALA, SIN.",0,3,3,1,0,0,
03/09/2015,CHIH.,"CHIH., CHIH.",2,1,3,4,0,1214,
03/09/2015,DGO.,"DGO., DGO.",3,0,3,0,0,0,
03/09/2015,SIN.,"ANGOSTURA, SIN.",1,1,2,0,0,0,
03/09/2015,SIN.,"CHOIX, SIN.",0,2,2,0,9,0,
03/09/2015,SON.,"HERMOSILLO, SON.",2,0,2,0,0,0,
03/09/2015,B.C.,"ENSENADA, B.C.",2,0,2,0,0,0,
03/09/2015,B.C.,"MEXICALI, B.C.",2,0,2,0,0,0,
03/09/2015,COAH.,"MÚZQUIZ, COAH.",0,2,2,0,0,0,
03/09/2015,COAH.,"ACUÑA, COAH.",2,0,2,0,0,0,
03/09/2015,VER.,"TIERRA BLANCA, VER.",0,1,1,0,0,0,
03/09/2015,OAX.,"SALINA CRUZ, OAX.",0,1,1,0,0,0,
03/09/2015,DGO.,"TLAHUALILO, DGO.",0,1,1,0,0,0,
03/09/2015,COL.,"COL., COL.",1,0,1,0,0,0,
03/09/2015,MEX.,"HUIXQUILUCAN, MEX.",1,0,1,0,0,0,
03/09/2015,GRO.,"ZIHUATANEJO DE AZUETA, GRO.",1,0,1,0,0,41,
03/09/2015,N.L.,"MONTERREY, N.L.",0,1,1,117,0,450,
03/09/2015,N.L.,"GRAL. ESCOBEDO, N.L.",0,1,1,0,0,0,
03/09/2015,N.L.,"SANTA CATARINA, N.L.",0,1,1,0,0,0,
03/09/2015,N.L.,"GARCIA, N.L.",0,1,1,0,0,0,
03/09/2015,TLAX.,"TLAX., TLAX.",1,0,1,0,0,0,
03/09/2015,COAH.,"SABINAS, COAH.",1,0,1,0,0,0,
03/09/2015,TAB.,"CENTLA, TAB.",1,0,1,0,0,0,
03/09/2015,OAX.,"MIAHUATLAN DE PORFIRIO DIAZ, OAX.",0,0,0,0,0,96,
03/09/2015,SON.,"CAJEME, SON.",0,0,0,0,0,1,
04/09/2015,D.F.,"TLALPAN, D.F.",34,3,37,0,5,0,
04/09/2015,PUE.,"PUE., PUE.",24,3,27,5,0,654,
04/09/2015,MEX.,"ATIZAPAN DE ZARAGOZA, MEX.",16,1,17,3,0,1095,
04/09/2015,MEX.,"COYOTEPEC, MEX.",10,4,14,0,1,0,
04/09/2015,SIN.,"MAZATLAN, SIN.",12,1,13,0,8,0,
04/09/2015,B.C.,"MEXICALI, B.C.",4,9,13,0,0,0,
04/09/2015,MEX.,"COACALCO DE BERRIOZABAL, MEX.",7,1,8,0,5,0,
04/09/2015,SIN.,"CHOIX, SIN.",0,7,7,0,0,0,
04/09/2015,CHIH.,"HGO. DEL PARRAL, CHIH.",2,1,3,0,0,40,
04/09/2015,SIN.,"ANGOSTURA, SIN.",1,2,3,0,0,0,
04/09/2015,OAX.,"OAX. DE JUAREZ, OAX.",0,2,2,0,0,0,
04/09/2015,GRO.,"ZIHUATANEJO DE AZUETA, GRO.",2,0,2,0,0,44,
04/09/2015,B.C.,"TIJUANA, B.C.",2,0,2,0,0,0,
04/09/2015,COL.,"COL., COL.",0,2,2,0,0,19,
04/09/2015,SIN.,"CULIACAN, SIN.",1,1,2,0,4,0,
04/09/2015,TAB.,"CARDENAS, TAB.",1,0,1,1,0,15,
04/09/2015,SON.,"HERMOSILLO, SON.",0,1,1,0,0,0,
04/09/2015,AGS.,"JESÚS MARÍA, AGS.",1,0,1,98,0,1,
04/09/2015,ZAC.,"JEREZ, ZAC.",1,0,1,0,0,0,
04/09/2015,DGO.,"DGO., DGO.",1,0,1,47,0,0,
04/09/2015,SIN.,"ROSARIO, SIN.",1,0,1,0,0,0,
04/09/2015,SIN.,"COSALA, SIN.",1,0,1,0,0,0,
04/09/2015,MEX.,"ATIZAPAN DE ZARAGOZA, MEX.",0,1,1,0,1,0,
04/09/2015,Q. ROO,"BACALAR, Q. ROO",0,0,0,0,0,134,
04/09/2015,TAB.,"CENTRO, TAB.",0,0,0,1,0,279,
05/09/2015,MEX.,"ATIZAPAN DE ZARAGOZA, MEX.",12,2,14,4,1,40,
05/09/2015,MEX.,"COYOTEPEC, MEX.",9,2,11,0,0,0,
05/09/2015,N.L.,"MONTERREY, N.L.",5,0,5,2,0,1350,
05/09/2015,COAH.,"PIEDRAS NEGRAS, COAH.",3,2,5,2,0,0,
05/09/2015,DGO.,"DGO., DGO.",4,0,4,4,2,0,
05/09/2015,DGO.,"GOMEZ PALACIO, DGO.",4,0,4,0,0,0,
05/09/2015,MEX.,"HUIXQUILUCAN, MEX.",1,1,2,0,0,103,
05/09/2015,N.L.,"GRAL. ESCOBEDO, N.L.",1,0,1,0,0,0,
05/09/2015,N.L.,"GARCIA, N.L.",1,0,1,31,0,119,
05/09/2015,TLAX.,"EL CARMEN TEQUEXQUITLA, TLAX.",1,0,1,0,0,0,
05/09/2015,DGO.,"TLAHUALILO, DGO.",0,1,1,0,0,0,
05/09/2015,MEX.,"COACALCO DE BERRIOZABAL, MEX.",1,0,1,0,4,0,
05/09/2015,TAMPS.,"VICTORIA, TAMPS.",1,0,1,0,0,17,
05/09/2015,COAH.,"MONCLOVA, COAH.",1,0,1,0,0,0,
05/09/2015,B.C.,"ENSENADA, B.C.",1,0,1,0,0,0,
05/09/2015,CHIH.,"HGO. DEL PARRAL, CHIH.",0,0,0,0,0,30,
05/09/2015,N.L.,"SANTA CATARINA, N.L.",0,0,0,4,0,600,
05/09/2015,SON.,"CAJEME, SON.",0,0,0,0,0,5000,
05/09/2015,CHIS.,"TAPACHULA, CHIS.",0,0,0,0,0,113,
05/09/2015,PUE.,"TEHUACAN, PUE.",0,0,0,0,11,0,
06/09/2015,TAMPS.,"MATAMOROS, TAMPS.",2,2,4,1,0,0,
06/09/2015,DGO.,"DGO., DGO.",2,0,2,1,2,0,
06/09/2015,N.L.,"GRAL. ESCOBEDO, N.L.",1,1,2,11,0,700,
06/09/2015,DGO.,"LERDO, DGO.",1,1,2,0,0,0,
06/09/2015,TLAX.,"EL CARMEN TEQUEXQUITLA, TLAX.",1,0,1,0,0,0,
06/09/2015,GRO.,"ZIHUATANEJO DE AZUETA, GRO.",0,1,1,0,0,0,
06/09/2015,N.L.,"MONTERREY, N.L.",0,1,1,6,0,7000,
06/09/2015,N.L.,"SANTA CATARINA, N.L.",1,0,1,0,0,0,
06/09/2015,DGO.,"GOMEZ PALACIO, DGO.",0,1,1,0,0,0,
06/09/2015,B.C.,"MEXICALI, B.C.",0,1,1,0,0,0,
07/09/2015,D.F.,"TLALPAN, D.F.",34,2,36,0,7,0,
07/09/2015,DGO.,"GOMEZ PALACIO, DGO.",3,3,6,0,0,0,
07/09/2015,B.C.,"TIJUANA, B.C.",5,1,6,0,0,0,
07/09/2015,SIN.,"CULIACAN, SIN.",3,2,5,0,4,0,
07/09/2015,SIN.,"COSALA, SIN.",2,3,5,0,0,0,
07/09/2015,COAH.,"TORREÓN, COAH.",3,2,5,2,0,0,
07/09/2015,N.L.,"MONTERREY, N.L.",1,4,5,0,0,200,
07/09/2015,SIN.,"MAZATLAN, SIN.",2,2,4,0,4,0,
07/09/2015,COAH.,"SABINAS, COAH.",3,0,3,0,0,84,
07/09/2015,SIN.,"ROSARIO, SIN.",1,1,2,0,0,0,
07/09/2015,SIN.,"SAN IGNACIO, SIN.",1,1,2,0,0,0,
07/09/2015,DGO.,"LERDO, DGO.",2,0,2,0,0,0,
07/09/2015,MEX.,"CHAPULTEPEC, MEX.",1,1,2,1,0,5,
07/09/2015,DGO.,"DGO., DGO.",2,0,2,21,0,0,
07/09/2015,SON.,"HERMOSILLO, SON.",0,2,2,0,0,0,
07/09/2015,VER.,"JAMAPA, VER.",1,0,1,0,0,0,
07/09/2015,SIN.,"ANGOSTURA, SIN.",0,1,1,0,0,0,
07/09/2015,COL.,"COL., COL.",0,1,1,0,0,0,
07/09/2015,OAX.,"MIAHUATLAN DE PORFIRIO DIAZ, OAX.",0,1,1,2,0,123,
07/09/2015,DGO.,"TLAHUALILO, DGO.",1,0,1,0,0,0,
07/09/2015,AGS.,"JESÚS MARÍA, AGS.",1,0,1,0,0,79,
07/09/2015,CHIH.,"ASCENSIÓN, CHIH.",0,1,1,0,0,0,
07/09/2015,N.L.,"GRAL. ESCOBEDO, N.L.",0,1,1,0,0,100,
07/09/2015,N.L.,"SANTA CATARINA, N.L.",0,1,1,3,0,0,
07/09/2015,HGO.,"TOLCAYUCA, HGO.",0,0,0,0,0,2000,
08/09/2015,D.F.,"TLALPAN, D.F.",31,2,33,0,1,0,
08/09/2015,SIN.,"CHOIX, SIN.",3,13,16,0,1,0,
08/09/2015,SIN.,"MAZATLAN, SIN.",11,2,13,0,4,0,
08/09/2015,B.C.,"ENSENADA, B.C.",8,4,12,0,0,0,
08/09/2015,MEX.,"CHALCO, MEX.",8,0,8,0,0,460,
08/09/2015,MEX.,"TULTITLAN, MEX.",7,0,7,4,0,138,
08/09/2015,B.C.,"TIJUANA, B.C.",4,3,7,0,0,0,
08/09/2015,CHIH.,"HGO. DEL PARRAL, CHIH.",3,2,5,0,0,0,
08/09/2015,SIN.,"ROSARIO, SIN.",2,2,4,0,0,0,
08/09/2015,COAH.,"PIEDRAS NEGRAS, COAH.",0,3,3,5,4,40,
08/09/2015,N.L.,"MONTERREY, N.L.",3,0,3,19,0,1349,
08/09/2015,TLAX.,"TLAX., TLAX.",2,0,2,0,0,0,
08/09/2015,VER.,"PEROTE, VER.",2,0,2,0,0,0,
08/09/2015,SON.,"HERMOSILLO, SON.",2,0,2,0,0,0,
08/09/2015,SIN.,"SAN IGNACIO, SIN.",1,1,2,0,0,0,
08/09/2015,MEX.,"TONATICO, MEX.",1,1,2,0,0,115,
08/09/2015,VER.,"JAMAPA, VER.",1,0,1,0,0,0,
08/09/2015,HGO.,"MIXQUIAHUALA DE JUAREZ, HGO.",1,0,1,0,0,0,
08/09/2015,CHIH.,"ASCENSIÓN, CHIH.",1,0,1,0,0,0,
08/09/2015,PUE.,"PUE., PUE.",1,0,1,0,0,24,
08/09/2015,SIN.,"CULIACAN, SIN.",0,1,1,0,10,0,
08/09/2015,OAX.,"MIAHUATLAN DE PORFIRIO DIAZ, OAX.",0,0,0,6,0,0,
08/09/2015,CHIS.,"TAPACHULA, CHIS.",0,0,0,0,0,20,
08/09/2015,N.L.,"GRAL. ESCOBEDO, N.L.",0,0,0,71,0,0,
08/09/2015,SIN.,"ANGOSTURA, SIN.",0,0,0,0,0,0,
09/09/2015,D.F.,"TLALPAN, D.F.",37,5,42,0,0,60,
09/09/2015,SIN.,"CHOIX, SIN.",21,5,26,0,5,0,
09/09/2015,COAH.,"SALTILLO, COAH.",11,2,13,16,3,118,
09/09/2015,SIN.,"MAZATLAN, SIN.",9,2,11,0,0,0,
09/09/2015,B.C.,"TIJUANA, B.C.",7,1,8,0,0,0,
09/09/2015,COAH.,"TORREÓN, COAH.",7,0,7,0,0,100,
09/09/2015,MEX.,"CHALCO, MEX.",6,1,7,0,1,0,
09/09/2015,COL.,"COL., COL.",1,4,5,0,0,0,
09/09/2015,COAH.,"PIEDRAS NEGRAS, COAH.",2,2,4,2,0,40,
09/09/2015,COAH.,"MONCLOVA, COAH.",3,1,4,0,0,51,
09/09/2015,CHIH.,"HGO. DEL PARRAL, CHIH.",3,1,4,0,0,0,
09/09/2015,MEX.,"TONATICO, MEX.",4,0,4,0,0,0,
09/09/2015,HGO.,"MIXQUIAHUALA DE JUAREZ, HGO.",2,0,2,0,0,1000,
09/09/2015,VER.,"TANTOYUCA, VER.",2,0,2,0,0,0,
09/09/2015,SIN.,"SAN IGNACIO, SIN.",1,1,2,0,0,0,
09/09/2015,DGO.,"DGO., DGO.",2,0,2,4,2,0,
09/09/2015,TLAX.,"HUAMANTLA, TLAX.",2,0,2,0,0,0,
09/09/2015,COAH.,"RAMOS ARIZPE, COAH.",1,1,2,2,0,115,
09/09/2015,COAH.,"ACUÑA, COAH.",0,2,2,0,0,2,
09/09/2015,VER.,"PEROTE, VER.",1,0,1,0,0,0,
09/09/2015,TAB.,"BALANCAN, TAB.",0,1,1,0,0,0,
09/09/2015,N.L.,"MONTERREY, N.L.",1,0,1,6,0,450,
09/09/2015,N.L.,"GRAL. ESCOBEDO, N.L.",1,0,1,0,0,0,
09/09/2015,TAMPS.,"TAMPICO, TAMPS.",1,0,1,4,0,0,
09/09/2015,S.L.P.,"CIUDAD VALLES, S.L.P.",1,0,1,0,0,0,
09/09/2015,SIN.,"ROSARIO, SIN.",1,0,1,0,2,0,
09/09/2015,SIN.,"ANGOSTURA, SIN.",0,1,1,0,0,0,
09/09/2015,SIN.,"CULIACAN, SIN.",1,0,1,0,3,0,
09/09/2015,TLAX.,"TLAX., TLAX.",0,1,1,0,0,0,
09/09/2015,COAH.,"MÚZQUIZ, COAH.",1,0,1,0,1,0,
09/09/2015,MEX.,"TULTITLAN, MEX.",1,0,1,0,0,0,
09/09/2015,GRO.,"ZIHUATANEJO DE AZUETA, GRO.",0,0,0,0,1,52,
09/09/2015,OAX.,"MIAHUATLAN DE PORFIRIO DIAZ, OAX.",0,0,0,4,0,162,
09/09/2015,N.L.,"SANTA CATARINA, N.L.",0,0,0,13,0,0,
09/09/2015,TAMPS.,"EL MANTE, TAMPS.",0,0,0,0,0,282,
09/09/2015,SIN.,"COSALA, SIN.",0,0,0,0,4,0,
09/09/2015,Q. ROO,"OTHON P. BLANCO, Q. ROO",0,0,0,0,1,419,
09/09/2015,COAH.,"SABINAS, COAH.",0,0,0,0,1,0,
09/09/2015,OAX.,"MIAHUATLAN DE PORFIRIO DIAZ, OAX.",0,0,0,4,0,162,
09/09/2015,PUE.,"SAN JERONIMO TECUANIPAN, PUE.",0,0,0,0,0,46,
10/09/2015,D.F.,"TLALPAN, D.F.",38,4,42,0,6,0,
10/09/2015,SIN.,"CHOIX, SIN.",11,12,23,0,3,0,
10/09/2015,B.C.,"MEXICALI, B.C.",10,9,19,0,0,0,
10/09/2015,SIN.,"MAZATLAN, SIN.",15,3,18,0,8,0,
10/09/2015,DGO.,"GOMEZ PALACIO, DGO.",5,3,8,0,0,0,
10/09/2015,B.C.,"TIJUANA, B.C.",7,1,8,0,0,0,
10/09/2015,COAH.,"TORREÓN, COAH.",4,3,7,0,0,32,
10/09/2015,TLAX.,"HUAMANTLA, TLAX.",1,4,5,0,0,0,
10/09/2015,CHIH.,"HGO. DEL PARRAL, CHIH.",3,0,3,0,0,0,
10/09/2015,DGO.,"LERDO, DGO.",0,2,2,0,0,0,
10/09/2015,N.L.,"MONTERREY, N.L.",2,0,2,0,0,2786,
10/09/2015,DGO.,"TLAHUALILO, DGO.",1,0,1,0,0,0,
10/09/2015,N.L.,"GRAL. ESCOBEDO, N.L.",1,0,1,0,0,2850,
10/09/2015,SIN.,"ROSARIO, SIN.",0,1,1,0,0,0,
10/09/2015,SIN.,"SAN IGNACIO, SIN.",1,0,1,1,0,0,
10/09/2015,SIN.,"CULIACAN, SIN.",0,1,1,0,1,0,
10/09/2015,SIN.,"COSALA, SIN.",0,1,1,0,0,0,
10/09/2015,B.C.,"ENSENADA, B.C.",0,1,1,0,0,0,
10/09/2015,MEX.,"CHAPULTEPEC, MEX.",1,0,1,0,0,41,
10/09/2015,OAX.,"MIAHUATLAN DE PORFIRIO DIAZ, OAX.",0,0,0,1,0,78,
10/09/2015,ZAC.,"JEREZ, ZAC.",0,0,0,2,0,0,
10/09/2015,Q. ROO,"OTHON P. BLANCO, Q. ROO",0,0,0,0,0,811,
11/09/2015,D.F.,"MILPA ALTA, D.F.",779,204,983,0,45,3,
11/09/2015,D.F.,"TLALPAN, D.F.",41,5,46,0,6,30,
11/09/2015,SIN.,"CHOIX, SIN.",6,13,19,0,10,0,
11/09/2015,MEX.,"CHALCO, MEX.",9,5,14,0,0,50,
11/09/2015,SIN.,"MAZATLAN, SIN.",10,3,13,0,5,0,
11/09/2015,B.C.,"TIJUANA, B.C.",6,2,8,0,0,0,
11/09/2015,COAH.,"SALTILLO, COAH.",3,5,8,0,1,325,
11/09/2015,SIN.,"ROSARIO, SIN.",2,4,6,0,0,0,
11/09/2015,SIN.,"COSALA, SIN.",1,4,5,0,0,0,
11/09/2015,DGO.,"GOMEZ PALACIO, DGO.",2,3,5,2,0,0,
11/09/2015,COAH.,"PIEDRAS NEGRAS, COAH.",2,2,4,1,0,100,
11/09/2015,MEX.,"TULTITLAN, MEX.",2,2,4,2,2,122,
11/09/2015,CHIH.,"HGO. DEL PARRAL, CHIH.",2,1,3,0,0,11,
11/09/2015,COAH.,"TORREÓN, COAH.",2,1,3,1,0,0,
11/09/2015,DGO.,"DGO., DGO.",1,2,3,0,0,0,
11/09/2015,GRO.,"ZIHUATANEJO DE AZUETA, GRO.",1,2,3,0,0,161,
11/09/2015,MEX.,"TONATICO, MEX.",3,0,3,0,0,0,
11/09/2015,GRO.,"COPANATOYAC, GRO.",2,0,2,0,0,0,
11/09/2015,N.L.,"MONTERREY, N.L.",2,0,2,1,0,0,
11/09/2015,SIN.,"ANGOSTURA, SIN.",1,0,1,0,0,0,
11/09/2015,SIN.,"SAN IGNACIO, SIN.",1,0,1,0,0,0,
11/09/2015,SIN.,"CULIACAN, SIN.",0,1,1,0,29,0,
11/09/2015,TLAX.,"HUAMANTLA, TLAX.",1,0,1,0,0,0,
11/09/2015,OAX.,"MIAHUATLAN DE PORFIRIO DIAZ, OAX.",0,1,1,3,0,479,
11/09/2015,S.L.P.,"RIOVERDE, S.L.P.",1,0,1,0,0,0,
11/09/2015,COAH.,"MONCLOVA, COAH.",1,0,1,0,0,0,
11/09/2015,COAH.,"ACUÑA, COAH.",0,1,1,0,0,0,
11/09/2015,AGS.,"JESÚS MARÍA, AGS.",1,0,1,0,0,0,
11/09/2015,ZAC.,"JEREZ, ZAC.",1,0,1,0,0,0,
11/09/2015,N.L.,"SANTA CATARINA, N.L.",1,0,1,10,0,2500,
11/09/2015,MEX.,"CHAPULTEPEC, MEX.",1,0,1,1,0,0,
11/09/2015,Q. ROO,"OTHON P. BLANCO, Q. ROO",0,0,0,0,0,334,
11/09/2015,SON.,"CAJEME, SON.",0,0,0,0,0,82,
11/09/2015,TAMPS.,"TAMPICO, TAMPS.",0,0,0,0,0,168,
12/09/2015,MEX.,"CHALCO, MEX.",9,1,10,0,4,0,
12/09/2015,N.L.,"MONTERREY, N.L.",3,4,7,1,0,0,
12/09/2015,TLAX.,"HUAMANTLA, TLAX.",3,2,5,0,0,0,
12/09/2015,B.C.,"MEXICALI, B.C.",1,4,5,0,0,0,
12/09/2015,DGO.,"GOMEZ PALACIO, DGO.",2,3,5,0,0,0,
12/09/2015,HGO.,"TOLCAYUCA, HGO.",1,3,4,0,0,380,
12/09/2015,TAMPS.,"MATAMOROS, TAMPS.",3,1,4,0,0,6,
12/09/2015,MEX.,"TONATICO, MEX.",4,0,4,0,0,0,
12/09/2015,B.C.,"TIJUANA, B.C.",3,0,3,0,0,0,
12/09/2015,MEX.,"TULTITLAN, MEX.",2,1,3,1,0,153,
12/09/2015,N.L.,"GRAL. ESCOBEDO, N.L.",2,0,2,0,0,8200,
12/09/2015,DGO.,"LERDO, DGO.",0,2,2,0,0,0,
12/09/2015,DGO.,"TLAHUALILO, DGO.",0,2,2,0,0,0,
12/09/2015,SON.,"CAJEME, SON.",1,0,1,0,0,0,
12/09/2015,MEX.,"CHAPULTEPEC, MEX.",1,0,1,1,0,0,
12/09/2015,ZAC.,"JEREZ, ZAC.",1,0,1,0,0,0,
12/09/2015,B.C.,"ENSENADA, B.C.",1,0,1,0,0,0,
12/09/2015,COAH.,"MONCLOVA, COAH.",1,0,1,0,0,21,
12/09/2015,CHIH.,"CHIH., CHIH.",1,0,1,0,0,0,
12/09/2015,COAH.,"PIEDRAS NEGRAS, COAH.",0,0,0,3,1,0,
13/09/2015,B.C.,"MEXICALI, B.C.",4,1,5,0,0,0,
13/09/2015,N.L.,"MONTERREY, N.L.",2,0,2,22,0,8473,
13/09/2015,CHIH.,"HGO. DEL PARRAL, CHIH.",1,0,1,0,0,0,
13/09/2015,TLAX.,"HUAMANTLA, TLAX.",0,1,1,0,0,0,
13/09/2015,GRO.,"COPANATOYAC, GRO.",1,0,1,0,0,0,
14/09/2015,B.C.,"TIJUANA, B.C.",8,3,11,0,0,0,
14/09/2015,COAH.,"FRONTERA, COAH.",6,3,9,0,0,82,
14/09/2015,COAH.,"SALTILLO, COAH.",6,0,6,2,0,60,
14/09/2015,COAH.,"SABINAS, COAH.",2,2,4,0,0,0,
14/09/2015,DGO.,"LERDO, DGO.",4,0,4,0,0,0,
14/09/2015,TLAX.,"TLAXCO, TLAX.",0,2,2,0,0,0,
14/09/2015,GRO.,"COPANATOYAC, GRO.",2,0,2,0,0,0,
14/09/2015,COAH.,"TORREÓN, COAH.",2,0,2,0,0,0,
14/09/2015,N.L.,"MONTERREY, N.L.",2,0,2,30,0,100,
14/09/2015,OAX.,"MIAHUATLAN DE PORFIRIO DIAZ, OAX.",1,0,1,1,0,37,
14/09/2015,CHIH.,"HGO. DEL PARRAL, CHIH.",1,0,1,0,0,0,
14/09/2015,COAH.,"ACUÑA, COAH.",0,1,1,0,0,0,
14/09/2015,DGO.,"MAPIMI, DGO.",1,0,1,0,0,0,
14/09/2015,SON.,"HERMOSILLO, SON.",0,1,1,0,0,0,
14/09/2015,Q. ROO,"OTHON P. BLANCO, Q. ROO",0,0,0,0,0,364,
14/09/2015,TAB.,"CENTRO, TAB.",0,0,0,0,0,30,
15/09/2015,OAX.,"OAX. DE JUAREZ, OAX.",1,17,18,3,0,56,
15/09/2015,D.F.,"CUAJIMALPA DE MOR., D.F.",6,7,13,0,0,2,
15/09/2015,COAH.,"PIEDRAS NEGRAS, COAH.",3,4,7,0,0,52,
15/09/2015,B.C.,"MEXICALI, B.C.",4,2,6,0,0,0,
15/09/2015,COAH.,"TORREÓN, COAH.",1,4,5,0,0,0,
15/09/2015,CHIH.,"HGO. DEL PARRAL, CHIH.",2,0,2,0,0,0,
15/09/2015,COAH.,"MÚZQUIZ, COAH.",1,1,2,0,0,0,
15/09/2015,B.C.,"TIJUANA, B.C.",0,2,2,0,0,0,
15/09/2015,TLAX.,"TLAXCO, TLAX.",0,1,1,0,0,0,
15/09/2015,B.C.,"ENSENADA, B.C.",0,1,1,0,0,0,
15/09/2015,Q. ROO,"OTHON P. BLANCO, Q. ROO",0,0,0,0,1,199,
15/09/2015,SON.,"CAJEME, SON.",0,0,0,0,0,10,
15/09/2015,N.L.,"MONTERREY, N.L.",0,0,0,0,1,127,
16/09/2015,B.C.,"MEXICALI, B.C.",9,7,16,0,0,0,
16/09/2015,DGO.,"DGO., DGO.",1,4,5,1,0,0,
16/09/2015,B.C.,"ENSENADA, B.C.",3,0,3,0,0,0,
16/09/2015,N.L.,"MONTERREY, N.L.",1,0,1,22,0,100,
16/09/2015,B.C.,"TIJUANA, B.C.",0,1,1,0,0,0,
17/09/2015,D.F.,"CUAJIMALPA DE MOR., D.F.",41,2,43,0,3,0,
17/09/2015,B.C.,"TIJUANA, B.C.",7,5,12,0,0,0,
17/09/2015,COAH.,"SALTILLO, COAH.",9,1,10,0,2,556,
17/09/2015,COAH.,"TORREÓN, COAH.",7,2,9,0,0,0,
17/09/2015,DGO.,"DGO., DGO.",2,4,6,21,0,0,
17/09/2015,COAH.,"MONCLOVA, COAH.",4,0,4,1,0,100,
17/09/2015,QRO.,"QUERETARO, QRO.",1,1,2,0,0,0,
17/09/2015,DGO.,"GOMEZ PALACIO, DGO.",1,1,2,0,0,0,
17/09/2015,COAH.,"SABINAS, COAH.",1,1,2,0,0,0,
17/09/2015,CHIH.,"HGO. DEL PARRAL, CHIH.",2,0,2,0,0,46,
17/09/2015,N.L.,"MONTERREY, N.L.",1,1,2,1,0,90,
17/09/2015,N.L.,"MONTERREY, N.L.",1,1,2,1,0,90,
17/09/2015,DGO.,"TLAHUALILO, DGO.",0,1,1,0,0,0,
17/09/2015,TLAX.,"TLAXCO, TLAX.",1,0,1,0,0,0,
17/09/2015,OAX.,"CIUDAD IXTEPEC, OAX.",1,0,1,0,0,0,
17/09/2015,COAH.,"MÚZQUIZ, COAH.",0,0,0,0,1,0,
17/09/2015,Q. ROO,"OTHON P. BLANCO, Q. ROO",0,0,0,0,0,196,
17/09/2015,OAX.,"MIAHUATLAN DE PORFIRIO DIAZ, OAX.",0,0,0,1,0,18,
18/09/2015,D.F.,"CUAJIMALPA DE MOR., D.F.",30,5,35,0,0,278,
18/09/2015,COAH.,"SALTILLO, COAH.",5,5,10,2,3,260,
18/09/2015,COAH.,"PIEDRAS NEGRAS, COAH.",4,4,8,0,0,0,
18/09/2015,COAH.,"TORREÓN, COAH.",2,5,7,5,0,0,
18/09/2015,B.C.,"MEXICALI, B.C.",4,3,7,0,0,0,
18/09/2015,N.L.,"SAN PEDRO GARZA GARCIA, N.L.",5,1,6,27,0,8900,
18/09/2015,DGO.,"GOMEZ PALACIO, DGO.",3,2,5,0,0,0,
18/09/2015,B.C.,"TIJUANA, B.C.",5,0,5,0,0,0,
18/09/2015,TAMPS.,"TAMPICO, TAMPS.",3,0,3,0,0,430,
18/09/2015,B.C.,"ENSENADA, B.C.",1,2,3,0,0,0,
18/09/2015,COAH.,"MONCLOVA, COAH.",3,0,3,1,1,31,
18/09/2015,COAH.,"SABINAS, COAH.",1,2,3,0,0,0,
18/09/2015,DGO.,"DGO., DGO.",0,2,2,44,0,0,
18/09/2015,AGS.,"JESÚS MARÍA, AGS.",2,0,2,0,0,6,
18/09/2015,VER.,"PUEBLO VIEJO, VER.",1,0,1,0,0,0,
18/09/2015,OAX.,"MIAHUATLAN DE PORFIRIO DIAZ, OAX.",1,0,1,1,0,0,
18/09/2015,TLAX.,"TLAX., TLAX.",0,1,1,0,0,0,
18/09/2015,QRO.,"QUERETARO, QRO.",0,1,1,0,0,0,
18/09/2015,GRO.,"OLINALA, GRO.",1,0,1,0,0,0,
18/09/2015,TAMPS.,"ALTAMIRA, TAMPS.",1,0,1,0,0,33,
18/09/2015,DGO.,"LERDO, DGO.",0,1,1,0,0,0,
18/09/2015,N.L.,"MONTERREY, N.L.",0,1,1,9,0,167,
18/09/2015,COAH.,"MÚZQUIZ, COAH.",0,1,1,0,0,0,
18/09/2015,Q. ROO,"OTHON P. BLANCO, Q. ROO",0,0,0,0,0,100,
18/09/2015,TAB.,"CENTRO, TAB.",0,0,0,0,0,25,
18/09/2015,CHIH.,"HGO. DEL PARRAL, CHIH.",0,0,0,0,0,48,
18/09/2015,PUE.,"PUE., PUE.",0,0,0,0,6,38,
18/09/2015,CHIH.,"CHIH., CHIH.",0,0,0,0,0,18,
19/09/2015,GRO.,"OLINALA, GRO.",2,2,4,0,0,0,
19/09/2015,DGO.,"GOMEZ PALACIO, DGO.",2,0,2,0,0,0,
19/09/2015,TLAX.,"TLAX., TLAX.",0,1,1,0,0,0,
19/09/2015,DGO.,"TLAHUALILO, DGO.",0,1,1,0,0,0,
19/09/2015,N.L.,"MONTERREY, N.L.",1,0,1,50,0,0,
19/09/2015,QRO.,"QUERETARO, QRO.",1,0,1,0,0,0,
19/09/2015,CHIS.,"TAPACHULA, CHIS.",0,0,0,0,0,100,
19/09/2015,N.L.,"SAN PEDRO GARZA GARCIA, N.L.",0,0,0,45,0,4750,
19/09/2015,CHIH.,"HGO. DEL PARRAL, CHIH.",0,0,0,0,0,48,
19/09/2015,TAB.,"CENTRO, TAB.",0,0,0,0,1,0,
19/09/2015,Q. ROO,"OTHON P. BLANCO, Q. ROO",0,0,0,0,0,140,
20/09/2015,DGO.,"DGO., DGO.",0,5,5,0,0,0,
20/09/2015,QRO.,"QUERETARO, QRO.",1,1,2,0,0,0,
20/09/2015,TLAX.,"TLAX., TLAX.",1,0,1,1,0,3,
20/09/2015,N.L.,"MONTERREY, N.L.",0,1,1,2,0,1065,
20/09/2015,QRO.,"QUERETARO, QRO.",1,0,1,0,1,0,
20/09/2015,N.L.,"SAN PEDRO GARZA GARCIA, N.L.",0,0,0,0,0,5850,
21/09/2015,D.F.,"CUAJIMALPA DE MOR., D.F.",44,6,50,0,4,0,
21/09/2015,DGO.,"DGO., DGO.",2,9,11,5,0,0,
21/09/2015,COAH.,"TORREÓN, COAH.",7,3,10,0,0,0,
21/09/2015,COAH.,"SALTILLO, COAH.",7,1,8,0,0,12,
21/09/2015,COAH.,"MONCLOVA, COAH.",5,3,8,1,0,11,
21/09/2015,SIN.,"MAZATLAN, SIN.",4,4,8,0,7,0,
21/09/2015,SIN.,"CHOIX, SIN.",3,5,8,0,0,0,
21/09/2015,MEX.,"TLALMANALCO, MEX.",6,1,7,0,4,31,
21/09/2015,MEX.,"TEZOYUCA, MEX.",4,2,6,0,4,0,
21/09/2015,B.C.,"TIJUANA, B.C.",5,0,5,0,0,0,
21/09/2015,COAH.,"SABINAS, COAH.",2,2,4,0,0,0,
21/09/2015,MEX.,"TENANCINGO, MEX.",1,2,3,1,0,0,
21/09/2015,VER.,"PAPANTLA, VER.",1,1,2,0,0,100,
21/09/2015,DGO.,"GOMEZ PALACIO, DGO.",0,2,2,0,0,0,
21/09/2015,DGO.,"LERDO, DGO.",1,1,2,0,0,0,
21/09/2015,QRO.,"QUERETARO, QRO.",2,0,2,0,0,0,
21/09/2015,TAMPS.,"MIGUEL ALEMAN, TAMPS.",1,1,2,0,0,0,
21/09/2015,MEX.,"TENANGO DEL VALLE, MEX.",1,1,2,1,0,40,
21/09/2015,TLAX.,"TLAXCO, TLAX.",1,0,1,0,0,0,
21/09/2015,GRO.,"BENITO JUAREZ, GRO.",1,0,1,0,0,30,
21/09/2015,GRO.,"OLINALA, GRO.",0,1,1,0,0,0,
21/09/2015,COAH.,"ACUÑA, COAH.",1,0,1,0,0,0,
21/09/2015,SIN.,"SAN IGNACIO, SIN.",1,0,1,0,0,0,
21/09/2015,SIN.,"COSALA, SIN.",0,1,1,0,0,0,
21/09/2015,PUE.,"PUE., PUE.",0,0,0,0,0,202,
21/09/2015,OAX.,"MIAHUATLAN DE PORFIRIO DIAZ, OAX.",0,0,0,1,0,15,
21/09/2015,N.L.,"SAN PEDRO GARZA GARCIA, N.L.",0,0,0,16,0,0,
22/09/2015,D.F.,"CUAJIMALPA DE MOR., D.F.",49,10,59,0,2,0,
22/09/2015,SIN.,"MAZATLAN, SIN.",12,3,15,0,2,0,
22/09/2015,B.C.,"MEXICALI, B.C.",5,6,11,0,0,0,
22/09/2015,SIN.,"CHOIX, SIN.",5,4,9,0,0,0,
22/09/2015,MEX.,"TENANCINGO, MEX.",8,1,9,0,0,100,
22/09/2015,MEX.,"TLALMANALCO, MEX.",8,0,8,0,1,210,
22/09/2015,COAH.,"PIEDRAS NEGRAS, COAH.",3,4,7,5,0,49,
22/09/2015,QRO.,"QUERETARO, QRO.",4,3,7,0,1,0,
22/09/2015,B.C.,"TIJUANA, B.C.",2,4,6,0,0,0,
22/09/2015,SIN.,"CULIACAN, SIN.",5,1,6,0,18,0,
22/09/2015,MEX.,"TEZOYUCA, MEX.",4,1,5,0,0,0,
22/09/2015,COAH.,"MONCLOVA, COAH.",4,0,4,1,0,38,
22/09/2015,COAH.,"SALTILLO, COAH.",2,1,3,2,3,0,
22/09/2015,COAH.,"SABINAS, COAH.",2,1,3,0,0,0,
22/09/2015,COAH.,"TORREÓN, COAH.",3,0,3,0,0,0,
22/09/2015,B.C.,"ENSENADA, B.C.",1,2,3,0,0,0,
22/09/2015,SIN.,"ANGOSTURA, SIN.",1,2,3,0,0,0,
22/09/2015,SIN.,"SAN IGNACIO, SIN.",1,2,3,1,0,0,
22/09/2015,CHIH.,"HGO. DEL PARRAL, CHIH.",1,2,3,0,0,48,
22/09/2015,MEX.,"TENANGO DEL VALLE, MEX.",2,0,2,1,0,0,
22/09/2015,TLAX.,"TLAXCO, TLAX.",1,1,2,0,0,0,
22/09/2015,COAH.,"MÚZQUIZ, COAH.",1,0,1,0,0,0,
22/09/2015,COAH.,"ACUÑA, COAH.",0,1,1,0,0,0,
22/09/2015,TLAX.,"TLAX., TLAX.",1,0,1,0,0,0,
22/09/2015,GRO.,"BENITO JUAREZ, GRO.",0,0,0,0,6,0,
22/09/2015,OAX.,"MIAHUATLAN DE PORFIRIO DIAZ, OAX.",0,0,0,2,0,25,
22/09/2015,CHIS.,"TAPACHULA, CHIS.",0,0,0,0,0,45,
22/09/2015,QRO.,"QUERETARO, QRO.",0,0,0,0,1,0,
23/09/2015,D.F.,"CUAJIMALPA DE MOR., D.F.",48,7,55,0,0,0,
23/09/2015,SIN.,"CHOIX, SIN.",24,8,32,0,0,0,
23/09/2015,B.C.,"TIJUANA, B.C.",6,3,9,0,0,0,
23/09/2015,COAH.,"PIEDRAS NEGRAS, COAH.",6,1,7,0,0,255,
23/09/2015,COAH.,"SALTILLO, COAH.",4,3,7,0,1,398,
23/09/2015,QRO.,"QUERETARO, QRO.",1,5,6,0,0,0,
23/09/2015,DGO.,"GOMEZ PALACIO, DGO.",3,3,6,0,0,0,
23/09/2015,SIN.,"MAZATLAN, SIN.",5,0,5,0,5,0,
23/09/2015,DGO.,"DGO., DGO.",2,3,5,3,0,0,
23/09/2015,MEX.,"TENANCINGO, MEX.",4,1,5,4,0,0,
23/09/2015,CHIH.,"HGO. DEL PARRAL, CHIH.",3,2,5,0,0,44,
23/09/2015,HGO.,"TOLCAYUCA, HGO.",1,3,4,0,0,380,
23/09/2015,COAH.,"SABINAS, COAH.",1,3,4,0,0,0,
23/09/2015,MEX.,"TENANGO DEL VALLE, MEX.",2,2,4,0,0,0,
23/09/2015,TAMPS.,"TAMPICO, TAMPS.",3,1,4,0,0,564,
23/09/2015,TAMPS.,"CIUDAD MADERO, TAMPS.",3,1,4,0,0,0,
23/09/2015,COAH.,"TORREÓN, COAH.",2,1,3,0,0,0,
23/09/2015,AGS.,"JESÚS MARÍA, AGS.",3,0,3,3,0,90,
23/09/2015,N.L.,"SAN PEDRO GARZA GARCIA, N.L.",2,0,2,30,0,1100,
23/09/2015,SIN.,"ROSARIO, SIN.",1,1,2,0,1,0,
23/09/2015,SIN.,"SAN IGNACIO, SIN.",0,2,2,0,0,0,
23/09/2015,SIN.,"CULIACAN, SIN.",2,0,2,0,17,0,
23/09/2015,B.C.,"ENSENADA, B.C.",1,1,2,0,0,0,
23/09/2015,MEX.,"TLALMANALCO, MEX.",1,1,2,0,0,181,
23/09/2015,SIN.,"ANGOSTURA, SIN.",1,0,1,0,0,0,
23/09/2015,TLAX.,"TLAX., TLAX.",1,0,1,1,0,0,
23/09/2015,TLAX.,"TLAXCO, TLAX.",1,0,1,0,0,0,
23/09/2015,COAH.,"MONCLOVA, COAH.",1,0,1,0,0,40,
23/09/2015,COAH.,"ACUÑA, COAH.",1,0,1,0,0,0,
23/09/2015,DGO.,"LERDO, DGO.",0,1,1,0,0,0,
23/09/2015,DGO.,"TLAHUALILO, DGO.",1,0,1,0,0,0,
23/09/2015,MEX.,"TEZOYUCA, MEX.",1,0,1,0,0,0,
23/09/2015,OAX.,"MIAHUATLAN DE PORFIRIO DIAZ, OAX.",0,0,0,0,0,35,
23/09/2015,QRO.,"QUERETARO, QRO.",0,0,0,0,0,0,
24/09/2015,D.F.,"CUAJIMALPA DE MOR., D.F.",51,4,55,0,0,0,
24/09/2015,MEX.,"TEZOYUCA, MEX.",11,2,13,0,0,0,
24/09/2015,SIN.,"MAZATLAN, SIN.",10,2,12,0,3,0,
24/09/2015,MEX.,"TENANGO DEL VALLE, MEX.",7,3,10,3,0,0,
24/09/2015,DGO.,"LERDO, DGO.",3,3,6,0,0,0,
24/09/2015,N.L.,"ABASOLO, N.L.",4,2,6,0,0,0,
24/09/2015,COAH.,"PIEDRAS NEGRAS, COAH.",3,2,5,0,6,30,
24/09/2015,QRO.,"QUERETARO, QRO.",3,2,5,0,0,0,
24/09/2015,COAH.,"SALTILLO, COAH.",1,3,4,0,4,497,
24/09/2015,MEX.,"TENANCINGO, MEX.",2,2,4,0,0,0,
24/09/2015,COAH.,"SABINAS, COAH.",3,0,3,0,0,0,
24/09/2015,COAH.,"MONCLOVA, COAH.",2,1,3,0,0,64,
24/09/2015,MEX.,"TLALMANALCO, MEX.",2,0,2,0,0,0,
24/09/2015,COAH.,"TORREÓN, COAH.",1,1,2,0,0,0,
24/09/2015,DGO.,"TLAHUALILO, DGO.",0,2,2,0,0,0,
24/09/2015,SIN.,"ROSARIO, SIN.",0,1,1,0,0,0,
24/09/2015,SIN.,"ANGOSTURA, SIN.",0,1,1,0,0,0,
24/09/2015,COAH.,"ACUÑA, COAH.",0,1,1,0,0,2,
24/09/2015,VER.,"PUEBLO VIEJO, VER.",1,0,1,0,0,0,
24/09/2015,TLAX.,"TLAX., TLAX.",1,0,1,0,0,0,
25/09/2015,D.F.,"CUAJIMALPA DE MOR., D.F.",52,7,59,0,0,0,
25/09/2015,B.C.S.,"LA PAZ, B.C.S.",7,4,11,0,0,0,
25/09/2015,SIN.,"MAZATLAN, SIN.",9,2,11,0,8,0,
25/09/2015,COAH.,"SALTILLO, COAH.",3,4,7,1,1,72,
25/09/2015,MEX.,"TLALMANALCO, MEX.",3,3,6,0,0,0,
25/09/2015,QRO.,"QUERETARO, QRO.",3,2,5,0,0,0,
25/09/2015,COAH.,"PIEDRAS NEGRAS, COAH.",1,4,5,0,0,200,
25/09/2015,SIN.,"CULIACAN, SIN.",2,3,5,0,13,0,
25/09/2015,B.C.,"MEXICALI, B.C.",1,3,4,0,0,0,
25/09/2015,MEX.,"TENANGO DEL VALLE, MEX.",3,0,3,2,0,0,
25/09/2015,B.C.,"TIJUANA, B.C.",1,2,3,0,0,0,
25/09/2015,B.C.,"ENSENADA, B.C.",0,3,3,0,0,0,
25/09/2015,MEX.,"TEZOYUCA, MEX.",1,2,3,0,1,0,
25/09/2015,DGO.,"DGO., DGO.",2,0,2,1,1,0,
25/09/2015,CHIH.,"HGO. DEL PARRAL, CHIH.",0,2,2,0,0,0,
25/09/2015,DGO.,"TLAHUALILO, DGO.",1,1,2,0,0,0,
25/09/2015,COAH.,"SABINAS, COAH.",1,1,2,0,1,0,
25/09/2015,COAH.,"ACUÑA, COAH.",1,1,2,0,0,129,
25/09/2015,MEX.,"TENANCINGO, MEX.",2,0,2,0,0,96,
25/09/2015,SIN.,"ROSARIO, SIN.",2,0,2,0,0,0,
25/09/2015,OAX.,"SALINA CRUZ, OAX.",1,0,1,0,0,0,
25/09/2015,VER.,"ALVARADO, VER.",1,0,1,0,0,0,
25/09/2015,GRO.,"ARCELIA, GRO.",1,0,1,0,0,0,
25/09/2015,COL.,"COL., COL.",1,0,1,0,1,4,
25/09/2015,ZAC.,"JEREZ, ZAC.",1,0,1,0,0,0,
25/09/2015,DGO.,"GOMEZ PALACIO, DGO.",1,0,1,0,0,0,
25/09/2015,COAH.,"MONCLOVA, COAH.",1,0,1,0,0,0,
25/09/2015,SON.,"HERMOSILLO, SON.",1,0,1,39,0,0,
25/09/2015,SIN.,"ANGOSTURA, SIN.",0,1,1,0,0,0,
25/09/2015,SIN.,"SAN IGNACIO, SIN.",0,1,1,0,0,0,
25/09/2015,AGS.,"JESÚS MARÍA, AGS.",0,0,0,2,0,8,
25/09/2015,COAH.,"MÚZQUIZ, COAH.",0,0,0,0,1,0,
25/09/2015,TAMPS.,"NUEVO LAREDO, TAMPS.",0,0,0,3,0,28,
25/09/2015,PUE.,"PUE., PUE.",0,0,0,1,2,105,
25/09/2015,TAB.,"HUIMANGUILLO, TAB.",0,0,0,0,1,0,
26/09/2015,B.C.,"MEXICALI, B.C.",3,9,12,0,0,0,
26/09/2015,MEX.,"TEZOYUCA, MEX.",3,2,5,0,0,0,
26/09/2015,B.C.,"TIJUANA, B.C.",4,0,4,0,0,0,
26/09/2015,MEX.,"TENANCINGO, MEX.",2,1,3,0,0,0,
26/09/2015,TLAX.,"TLAX., TLAX.",1,2,3,1,0,0,
26/09/2015,VER.,"PUEBLO VIEJO, VER.",1,1,2,1,0,2,
26/09/2015,SON.,"CAJEME, SON.",1,0,1,0,0,0,
26/09/2015,MEX.,"TENANGO DEL VALLE, MEX.",0,1,1,0,1,0,
26/09/2015,TAMPS.,"ALTAMIRA, TAMPS.",1,0,1,0,0,58,
26/09/2015,TLAX.,"TLAXCO, TLAX.",1,0,1,0,0,0,
26/09/2015,COAH.,"MONCLOVA, COAH.",1,0,1,1,0,27,
26/09/2015,TAMPS.,"MATAMOROS, TAMPS.",0,0,0,0,1,0,
26/09/2015,N.L.,"SAN PEDRO GARZA GARCIA, N.L.",0,0,0,40,0,1800,
27/09/2015,DGO.,"DGO., DGO.",4,1,5,2,0,0,
27/09/2015,CHIH.,"HGO. DEL PARRAL, CHIH.",1,0,1,0,0,0,
28/09/2015,D.F.,"AZCAPOTZALCO, D.F.",45,12,57,0,0,120,
28/09/2015,SIN.,"EL FUERTE, SIN.",6,3,9,0,6,0,
28/09/2015,MEX.,"OCOYOACAC, MEX.",5,4,9,4,0,0,
28/09/2015,SIN.,"BADIRAGUATO, SIN.",5,3,8,0,0,0,
28/09/2015,B.C.,"TIJUANA, B.C.",5,2,7,0,0,0,
28/09/2015,TAB.,"BALANCAN, TAB.",2,4,6,0,0,0,
28/09/2015,MEX.,"TEPOTZOTLAN, MEX.",5,0,5,0,0,0,
28/09/2015,MEX.,"TEOLOYUCAN, MEX.",3,0,3,0,0,416,
28/09/2015,GRO.,"FLORENCIO VILLARREAL, GRO.",1,1,2,0,0,0,
28/09/2015,TLAX.,"TLAX., TLAX.",1,1,2,0,0,0,
28/09/2015,TLAX.,"NATIVITAS, TLAX.",2,0,2,0,0,0,
28/09/2015,DGO.,"DGO., DGO.",1,1,2,0,0,0,
28/09/2015,SIN.,"ELOTA, SIN.",0,1,1,0,10,0,
28/09/2015,MEX.,"NICOLAS ROMERO, MEX.",0,1,1,1,0,0,
28/09/2015,CHIS.,"BENEMÉRITO DE LAS AMÉRICAS, CHIS.",1,0,1,0,0,0,
28/09/2015,N.L.,"SAN PEDRO GARZA GARCIA, N.L.",0,0,0,4,0,350,
28/09/2015,CHIH.,"HGO. DEL PARRAL, CHIH.",0,0,0,0,0,24,
29/09/2015,D.F.,"AZCAPOTZALCO, D.F.",47,10,57,0,4,48,
29/09/2015,COAH.,"MONCLOVA, COAH.",3,9,12,6,0,151,
29/09/2015,SIN.,"EL FUERTE, SIN.",6,6,12,0,7,0,
29/09/2015,COAH.,"PIEDRAS NEGRAS, COAH.",3,3,6,0,0,0,
29/09/2015,B.C.,"TIJUANA, B.C.",4,2,6,0,0,0,
29/09/2015,B.C.,"MEXICALI, B.C.",1,5,6,0,0,0,
29/09/2015,MEX.,"TEOLOYUCAN, MEX.",4,2,6,0,0,201,
29/09/2015,COAH.,"SALTILLO, COAH.",4,1,5,5,3,149,
29/09/2015,HGO.,"TULANCINGO DE BRAVO, HGO.",2,2,4,0,0,0,
29/09/2015,SIN.,"ESCUINAPA, SIN.",1,3,4,0,0,0,
29/09/2015,COAH.,"TORREÓN, COAH.",2,0,2,0,0,0,
29/09/2015,COAH.,"ACUÑA, COAH.",1,1,2,0,0,0,
29/09/2015,SIN.,"BADIRAGUATO, SIN.",1,1,2,0,0,0,
29/09/2015,SIN.,"NAVOLATO, SIN.",1,1,2,0,2,0,
29/09/2015,CHIH.,"HGO. DEL PARRAL, CHIH.",1,0,1,0,0,0,
29/09/2015,VER.,"TANTOYUCA, VER.",0,1,1,0,0,0,
29/09/2015,TLAX.,"NATIVITAS, TLAX.",0,1,1,0,0,0,
29/09/2015,DGO.,"DGO., DGO.",1,0,1,0,0,0,
29/09/2015,GRO.,"FLORENCIO VILLARREAL, GRO.",1,0,1,0,0,0,
29/09/2015,COAH.,"RAMOS ARIZPE, COAH.",1,0,1,0,0,0,
29/09/2015,SIN.,"ELOTA, SIN.",1,0,1,0,6,0,
29/09/2015,B.C.,"ENSENADA, B.C.",1,0,1,0,0,0,
29/09/2015,MEX.,"OCOYOACAC, MEX.",0,1,1,1,0,0,
29/09/2015,TAMPS.,"MATAMOROS, TAMPS.",0,1,1,0,0,0,
29/09/2015,N.L.,"SAN PEDRO GARZA GARCIA, N.L.",0,0,0,5,0,1100,
29/09/2015,N.L.,"ABASOLO, N.L.",0,0,0,7,0,0,
29/09/2015,PUE.,"PUE., PUE.",0,0,0,0,3,0,
29/09/2015,MEX.,"NICOLAS ROMERO, MEX.",0,0,0,0,9,0,
30/09/2015,D.F.,"AZCAPOTZALCO, D.F.",51,7,58,0,0,37,
30/09/2015,B.C.,"MEXICALI, B.C.",23,25,48,0,0,0,
30/09/2015,SIN.,"EL FUERTE, SIN.",21,11,32,0,4,0,
30/09/2015,COAH.,"SALTILLO, COAH.",10,2,12,0,1,76,
30/09/2015,SIN.,"BADIRAGUATO, SIN.",6,5,11,0,0,0,
30/09/2015,B.C.,"MEXICALI, B.C.",4,6,10,0,0,0,
30/09/2015,B.C.,"TIJUANA, B.C.",3,3,6,0,0,0,
30/09/2015,MEX.,"NICOLAS ROMERO, MEX.",5,1,6,0,12,0,
30/09/2015,TAMPS.,"TAMPICO, TAMPS.",3,2,5,1,0,311,
30/09/2015,COAH.,"TORREÓN, COAH.",4,1,5,4,0,0,
30/09/2015,DGO.,"DGO., DGO.",4,0,4,0,0,0,
30/09/2015,COAH.,"PIEDRAS NEGRAS, COAH.",3,1,4,3,0,0,
30/09/2015,SIN.,"ELOTA, SIN.",2,1,3,0,6,0,
30/09/2015,SIN.,"NAVOLATO, SIN.",2,1,3,0,10,26,
30/09/2015,B.C.,"ENSENADA, B.C.",1,2,3,0,0,0,
30/09/2015,MEX.,"OCOYOACAC, MEX.",3,0,3,0,0,11,
30/09/2015,SIN.,"ESCUINAPA, SIN.",0,2,2,0,0,0,
30/09/2015,COAH.,"MONCLOVA, COAH.",1,1,2,0,0,53,
30/09/2015,COAH.,"SABINAS, COAH.",1,1,2,0,0,0,
30/09/2015,MEX.,"TEOLOYUCAN, MEX.",1,1,2,0,0,0,
30/09/2015,GRO.,"FLORENCIO VILLARREAL, GRO.",1,0,1,0,0,0,
30/09/2015,TLAX.,"TLAX., TLAX.",1,0,1,0,0,0,
30/09/2015,TAB.,"BALANCAN, TAB.",0,1,1,0,0,0,
30/09/2015,HGO.,"TULANCINGO DE BRAVO, HGO.",0,1,1,0,0,0,
30/09/2015,COAH.,"ACUÑA, COAH.",0,1,1,0,0,0,
30/09/2015,MEX.,"TEPOTZOTLAN, MEX.",1,0,1,0,0,0,
30/09/2015,TAB.,"HUIMANGUILLO, TAB.",1,0,1,0,0,0,
30/09/2015,PUE.,"PUE., PUE.",0,0,0,0,0,361,
01/10/2015,D.F.,"AZCAPOTZALCO, D.F.",43,3,46,0,1,0,
01/10/2015,SIN.,"EL FUERTE, SIN.",10,6,16,0,4,0,
01/10/2015,B.C.,"TIJUANA, B.C.",7,7,14,0,0,0,
01/10/2015,TAMPS.,"CIUDAD MADERO, TAMPS.",6,1,7,2,1,702,
01/10/2015,B.C.,"MEXICALI, B.C.",2,4,6,0,0,0,
01/10/2015,SIN.,"BADIRAGUATO, SIN.",3,2,5,0,0,0,
01/10/2015,SIN.,"ESCUINAPA, SIN.",1,2,3,0,0,0,
01/10/2015,B.C.,"ENSENADA, B.C.",3,0,3,0,0,0,
01/10/2015,MEX.,"NICOLAS ROMERO, MEX.",1,1,2,1,10,0,
01/10/2015,MEX.,"OCOYOACAC, MEX.",2,0,2,2,0,70,
01/10/2015,SIN.,"NAVOLATO, SIN.",1,1,2,0,10,0,
01/10/2015,MEX.,"TEOLOYUCAN, MEX.",2,0,2,0,1,0,
01/10/2015,SIN.,"ELOTA, SIN.",0,1,1,0,0,0,
01/10/2015,MEX.,"TEPOTZOTLAN, MEX.",1,0,1,0,0,0,
02/10/2015,D.F.,"AZCAPOTZALCO, D.F.",49,7,56,0,0,0,
02/10/2015,D.F.,"AZCAPOTZALCO, D.F.",49,7,56,0,0,0,
02/10/2015,TAMPS.,"TAMPICO, TAMPS.",10,9,19,43,4,552,
02/10/2015,SIN.,"EL FUERTE, SIN.",11,7,18,0,6,0,
02/10/2015,SIN.,"BADIRAGUATO, SIN.",5,3,8,0,0,0,
02/10/2015,B.C.,"TIJUANA, B.C.",5,3,8,0,0,0,
02/10/2015,COAH.,"SALTILLO, COAH.",6,2,8,1,1,121,
02/10/2015,COAH.,"TORREÓN, COAH.",7,0,7,0,0,0,
02/10/2015,COAH.,"MONCLOVA, COAH.",3,2,5,0,0,177,
02/10/2015,DGO.,"DGO., DGO.",1,2,3,0,0,0,
02/10/2015,GRO.,"FLORENCIO VILLARREAL, GRO.",2,1,3,0,0,0,
02/10/2015,HGO.,"TULANCINGO DE BRAVO, HGO.",1,1,2,0,0,0,
02/10/2015,B.C.,"ENSENADA, B.C.",0,2,2,0,0,0,
02/10/2015,B.C.,"MEXICALI, B.C.",1,1,2,0,0,0,
02/10/2015,GRO.,"SAN MIGUEL TOTOLAPAN, GRO.",0,1,1,0,0,0,
02/10/2015,SIN.,"ESCUINAPA, SIN.",0,1,1,0,0,0,
02/10/2015,SIN.,"NAVOLATO, SIN.",0,1,1,0,11,0,
02/10/2015,DGO.,"LERDO, DGO.",0,1,1,0,1,0,
02/10/2015,SON.,"HERMOSILLO, SON.",1,0,1,2,0,0,
02/10/2015,TLAX.,"TLAX., TLAX.",1,0,1,0,0,0,
02/10/2015,COAH.,"PIEDRAS NEGRAS, COAH.",0,1,1,0,0,0,
02/10/2015,COAH.,"RAMOS ARIZPE, COAH.",0,1,1,0,0,0,
02/10/2015,PUE.,"PUE., PUE.",0,0,0,2,0,480,
03/10/2015,MEX.,"TEOLOYUCAN, MEX.",2,2,4,0,0,0,
03/10/2015,COAH.,"PIEDRAS NEGRAS, COAH.",0,3,3,6,0,220,
03/10/2015,B.C.,"MEXICALI, B.C.",1,1,2,0,0,0,
03/10/2015,MEX.,"OCOYOACAC, MEX.",1,1,2,0,0,0,
03/10/2015,HGO.,"HUICHAPAN, HGO.",0,1,1,0,0,0,
03/10/2015,TLAX.,"ZACATELCO, TLAX.",0,1,1,0,0,0,
03/10/2015,MEX.,"TEPOTZOTLAN, MEX.",1,0,1,0,0,0,
03/10/2015,N.L.,"ABASOLO, N.L.",1,0,1,6,0,0,
03/10/2015,GRO.,"SAN MIGUEL TOTOLAPAN, GRO.",0,1,1,0,0,0,
03/10/2015,TAB.,"HUIMANGUILLO, TAB.",0,0,0,0,0,50,
04/10/2015,DGO.,"DGO., DGO.",2,2,4,0,0,0,
04/10/2015,TLAX.,"ZACATELCO, TLAX.",1,2,3,0,0,0,
04/10/2015,TLAX.,"TLAX., TLAX.",1,0,1,0,0,0,
04/10/2015,GRO.,"SAN MIGUEL TOTOLAPAN, GRO.",0,1,1,0,0,0,
04/10/2015,GRO.,"HUAMUXTITLAN, GRO.",1,0,1,0,0,0,
05/10/2015,D.F.,"AZCAPOTZALCO, D.F.",45,8,53,0,5,12,
05/10/2015,MEX.,"ECATEPEC DE MOR., MEX.",12,3,15,0,0,100,
05/10/2015,SIN.,"EL FUERTE, SIN.",11,1,12,0,5,0,
05/10/2015,COAH.,"SALTILLO, COAH.",5,3,8,5,1,397,
05/10/2015,MEX.,"TIANGUISTENCO, MEX.",6,0,6,0,0,0,
05/10/2015,DGO.,"GOMEZ PALACIO, DGO.",3,2,5,0,0,0,
05/10/2015,SIN.,"ESCUINAPA, SIN.",3,2,5,0,0,0,
05/10/2015,SIN.,"BADIRAGUATO, SIN.",0,4,4,0,0,0,
05/10/2015,DGO.,"TLAHUALILO, DGO.",0,3,3,0,0,0,
05/10/2015,SIN.,"NAVOLATO, SIN.",2,1,3,0,0,0,
05/10/2015,COAH.,"PIEDRAS NEGRAS, COAH.",2,1,3,0,0,13,
05/10/2015,COAH.,"MONCLOVA, COAH.",2,1,3,1,0,8,
05/10/2015,VER.,"IGNACIO DE LA LLAVE, VER.",0,2,2,0,0,0,
05/10/2015,COAH.,"TORREÓN, COAH.",2,0,2,0,0,0,
05/10/2015,COAH.,"ACUÑA, COAH.",0,2,2,0,0,0,
05/10/2015,SIN.,"ELOTA, SIN.",0,1,1,0,0,0,
05/10/2015,COAH.,"SABINAS, COAH.",1,0,1,0,0,0,
05/10/2015,DGO.,"DGO., DGO.",1,0,1,1,0,0,
05/10/2015,S.L.P.,"SAN LUIS POTOSI, S.L.P.",0,0,0,0,0,16,
06/10/2015,D.F.,"AZCAPOTZALCO, D.F.",48,4,52,0,0,55,
06/10/2015,COAH.,"SALTILLO, COAH.",6,3,9,1,1,88,
06/10/2015,SIN.,"EL FUERTE, SIN.",5,2,7,0,3,0,
06/10/2015,B.C.,"TIJUANA, B.C.",4,3,7,0,0,0,
06/10/2015,MEX.,"TONANITLA, MEX.",5,1,6,0,0,100,
06/10/2015,SIN.,"NAVOLATO, SIN.",2,2,4,0,0,0,
06/10/2015,HGO.,"TULANCINGO DE BRAVO, HGO.",0,3,3,0,0,50,
06/10/2015,SIN.,"ESCUINAPA, SIN.",2,1,3,0,0,0,
06/10/2015,COAH.,"MONCLOVA, COAH.",1,2,3,0,0,264,
06/10/2015,MEX.,"ECATEPEC DE MOR., MEX.",3,0,3,0,0,15,
06/10/2015,GRO.,"SAN MIGUEL TOTOLAPAN, GRO.",1,1,2,0,0,0,
06/10/2015,DGO.,"DGO., DGO.",2,0,2,6,0,0,
06/10/2015,VER.,"IGNACIO DE LA LLAVE, VER.",0,2,2,0,0,261,
06/10/2015,COAH.,"PIEDRAS NEGRAS, COAH.",2,0,2,0,1,180,
06/10/2015,OAX.,"CIUDAD IXTEPEC, OAX.",1,0,1,1,0,7,
06/10/2015,SIN.,"BADIRAGUATO, SIN.",0,1,1,0,0,0,
06/10/2015,GRO.,"HUAMUXTITLAN, GRO.",1,0,1,0,0,0,
06/10/2015,SON.,"CAJEME, SON.",1,0,1,0,0,0,
06/10/2015,COAH.,"TORREÓN, COAH.",1,0,1,0,0,0,
06/10/2015,TLAX.,"APIZACO, TLAX.",0,1,1,0,0,0,
06/10/2015,TLAX.,"ZACATELCO, TLAX.",1,0,1,0,0,0,
06/10/2015,N.L.,"ANAHUAC, N.L.",0,0,0,1,0,100,
07/10/2015,D.F.,"AZCAPOTZALCO, D.F.",50,5,55,0,2,25,
07/10/2015,SIN.,"EL FUERTE, SIN.",16,4,20,0,3,0,
07/10/2015,MEX.,"ECATEPEC DE MOR., MEX.",12,0,12,0,0,523,
07/10/2015,COAH.,"PIEDRAS NEGRAS, COAH.",4,3,7,1,0,49,
07/10/2015,SIN.,"BADIRAGUATO, SIN.",3,3,6,0,1,0,
07/10/2015,COAH.,"TORREÓN, COAH.",5,1,6,0,0,0,
07/10/2015,COAH.,"SALTILLO, COAH.",3,2,5,1,1,50,
07/10/2015,B.C.,"MEXICALI, B.C.",0,3,3,0,0,0,
07/10/2015,SIN.,"ELOTA, SIN.",2,0,2,0,0,0,
07/10/2015,COAH.,"ACUÑA, COAH.",1,1,2,0,0,0,
07/10/2015,B.C.,"TIJUANA, B.C.",2,0,2,0,0,0,
07/10/2015,COAH.,"MONCLOVA, COAH.",1,0,1,1,0,6,
07/10/2015,VER.,"IGNACIO DE LA LLAVE, VER.",1,0,1,0,0,0,
07/10/2015,VER.,"MARTINEZ DE LA TORRE, VER.",1,0,1,0,0,0,
07/10/2015,ZAC.,"ZAC., ZAC.",0,1,1,0,0,0,
07/10/2015,CHIH.,"OJINAGA, CHIH.",1,0,1,0,0,0,
07/10/2015,SON.,"HERMOSILLO, SON.",1,0,1,0,0,0,
07/10/2015,COL.,"COL., COL.",1,0,1,0,0,0,
07/10/2015,MEX.,"TONANITLA, MEX.",0,1,1,0,0,0,
07/10/2015,SIN.,"ESCUINAPA, SIN.",0,0,0,0,5,0,
07/10/2015,N.L.,"SAN NICOLAS DE LOS GARZA, N.L.",0,0,0,24,0,0,
08/10/2015,D.F.,"AZCAPOTZALCO, D.F.",45,4,49,0,1,8,
08/10/2015,MEX.,"ECATEPEC DE MOR., MEX.",8,1,9,2,3,885,
08/10/2015,COAH.,"SALTILLO, COAH.",5,2,7,0,3,55,
08/10/2015,B.C.,"TIJUANA, B.C.",7,0,7,0,0,0,
08/10/2015,HGO.,"TULANCINGO DE BRAVO, HGO.",4,2,6,0,0,0,
08/10/2015,MEX.,"TIANGUISTENCO, MEX.",6,0,6,5,1,0,
08/10/2015,COAH.,"MONCLOVA, COAH.",2,1,3,1,0,0,
08/10/2015,COL.,"COL., COL.",1,1,2,0,0,0,
08/10/2015,COAH.,"TORREÓN, COAH.",2,0,2,0,0,0,
08/10/2015,TAMPS.,"CIUDAD MADERO, TAMPS.",2,0,2,0,0,519,
08/10/2015,CHIH.,"HGO. DEL PARRAL, CHIH.",1,1,2,0,0,73,
08/10/2015,DGO.,"DGO., DGO.",0,2,2,0,0,0,
08/10/2015,NAY.,"AHUACATLAN, NAY.",2,0,2,0,0,0,
08/10/2015,COAH.,"PIEDRAS NEGRAS, COAH.",0,1,1,0,0,0,
08/10/2015,TAMPS.,"NUEVO LAREDO, TAMPS.",0,1,1,0,0,158,
08/10/2015,MEX.,"ATIZAPAN, MEX.",0,1,1,0,0,124,
08/10/2015,PUE.,"PUE., PUE.",0,1,1,0,0,0,
08/10/2015,VER.,"MARTINEZ DE LA TORRE, VER.",0,1,1,0,0,0,
08/10/2015,SON.,"CAJEME, SON.",0,0,0,0,0,2,
09/10/2015,D.F.,"AZCAPOTZALCO, D.F.",47,10,57,0,0,110,
09/10/2015,MEX.,"ECATEPEC DE MOR., MEX.",14,2,16,3,6,518,
09/10/2015,SIN.,"EL FUERTE, SIN.",9,2,11,0,5,0,
09/10/2015,COAH.,"TORREÓN, COAH.",6,1,7,2,0,103,
09/10/2015,COAH.,"MONCLOVA, COAH.",5,2,7,0,0,84,
09/10/2015,B.C.,"MEXICALI, B.C.",0,7,7,0,0,0,
09/10/2015,N.L.,"ANAHUAC, N.L.",0,6,6,0,0,0,
09/10/2015,COAH.,"SALTILLO, COAH.",1,3,4,1,2,0,
09/10/2015,DGO.,"GOMEZ PALACIO, DGO.",3,0,3,0,0,0,
09/10/2015,SIN.,"BADIRAGUATO, SIN.",2,1,3,0,5,0,
09/10/2015,HGO.,"HUICHAPAN, HGO.",0,2,2,0,0,0,
09/10/2015,N.L.,"SAN NICOLAS DE LOS GARZA, N.L.",2,0,2,30,0,4500,
09/10/2015,PUE.,"PUE., PUE.",2,0,2,0,0,0,
09/10/2015,SON.,"HERMOSILLO, SON.",2,0,2,1,0,0,
09/10/2015,B.C.,"TIJUANA, B.C.",2,0,2,0,0,0,
09/10/2015,HGO.,"TULANCINGO DE BRAVO, HGO.",0,1,1,0,0,466,
09/10/2015,YUC.,"UMAN, YUC.",1,0,1,0,0,0,
09/10/2015,DGO.,"DGO., DGO.",1,0,1,5,0,0,
09/10/2015,TAB.,"BALANCAN, TAB.",1,0,1,0,0,0,
09/10/2015,MEX.,"TONANITLA, MEX.",1,0,1,1,0,0,
09/10/2015,COAH.,"SABINAS, COAH.",0,1,1,0,0,0,
09/10/2015,DGO.,"MAPIMI, DGO.",0,1,1,0,0,0,
09/10/2015,SON.,"CAJEME, SON.",1,0,1,0,0,60,
09/10/2015,S.L.P.,"CIUDAD VALLES, S.L.P.",0,1,1,0,0,0,
09/10/2015,SIN.,"ELOTA, SIN.",0,1,1,0,0,0,
09/10/2015,TLAX.,"APIZACO, TLAX.",0,1,1,0,0,0,
09/10/2015,TLAX.,"ZACATELCO, TLAX.",0,1,1,0,0,0,
09/10/2015,GRO.,"COYUCA DE CATALAN, GRO.",1,0,1,0,0,0,
09/10/2015,TAB.,"CENTRO, TAB.",0,0,0,0,0,175,
09/10/2015,SIN.,"ESCUINAPA, SIN.",0,0,0,0,1,0,
09/10/2015,SIN.,"NAVOLATO, SIN.",0,0,0,0,10,0,
10/10/2015,MEX.,"TIANGUISTENCO, MEX.",3,0,3,0,0,0,
10/10/2015,HGO.,"TULANCINGO DE BRAVO, HGO.",1,1,2,0,0,211,
10/10/2015,TLAX.,"ZACATELCO, TLAX.",1,1,2,0,0,0,
10/10/2015,B.C.,"TIJUANA, B.C.",1,1,2,0,0,0,
10/10/2015,HGO.,"HUICHAPAN, HGO.",0,1,1,0,0,200,
10/10/2015,B.C.,"ENSENADA, B.C.",0,1,1,0,0,0,
10/10/2015,TAB.,"CENTRO, TAB.",0,0,0,0,0,35,
11/10/2015,MEX.,"ECATEPEC DE MOR., MEX.",11,3,14,0,0,148,
11/10/2015,DGO.,"DGO., DGO.",1,2,3,0,0,0,
11/10/2015,MEX.,"TONANITLA, MEX.",1,0,1,0,0,0,
12/10/2015,D.F.,"ALVARO OBREGON, D.F.",4,9,13,0,0,50,
12/10/2015,COAH.,"SALTILLO, COAH.",5,2,7,0,0,93,
12/10/2015,COAH.,"MONCLOVA, COAH.",4,3,7,0,0,158,
12/10/2015,COAH.,"PIEDRAS NEGRAS, COAH.",6,0,6,0,0,0,
12/10/2015,DGO.,"DGO., DGO.",3,2,5,11,0,0,
12/10/2015,SIN.,"BADIRAGUATO, SIN.",3,2,5,0,0,0,
12/10/2015,SIN.,"EL FUERTE, SIN.",2,3,5,0,1,0,
12/10/2015,MEX.,"LA PAZ, MEX.",3,1,4,0,0,0,
12/10/2015,DGO.,"GOMEZ PALACIO, DGO.",2,2,4,0,0,0,
12/10/2015,N.L.,"ANAHUAC, N.L.",2,2,4,0,0,0,
12/10/2015,COAH.,"SABINAS, COAH.",2,1,3,0,0,0,
12/10/2015,COAH.,"ACUÑA, COAH.",1,2,3,0,0,0,
12/10/2015,MEX.,"SAN ANTONIO LA ISLA, MEX.",0,2,2,0,0,0,
12/10/2015,MEX.,"NEXTLALPAN, MEX., MEX.",2,0,2,0,0,54,
12/10/2015,B.C.,"ENSENADA, B.C.",1,1,2,0,0,0,
12/10/2015,DGO.,"LERDO, DGO.",1,1,2,0,0,0,
12/10/2015,VER.,"TLALIXCOYAN, VER.",1,1,2,0,0,0,
12/10/2015,HGO.,"IXMIQUILPAN, HGO.",1,0,1,0,1,0,
12/10/2015,SIN.,"NAVOLATO, SIN.",0,1,1,0,12,0,
12/10/2015,COAH.,"TORREÓN, COAH.",1,0,1,0,0,0,
12/10/2015,COAH.,"MÚZQUIZ, COAH.",0,1,1,3,0,0,
12/10/2015,GRO.,"COYUCA DE BENITEZ, GRO.",1,0,1,1,0,0,
12/10/2015,VER.,"MARTINEZ DE LA TORRE, VER.",1,0,1,0,0,0,
12/10/2015,N.L.,"SAN NICOLAS DE LOS GARZA, N.L.",0,0,0,10,0,1050,
13/10/2015,SIN.,"EL FUERTE, SIN.",25,7,32,0,2,0,
13/10/2015,MEX.,"LA PAZ, MEX.",6,4,10,0,0,0,
13/10/2015,COAH.,"PIEDRAS NEGRAS, COAH.",3,3,6,7,0,180,
13/10/2015,B.C.,"MEXICALI, B.C.",1,5,6,0,0,0,
13/10/2015,COAH.,"SALTILLO, COAH.",5,0,5,0,0,0,
13/10/2015,D.F.,"ALVARO OBREGON, D.F.",3,1,4,0,0,0,
13/10/2015,TAMPS.,"MIGUEL ALEMAN, TAMPS.",0,4,4,0,0,0,
13/10/2015,SIN.,"BADIRAGUATO, SIN.",1,2,3,0,3,0,
13/10/2015,COAH.,"TORREÓN, COAH.",2,0,2,0,0,0,
13/10/2015,VER.,"MARTINEZ DE LA TORRE, VER.",1,1,2,0,0,0,
13/10/2015,HGO.,"HUAUTLA, HGO.",1,1,2,0,0,0,
13/10/2015,GRO.,"COYUCA DE CATALAN, GRO.",2,0,2,0,0,0,
13/10/2015,MEX.,"NEXTLALPAN, MEX., MEX.",1,1,2,1,2,0,
13/10/2015,SIN.,"ELOTA, SIN.",0,1,1,0,5,0,
13/10/2015,TAB.,"BALANCAN, TAB.",0,1,1,0,0,0,
13/10/2015,COAH.,"MONCLOVA, COAH.",1,0,1,0,0,0,
13/10/2015,COAH.,"SABINAS, COAH.",1,0,1,0,0,0,
13/10/2015,COAH.,"ACUÑA, COAH.",1,0,1,0,0,0,
13/10/2015,GRO.,"ATOYAC DE ALVAREZ, GRO.",1,0,1,0,1,0,
13/10/2015,SON.,"HERMOSILLO, SON.",1,0,1,0,0,0,
13/10/2015,N.L.,"CARMEN, N.L.",1,0,1,0,0,0,
13/10/2015,SIN.,"ESCUINAPA, SIN.",0,0,0,0,1,0,
13/10/2015,SIN.,"NAVOLATO, SIN.",0,0,0,0,6,0,
13/10/2015,HGO.,"ZEMPOALA, HGO.",0,0,0,0,0,211,
13/10/2015,TAMPS.,"TAMPICO, TAMPS.",0,0,0,4,0,120,
14/10/2015,D.F.,"ALVARO OBREGON, D.F.",40,2,42,0,0,35,
14/10/2015,MEX.,"LA PAZ, MEX.",8,1,9,0,0,0,
14/10/2015,DGO.,"GOMEZ PALACIO, DGO.",3,1,4,0,0,0,
14/10/2015,GRO.,"ATOYAC DE ALVAREZ, GRO.",2,0,2,0,0,0,
14/10/2015,MEX.,"SAN ANTONIO LA ISLA, MEX.",2,0,2,1,0,6,
14/10/2015,MEX.,"VALLE DE BRAVO, MEX.",2,0,2,2,0,4,
14/10/2015,COAH.,"TORREÓN, COAH.",2,0,2,0,0,0,
14/10/2015,N.L.,"CARMEN, N.L.",0,1,1,0,0,0,
14/10/2015,CHIH.,"NUEVO CASAS GRANDES, CHIH.",1,0,1,0,0,0,
14/10/2015,CHIH.,"HGO. DEL PARRAL, CHIH.",0,1,1,0,0,0,
14/10/2015,MEX.,"NEXTLALPAN, MEX., MEX.",0,0,0,0,2,50,
14/10/2015,N.L.,"SAN NICOLAS DE LOS GARZA, N.L.",0,0,0,80,0,0,
15/10/2015,SIN.,"EL FUERTE, SIN.",13,4,17,0,1,0,
15/10/2015,D.F.,"ALVARO OBREGON, D.F.",1,7,8,0,3,70,
15/10/2015,SIN.,"BADIRAGUATO, SIN.",3,2,5,0,0,0,
15/10/2015,MEX.,"LA PAZ, MEX.",3,0,3,0,2,0,
15/10/2015,CHIH.,"AHUMADA, CHIH.",3,0,3,0,0,0,
15/10/2015,SON.,"CAJEME, SON.",1,1,2,0,0,0,
15/10/2015,MEX.,"VALLE DE BRAVO, MEX.",1,1,2,0,0,4,
15/10/2015,HGO.,"HUAUTLA, HGO.",0,1,1,0,0,0,
15/10/2015,SIN.,"NAVOLATO, SIN.",1,0,1,0,0,0,
15/10/2015,MEX.,"SAN ANTONIO LA ISLA, MEX.",0,1,1,0,0,0,
15/10/2015,MEX.,"NEXTLALPAN, MEX., MEX.",0,0,0,0,3,0,
16/10/2015,SIN.,"BADIRAGUATO, SIN.",16,8,24,0,7,0,
16/10/2015,D.F.,"ALVARO OBREGON, D.F.",4,5,9,0,7,23,
16/10/2015,COAH.,"PIEDRAS NEGRAS, COAH.",4,4,8,1,0,40,
16/10/2015,SIN.,"EL FUERTE, SIN.",6,1,7,0,2,0,
16/10/2015,COAH.,"SALTILLO, COAH.",3,4,7,2,2,260,
16/10/2015,COAH.,"TORREÓN, COAH.",4,1,5,0,0,0,
16/10/2015,COAH.,"MÚZQUIZ, COAH.",2,2,4,0,0,0,
16/10/2015,MEX.,"NEXTLALPAN, MEX., MEX.",2,1,3,0,0,0,
16/10/2015,DGO.,"DGO., DGO.",2,1,3,15,0,0,
16/10/2015,COAH.,"MONCLOVA, COAH.",2,1,3,2,0,0,
16/10/2015,SIN.,"ESCUINAPA, SIN.",1,1,2,0,0,0,
16/10/2015,SIN.,"NAVOLATO, SIN.",0,2,2,0,2,0,
16/10/2015,GRO.,"ATOYAC DE ALVAREZ, GRO.",2,0,2,0,0,0,
16/10/2015,MEX.,"LA PAZ, MEX.",1,1,2,0,0,0,
16/10/2015,MEX.,"SAN ANTONIO LA ISLA, MEX.",1,1,2,4,0,0,
16/10/2015,HGO.,"IXMIQUILPAN, HGO.",0,1,1,0,0,0,
16/10/2015,HGO.,"HUAUTLA, HGO.",1,0,1,0,0,0,
16/10/2015,HGO.,"ZEMPOALA, HGO.",1,0,1,0,0,0,
16/10/2015,SIN.,"ELOTA, SIN.",1,0,1,0,6,0,
16/10/2015,GRO.,"PUNGARABATO, GRO.",1,0,1,0,0,0,
16/10/2015,YUC.,"TINUM, YUC.",1,0,1,0,0,0,
16/10/2015,CHIH.,"HGO. DEL PARRAL, CHIH.",0,1,1,0,0,0,
16/10/2015,TAB.,"BALANCAN, TAB.",1,0,1,0,0,0,
16/10/2015,OAX.,"SALINA CRUZ, OAX.",1,0,1,0,0,10,
16/10/2015,TAMPS.,"CIUDAD MADERO, TAMPS.",1,0,1,0,0,3,
16/10/2015,NAY.,"AHUACATLAN, NAY.",1,0,1,0,0,0,
16/10/2015,HGO.,"TULANCINGO DE BRAVO, HGO.",0,0,0,0,0,76,
16/10/2015,CHIH.,"AQUILES SERDÁN, CHIH.",0,0,0,4,0,209,
16/10/2015,TAMPS.,"TAMPICO, TAMPS.",0,0,0,0,0,137,
16/10/2015,TAMPS.,"EL MANTE, TAMPS.",0,0,0,0,0,1,
17/10/2015,B.C.,"MEXICALI, B.C.",3,5,8,0,0,0,
17/10/2015,MEX.,"LA PAZ, MEX.",4,1,5,0,0,0,
17/10/2015,HGO.,"HUAUTLA, HGO.",2,0,2,0,0,200,
17/10/2015,HGO.,"TULANCINGO DE BRAVO, HGO.",2,0,2,0,0,29,
17/10/2015,GRO.,"PUNGARABATO, GRO.",0,2,2,0,0,0,
17/10/2015,N.L.,"SAN NICOLAS DE LOS GARZA, N.L.",2,0,2,94,0,4500,
17/10/2015,B.C.,"ENSENADA, B.C.",0,1,1,0,0,0,
17/10/2015,MEX.,"NEXTLALPAN, MEX., MEX.",1,0,1,0,0,0,
17/10/2015,YUC.,"TINUM, YUC.",0,0,0,0,1,168,
18/10/2015,TAMPS.,"MATAMOROS, TAMPS.",2,3,5,3,0,90,
18/10/2015,DGO.,"LERDO, DGO.",4,0,4,0,0,0,
18/10/2015,N.L.,"SAN NICOLAS DE LOS GARZA, N.L.",3,0,3,160,0,6000,
19/10/2015,SIN.,"GUASAVE, SIN.",21,0,21,0,0,0,
19/10/2015,D.F.,"ALVARO OBREGON, D.F.",5,7,12,0,0,5,
19/10/2015,SON.,"HERMOSILLO, SON.",8,2,10,6,1,5091,
19/10/2015,COAH.,"SALTILLO, COAH.",7,0,7,6,1,0,
19/10/2015,COAH.,"TORREÓN, COAH.",6,0,6,0,0,0,
19/10/2015,NAY.,"ACAPONETA, NAY.",2,3,5,0,0,0,
19/10/2015,MEX.,"NEZAHUALCOYOTL, MEX.",4,1,5,0,2,0,
19/10/2015,COAH.,"PIEDRAS NEGRAS, COAH.",3,2,5,3,2,34,
19/10/2015,SIN.,"CONCORDIA, SIN.",1,2,3,0,0,0,
19/10/2015,COAH.,"ACUÑA, COAH.",3,0,3,0,0,0,
19/10/2015,N.L.,"SAN NICOLAS DE LOS GARZA, N.L.",1,1,2,1,0,500,
19/10/2015,GRO.,"PUNGARABATO, GRO.",0,1,1,0,0,0,
19/10/2015,MEX.,"XONACATLAN, MEX.",1,0,1,0,0,0,
19/10/2015,CHIH.,"HGO. DEL PARRAL, CHIH.",0,1,1,0,0,0,
19/10/2015,MEX.,"TEOTIHUACAN, MEX.",1,0,1,0,0,209,
19/10/2015,CHIH.,"AQUILES SERDÁN, CHIH.",0,0,0,5,0,380,
20/10/2015,SIN.,"GUASAVE, SIN.",15,5,20,0,4,0,
20/10/2015,MEX.,"NEZAHUALCOYOTL, MEX.",13,3,16,0,0,0,
20/10/2015,SIN.,"CONCORDIA, SIN.",1,5,6,0,0,0,
20/10/2015,COAH.,"MONCLOVA, COAH.",4,1,5,2,0,172,
20/10/2015,COAH.,"SALTILLO, COAH.",4,0,4,0,2,182,
20/10/2015,HGO.,"IXMIQUILPAN, HGO.",2,1,3,0,0,0,
20/10/2015,MEX.,"ZINACANTEPEC, MEX.",3,0,3,1,0,58,
20/10/2015,MEX.,"XONACATLAN, MEX.",3,0,3,0,0,0,
20/10/2015,COAH.,"TORREÓN, COAH.",3,0,3,2,0,24,
20/10/2015,DGO.,"DGO., DGO.",3,0,3,9,0,0,
20/10/2015,SIN.,"MOCORITO, SIN.",1,1,2,0,0,0,
20/10/2015,DGO.,"GOMEZ PALACIO, DGO.",1,1,2,0,0,0,
20/10/2015,D.F.,"ALVARO OBREGON, D.F.",2,0,2,0,3,0,
20/10/2015,MEX.,"TEOTIHUACAN, MEX.",1,1,2,0,0,90,
20/10/2015,OAX.,"CIUDAD IXTEPEC, OAX.",1,0,1,0,0,0,
20/10/2015,COAH.,"MÚZQUIZ, COAH.",1,0,1,0,0,0,
20/10/2015,TAMPS.,"NUEVO LAREDO, TAMPS.",1,0,1,0,0,981,
20/10/2015,CHIH.,"CHIH., CHIH.",0,0,0,0,0,599,
20/10/2015,N.L.,"SAN NICOLAS DE LOS GARZA, N.L.",0,0,0,2,0,150,
20/10/2015,Q. ROO,"COZUMEL, Q. ROO",0,0,0,0,0,52,
21/10/2015,SIN.,"GUASAVE, SIN.",17,7,24,0,12,0,
21/10/2015,D.F.,"ALVARO OBREGON, D.F.",22,1,23,0,1,0,
21/10/2015,N.L.,"SAN NICOLAS DE LOS GARZA, N.L.",8,2,10,197,0,21,
21/10/2015,MEX.,"ZINACANTEPEC, MEX.",4,1,5,0,0,0,
21/10/2015,MEX.,"NEZAHUALCOYOTL, MEX.",5,0,5,0,1,328,
21/10/2015,DGO.,"DGO., DGO.",4,0,4,50,0,0,
21/10/2015,HGO.,"IXMIQUILPAN, HGO.",2,2,4,0,0,0,
21/10/2015,B.C.,"MEXICALI, B.C.",0,4,4,0,0,0,
21/10/2015,MEX.,"XONACATLAN, MEX.",3,1,4,1,0,0,
21/10/2015,DGO.,"TLAHUALILO, DGO.",2,2,4,0,0,0,
21/10/2015,COAH.,"MONCLOVA, COAH.",2,1,3,3,0,48,
21/10/2015,GRO.,"EDUARDO NERI, GRO.",1,2,3,0,0,0,
21/10/2015,DGO.,"LERDO, DGO.",1,2,3,0,0,0,
21/10/2015,COAH.,"SALTILLO, COAH.",2,0,2,0,1,129,
21/10/2015,MEX.,"TEOTIHUACAN, MEX.",1,1,2,0,1,0,
21/10/2015,COAH.,"PIEDRAS NEGRAS, COAH.",1,0,1,0,0,0,
21/10/2015,COAH.,"TORREÓN, COAH.",1,0,1,1,0,40,
21/10/2015,COAH.,"MÚZQUIZ, COAH.",0,1,1,0,0,0,
21/10/2015,CHIS.,"BENEMÉRITO DE LAS AMÉRICAS, CHIS.",1,0,1,2,0,0,
21/10/2015,HGO.,"ZEMPOALA, HGO.",0,1,1,0,0,0,
21/10/2015,Q. ROO,"COZUMEL, Q. ROO",0,1,1,2,0,175,
21/10/2015,B.C.,"ENSENADA, B.C.",0,1,1,0,0,0,
21/10/2015,DGO.,"GOMEZ PALACIO, DGO.",0,1,1,0,0,0,
21/10/2015,SIN.,"CONCORDIA, SIN.",0,0,0,0,13,0,
21/10/2015,SON.,"CAJEME, SON.",0,0,0,0,1,230,
21/10/2015,TAB.,"MACUSPANA, TAB.",0,0,0,2,0,15,
22/10/2015,D.F.,"ALVARO OBREGON, D.F.",9,6,15,0,5,190,
22/10/2015,B.C.,"TIJUANA, B.C.",10,4,14,0,0,0,
22/10/2015,D.F.,"ALVARO OBREGON, D.F.",2,5,7,0,5,0,
22/10/2015,SIN.,"GUASAVE, SIN.",6,0,6,0,0,0,
22/10/2015,COAH.,"TORREÓN, COAH.",6,0,6,51,0,0,
22/10/2015,MEX.,"ZINACANTEPEC, MEX.",2,2,4,1,0,175,
22/10/2015,DGO.,"GOMEZ PALACIO, DGO.",1,3,4,0,0,0,
22/10/2015,MEX.,"XONACATLAN, MEX.",2,1,3,1,0,0,
22/10/2015,SIN.,"MOCORITO, SIN.",2,0,2,0,0,0,
22/10/2015,Q. ROO,"COZUMEL, Q. ROO",0,0,0,0,0,625,
22/10/2015,SIN.,"CONCORDIA, SIN.",0,0,0,0,3,0,
23/10/2015,SIN.,"GUASAVE, SIN.",17,8,25,0,68,0,
23/10/2015,D.F.,"ALVARO OBREGON, D.F.",14,7,21,0,3,0,
23/10/2015,MEX.,"NEZAHUALCOYOTL, MEX.",13,1,14,0,4,312,
23/10/2015,COAH.,"SALTILLO, COAH.",7,2,9,2,1,131,
23/10/2015,B.C.,"MEXICALI, B.C.",3,6,9,0,0,0,
23/10/2015,MEX.,"ZINACANTEPEC, MEX.",4,1,5,1,0,6,
23/10/2015,COAH.,"TORREÓN, COAH.",3,1,4,4,0,36,
23/10/2015,GRO.,"GENERAL HELIODORO CASTILLO, GRO.",1,3,4,0,0,0,
23/10/2015,COAH.,"TORREÓN, COAH.",3,1,4,4,0,36,
23/10/2015,MEX.,"XONACATLAN, MEX.",2,2,4,0,0,0,
23/10/2015,B.C.,"TIJUANA, B.C.",3,1,4,0,0,0,
23/10/2015,B.C.,"ENSENADA, B.C.",3,1,4,0,0,0,
23/10/2015,MEX.,"TEOTIHUACAN, MEX.",2,1,3,2,2,229,
23/10/2015,N.L.,"LOS HERRERAS, N.L.",1,1,2,0,0,0,
23/10/2015,SIN.,"CONCORDIA, SIN.",1,0,1,0,0,0,
23/10/2015,COAH.,"ACUÑA, COAH.",0,1,1,0,0,0,
24/10/2015,MEX.,"XONACATLAN, MEX.",1,3,4,1,0,0,
24/10/2015,B.C.,"TIJUANA, B.C.",1,2,3,0,0,0,
24/10/2015,MEX.,"ZINACANTEPEC, MEX.",3,0,3,1,0,0,
24/10/2015,TAMPS.,"MATAMOROS, TAMPS.",2,1,3,1,0,30,
24/10/2015,DGO.,"DGO., DGO.",2,0,2,0,0,0,
24/10/2015,B.C.,"ENSENADA, B.C.",0,1,1,0,0,0,
24/10/2015,B.C.,"MEXICALI, B.C.",0,1,1,0,0,0,
24/10/2015,HGO.,"IXMIQUILPAN, HGO.",1,0,1,0,0,0,
24/10/2015,HGO.,"TULANCINGO DE BRAVO, HGO.",0,1,1,0,0,59,
24/10/2015,HGO.,"ZEMPOALA, HGO.",0,0,0,0,2,834,
24/10/2015,TAMPS.,"NUEVO LAREDO, TAMPS.",0,0,0,0,0,49,
26/10/2015,SIN.,"GUASAVE, SIN.",13,5,18,0,5,0,
26/10/2015,COAH.,"SALTILLO, COAH.",7,0,7,0,0,453,
26/10/2015,DGO.,"DGO., DGO.",5,1,6,0,2,0,
26/10/2015,COAH.,"MONCLOVA, COAH.",3,3,6,0,0,0,
26/10/2015,B.C.,"TIJUANA, B.C.",5,0,5,0,0,0,
26/10/2015,SIN.,"MOCORITO, SIN.",0,4,4,0,0,0,
26/10/2015,D.F.,"ALVARO OBREGON, D.F.",2,2,4,0,0,0,
26/10/2015,COAH.,"PIEDRAS NEGRAS, COAH.",2,1,3,0,0,0,
26/10/2015,MEX.,"CALIMAYA, MEX.",2,0,2,0,0,0,
26/10/2015,MEX.,"TEXCALYACAC, MEX.",1,1,2,0,0,7,
26/10/2015,GRO.,"ATOYAC DE ALVAREZ, GRO.",1,1,2,0,0,0,
26/10/2015,COAH.,"TORREÓN, COAH.",1,1,2,0,0,0,
26/10/2015,MEX.,"COCOTITLAN, MEX.",2,0,2,0,0,0,
26/10/2015,VER.,"ATZALAN, VER.",0,1,1,0,0,0,
26/10/2015,GRO.,"GENERAL HELIODORO CASTILLO, GRO.",0,1,1,2,0,0,
26/10/2015,COAH.,"MÚZQUIZ, COAH.",0,1,1,0,0,0,
27/10/2015,HGO.,"ACTOPAN, HGO.",1,3,4,0,0,0,
27/10/2015,D.F.,"ALVARO OBREGON, D.F.",2,1,3,0,1,0,
27/10/2015,SON.,"HERMOSILLO, SON.",2,0,2,0,0,0,
27/10/2015,SON.,"CAJEME, SON.",0,2,2,0,0,0,
27/10/2015,CHIH.,"HGO. DEL PARRAL, CHIH.",1,0,1,0,0,0,
27/10/2015,DGO.,"DGO., DGO.",1,0,1,21,0,0,
27/10/2015,CHIS.,"BENEMÉRITO DE LAS AMÉRICAS, CHIS.",1,0,1,0,0,0,
27/10/2015,COL.,"COL., COL.",0,0,0,1,1,0,
28/10/2015,SIN.,"GUASAVE, SIN.",27,5,32,0,0,0,
28/10/2015,D.F.,"ALVARO OBREGON, D.F.",5,3,8,0,0,0,
28/10/2015,COAH.,"TORREÓN, COAH.",5,1,6,3,0,10,
28/10/2015,B.C.,"MEXICALI, B.C.",2,4,6,0,0,0,
28/10/2015,COAH.,"MONCLOVA, COAH.",3,1,4,0,0,7,
28/10/2015,COAH.,"SABINAS, COAH.",3,1,4,0,0,0,
28/10/2015,COAH.,"SALTILLO, COAH.",3,0,3,9,1,829,
28/10/2015,B.C.,"TIJUANA, B.C.",3,0,3,0,0,0,
28/10/2015,COAH.,"ACUÑA, COAH.",2,0,2,20,0,1,
28/10/2015,SON.,"CAJEME, SON.",1,0,1,0,0,0,
28/10/2015,CHIH.,"HGO. DEL PARRAL, CHIH.",1,0,1,0,0,0,
28/10/2015,CHIS.,"BENEMÉRITO DE LAS AMÉRICAS, CHIS.",0,1,1,0,0,0,
28/10/2015,COAH.,"SAN PEDRO, COAH.",1,0,1,0,0,0,
28/10/2015,GRO.,"ATOYAC DE ALVAREZ, GRO.",1,0,1,0,0,0,
28/10/2015,AGS.,"JESÚS MARÍA, AGS.",0,0,0,1,0,0,
29/10/2015,D.F.,"ALVARO OBREGON, D.F.",10,6,16,0,7,0,
29/10/2015,SIN.,"GUASAVE, SIN.",12,2,14,0,1,0,
29/10/2015,COAH.,"SALTILLO, COAH.",7,3,10,0,0,217,
29/10/2015,HGO.,"ACTOPAN, HGO.",1,4,5,0,0,0,
29/10/2015,COAH.,"TORREÓN, COAH.",4,0,4,22,0,59,
29/10/2015,MEX.,"COCOTITLAN, MEX.",1,2,3,0,0,0,
29/10/2015,COAH.,"MONCLOVA, COAH.",2,1,3,1,0,8,
29/10/2015,COAH.,"SABINAS, COAH.",1,2,3,0,0,0,
29/10/2015,DGO.,"DGO., DGO.",0,2,2,3,0,0,
29/10/2015,COAH.,"PIEDRAS NEGRAS, COAH.",0,2,2,0,0,0,
29/10/2015,COAH.,"MATAMOROS, COAH.",2,0,2,3,0,49,
29/10/2015,N.L.,"LOS ALDAMAS, N.L.",1,1,2,0,0,0,
29/10/2015,MEX.,"COCOTITLAN, MEX.",1,0,1,0,6,0,
29/10/2015,MEX.,"CALIMAYA, MEX.",1,0,1,1,0,18,
29/10/2015,B.C.,"MEXICALI, B.C.",0,1,1,0,0,0,
29/10/2015,SON.,"CAJEME, SON.",1,0,1,0,0,0,
29/10/2015,DGO.,"TLAHUALILO, DGO.",0,1,1,0,0,0,
29/10/2015,VER.,"ATZALAN, VER.",1,0,1,0,0,0,
29/10/2015,CHIS.,"BENEMÉRITO DE LAS AMÉRICAS, CHIS.",0,1,1,0,0,0,
29/10/2015,GRO.,"ATOYAC DE ALVAREZ, GRO.",1,0,1,0,0,0,
29/10/2015,COAH.,"ACUÑA, COAH.",1,0,1,0,0,0,
29/10/2015,COAH.,"SAN PEDRO, COAH.",1,0,1,0,0,0,
29/10/2015,N.L.,"CERRALVO, N.L.",1,0,1,1,0,0,
29/10/2015,VER.,"YANGA, VER.",0,0,0,0,2,0,
29/10/2015,SIN.,"CONCORDIA, SIN.",0,0,0,0,3,0,
29/10/2015,AGS.,"JESÚS MARÍA, AGS.",0,0,0,17,0,0,
29/10/2015,COAH.,"RAMOS ARIZPE, COAH.",0,0,0,0,2,0,
30/10/2015,D.F.,"COYOACAN, D.F.",4,18,22,0,0,0,
30/10/2015,SIN.,"GUASAVE, SIN.",9,4,13,0,0,0,
30/10/2015,YUC.,"HUNUCMA, YUC.",3,0,3,0,0,0,
30/10/2015,MEX.,"COCOTITLAN, MEX.",2,0,2,0,0,0,
30/10/2015,CHIS.,"BENEMÉRITO DE LAS AMÉRICAS, CHIS.",1,0,1,0,0,0,
30/10/2015,SON.,"CAJEME, SON.",1,0,1,0,0,0,
30/10/2015,TAMPS.,"EL MANTE, TAMPS.",1,0,1,0,0,0,
31/10/2015,DGO.,"GOMEZ PALACIO, DGO.",4,0,4,0,0,0,
31/10/2015,COAH.,"ACUÑA, COAH.",1,0,1,0,0,0,
31/10/2015,MEX.,"COCOTITLAN, MEX.",1,0,1,0,8,0,
31/10/2015,MEX.,"TEXCALYACAC, MEX.",0,0,0,0,1,0,
01/11/2015,B.C.,"MEXICALI, B.C.",3,0,3,0,0,0,
01/11/2015,B.C.,"TIJUANA, B.C.",1,1,2,0,0,0,
01/11/2015,DGO.,"TLAHUALILO, DGO.",1,0,1,0,0,0,
01/11/2015,DGO.,"DGO., DGO.",1,0,1,0,0,0,
02/11/2015,DGO.,"GOMEZ PALACIO, DGO.",1,2,3,0,0,0,
02/11/2015,DGO.,"LERDO, DGO.",0,2,2,0,0,0,
02/11/2015,HGO.,"ZACUALTIPAN DE ANGELES, HGO.",2,0,2,0,0,0,
02/11/2015,COAH.,"MATAMOROS, COAH.",1,1,2,0,0,0,
02/11/2015,COAH.,"TORREÓN, COAH.",0,0,0,8,0,0,
03/11/2015,B.C.,"TIJUANA, B.C.",50,31,81,0,0,0,
03/11/2015,SIN.,"GUASAVE, SIN.",4,4,8,0,4,0,
03/11/2015,D.F.,"COYOACAN, D.F.",2,4,6,0,0,25,
03/11/2015,DGO.,"DGO., DGO.",2,2,4,8,0,0,
03/11/2015,COAH.,"TORREÓN, COAH.",3,1,4,14,0,50,
03/11/2015,AGS.,"JESÚS MARÍA, AGS.",2,0,2,10,0,383,
03/11/2015,DGO.,"GOMEZ PALACIO, DGO.",2,0,2,0,0,0,
03/11/2015,MEX.,"CAPULHUAC, MEX.",2,0,2,0,0,0,
03/11/2015,HGO.,"ATOTONILCO EL GRANDE, HGO.",1,0,1,2,0,47,
03/11/2015,MEX.,"VALLE DE CHALCO SOLIDARIDAD, MEX.",1,0,1,0,0,0,
03/11/2015,TAMPS.,"TAMPICO, TAMPS.",1,0,1,3,0,449,
03/11/2015,MEX.,"TEJUPILCO, MEX.",0,0,0,0,0,0,
03/11/2015,SIN.,"CONCORDIA, SIN.",0,0,0,0,1,0,
04/11/2015,SIN.,"GUASAVE, SIN.",4,8,12,0,0,0,
04/11/2015,D.F.,"COYOACAN, D.F.",5,4,9,0,2,0,
04/11/2015,B.C.,"MEXICALI, B.C.",4,4,8,0,0,0,
04/11/2015,COAH.,"PIEDRAS NEGRAS, COAH.",5,3,8,1,0,38,
04/11/2015,COAH.,"MONCLOVA, COAH.",4,4,8,1,0,36,
04/11/2015,MEX.,"CAPULHUAC, MEX.",6,0,6,0,0,0,
04/11/2015,MEX.,"TEJUPILCO, MEX.",2,3,5,0,0,0,
04/11/2015,COAH.,"TORREÓN, COAH.",4,0,4,2,0,37,
04/11/2015,SIN.,"MOCORITO, SIN.",2,2,4,0,0,0,
04/11/2015,COAH.,"SALTILLO, COAH.",4,0,4,1,0,38,
04/11/2015,MEX.,"PAPALOTLA, MEX.",3,0,3,0,0,0,
04/11/2015,MEX.,"VALLE DE CHALCO SOLIDARIDAD, MEX.",3,0,3,0,0,0,
04/11/2015,B.C.,"ENSENADA, B.C.",1,1,2,0,0,0,
04/11/2015,N.L.,"GRAL. ESCOBEDO, N.L.",1,0,1,151,0,500,
04/11/2015,TAMPS.,"MATAMOROS, TAMPS.",1,0,1,0,0,0,
04/11/2015,COAH.,"MATAMOROS, COAH.",1,0,1,0,0,0,
04/11/2015,PUE.,"PUE., PUE.",0,0,0,2,0,130,
04/11/2015,HGO.,"PACHUCA DE SOTO, HGO.",0,0,0,0,2,0,
04/11/2015,SON.,"CAJEME, SON.",0,0,0,0,1,4000,
04/11/2015,COAH.,"RAMOS ARIZPE, COAH.",0,0,0,0,2,0,
05/11/2015,D.F.,"COYOACAN, D.F.",7,6,13,0,0,0,
05/11/2015,MEX.,"CAPULHUAC, MEX.",5,6,11,10,0,249,
05/11/2015,SIN.,"GUASAVE, SIN.",2,7,9,0,5,0,
05/11/2015,COAH.,"SALTILLO, COAH.",6,0,6,0,0,0,
05/11/2015,B.C.,"MEXICALI, B.C.",0,3,3,0,0,0,
05/11/2015,COAH.,"TORREÓN, COAH.",2,1,3,0,0,0,
05/11/2015,COAH.,"SAN PEDRO, COAH.",3,0,3,0,0,0,
05/11/2015,B.C.,"TIJUANA, B.C.",1,1,2,0,0,0,
05/11/2015,B.C.,"ENSENADA, B.C.",0,2,2,0,0,0,
05/11/2015,MEX.,"PAPALOTLA, MEX.",2,0,2,0,0,0,
05/11/2015,MEX.,"VALLE DE CHALCO SOLIDARIDAD, MEX.",0,2,2,0,0,0,
05/11/2015,COAH.,"SABINAS, COAH.",0,2,2,0,0,0,
05/11/2015,DGO.,"GOMEZ PALACIO, DGO.",0,2,2,0,0,0,
05/11/2015,TAMPS.,"NUEVO LAREDO, TAMPS.",1,0,1,2,0,53,
05/11/2015,COAH.,"MATAMOROS, COAH.",0,1,1,0,0,0,
05/11/2015,N.L.,"GRAL. ESCOBEDO, N.L.",0,0,0,200,0,700,
06/11/2015,D.F.,"COYOACAN, D.F.",12,3,15,0,12,38,
06/11/2015,B.C.,"TIJUANA, B.C.",5,2,7,0,0,0,
06/11/2015,MEX.,"TEJUPILCO, MEX.",2,4,6,3,0,1,
06/11/2015,MEX.,"VALLE DE CHALCO SOLIDARIDAD, MEX.",4,1,5,0,2,0,
06/11/2015,B.C.,"MEXICALI, B.C.",2,2,4,0,0,0,
06/11/2015,COAH.,"PIEDRAS NEGRAS, COAH.",2,2,4,12,0,27,
06/11/2015,COAH.,"MATAMOROS, COAH.",3,0,3,0,0,5,
06/11/2015,COAH.,"SALTILLO, COAH.",2,1,3,0,2,0,
06/11/2015,COAH.,"MONCLOVA, COAH.",2,1,3,1,1,11,
06/11/2015,N.L.,"GRAL. ESCOBEDO, N.L.",3,0,3,0,0,0,
06/11/2015,MEX.,"PAPALOTLA, MEX.",1,2,3,1,0,0,
06/11/2015,TAB.,"BALANCAN, TAB.",2,0,2,0,0,0,
06/11/2015,B.C.,"ENSENADA, B.C.",0,2,2,0,0,0,
06/11/2015,COAH.,"ACUÑA, COAH.",2,0,2,1,0,3,
06/11/2015,MEX.,"CAPULHUAC, MEX.",1,1,2,0,0,0,
06/11/2015,MOR.,"CUERNAVACA, MOR.",2,0,2,0,6,0,
06/11/2015,SIN.,"MOCORITO, SIN.",1,0,1,0,7,0,
06/11/2015,COAH.,"TORREÓN, COAH.",1,0,1,1,0,0,
06/11/2015,COAH.,"SAN PEDRO, COAH.",1,0,1,1,0,5,
06/11/2015,COAH.,"MÚZQUIZ, COAH.",0,1,1,0,0,0,
06/11/2015,COAH.,"SABINAS, COAH.",1,0,1,0,0,0,
06/11/2015,SON.,"HERMOSILLO, SON.",1,0,1,0,0,0,
06/11/2015,GRO.,"ALPOYECA, GRO.",0,1,1,0,0,0,
06/11/2015,DGO.,"DGO., DGO.",1,0,1,1,0,0,
06/11/2015,COAH.,"RAMOS ARIZPE, COAH.",0,0,0,0,3,0,
07/11/2015,MEX.,"CAPULHUAC, MEX.",15,2,17,0,0,41,
07/11/2015,MEX.,"TEJUPILCO, MEX.",8,1,9,5,0,91,
07/11/2015,N.L.,"GRAL. ESCOBEDO, N.L.",0,5,5,130,0,12000,
07/11/2015,MOR.,"CUERNAVACA, MOR.",1,1,2,0,4,0,
07/11/2015,MEX.,"PAPALOTLA, MEX.",1,0,1,0,0,0,
08/11/2015,N.L.,"MONTERREY, N.L.",3,1,4,10,0,400,
08/11/2015,TAMPS.,"MATAMOROS, TAMPS.",0,1,1,0,0,0,
08/11/2015,B.C.,"ENSENADA, B.C.",1,0,1,0,0,0,
08/11/2015,MOR.,"CUERNAVACA, MOR.",0,1,1,0,0,0,
08/11/2015,TAB.,"MACUSPANA, TAB.",0,0,0,0,0,181,
09/11/2015,SIN.,"SIN., SIN.",19,6,25,0,4,0,
09/11/2015,D.F.,"CUAUHTEMOC, D.F.",16,0,16,0,3,0,
09/11/2015,COAH.,"SALTILLO, COAH.",11,0,11,0,0,49,
09/11/2015,N.L.,"MONTERREY, N.L.",4,1,5,1,0,100,
09/11/2015,MEX.,"TECAMAC, MEX.",2,3,5,0,0,466,
09/11/2015,COAH.,"TORREÓN, COAH.",4,0,4,35,0,0,
09/11/2015,MEX.,"MALINALCO, MEX.",2,1,3,2,0,0,
09/11/2015,N.L.,"GRAL. ESCOBEDO, N.L.",2,1,3,1,0,0,
09/11/2015,COAH.,"SAN PEDRO, COAH.",2,0,2,0,0,0,
09/11/2015,COAH.,"MONCLOVA, COAH.",2,0,2,0,0,0,
09/11/2015,COAH.,"SABINAS, COAH.",1,1,2,0,0,0,
09/11/2015,MEX.,"CHIAUTLA, MEX.",1,1,2,0,0,0,
09/11/2015,HGO.,"TEPEAPULCO, HGO.",1,0,1,0,0,0,
09/11/2015,COAH.,"ACUÑA, COAH.",1,0,1,0,0,0,
09/11/2015,MOR.,"CUERNAVACA, MOR.",0,1,1,0,0,0,
10/11/2015,D.F.,"CUAUHTEMOC, D.F.",5,13,18,0,0,0,
10/11/2015,MEX.,"TECAMAC, MEX.",10,2,12,2,2,171,
10/11/2015,SIN.,"SIN., SIN.",7,2,9,0,5,0,
10/11/2015,COAH.,"SALTILLO, COAH.",7,2,9,1,2,190,
10/11/2015,COAH.,"TORREÓN, COAH.",7,1,8,0,0,0,
10/11/2015,MEX.,"MALINALCO, MEX.",6,0,6,2,0,0,
10/11/2015,N.L.,"MONTERREY, N.L.",5,1,6,3,0,400,
10/11/2015,N.L.,"GRAL. ESCOBEDO, N.L.",0,5,5,21,0,0,
10/11/2015,COAH.,"PIEDRAS NEGRAS, COAH.",2,3,5,2,0,650,
10/11/2015,B.C.,"MEXICALI, B.C.",3,1,4,0,0,0,
10/11/2015,COAH.,"MONCLOVA, COAH.",3,1,4,0,0,46,
10/11/2015,MEX.,"ISIDRO FABELA, MEX.",2,1,3,1,0,0,
10/11/2015,MEX.,"CHIAUTLA, MEX.",3,0,3,0,0,0,
10/11/2015,CHIS.,"TUXTLA CHICO, CHIS.",1,1,2,0,0,0,
10/11/2015,B.C.,"TIJUANA, B.C.",2,0,2,0,0,0,
10/11/2015,MOR.,"CUERNAVACA, MOR.",0,1,1,0,0,0,
10/11/2015,HGO.,"TLANCHINOL, HGO.",1,0,1,0,0,0,
10/11/2015,VER.,"ALTOTONGA, VER.",1,0,1,0,0,0,
10/11/2015,CHIH.,"HGO. DEL PARRAL, CHIH.",1,0,1,0,0,0,
10/11/2015,GRO.,"ALPOYECA, GRO.",0,1,1,0,0,0,
10/11/2015,B.C.,"ENSENADA, B.C.",0,1,1,0,0,0,
10/11/2015,COAH.,"MATAMOROS, COAH.",0,1,1,0,0,0,
10/11/2015,COAH.,"SAN PEDRO, COAH.",0,1,1,0,0,0,
10/11/2015,COAH.,"RAMOS ARIZPE, COAH.",1,0,1,0,0,0,
11/11/2015,COAH.,"MONCLOVA, COAH.",25,1,26,0,0,6329,
11/11/2015,D.F.,"CUAUHTEMOC, D.F.",8,6,14,0,2,0,
11/11/2015,COAH.,"MÚZQUIZ, COAH.",1,10,11,0,0,0,
11/11/2015,COAH.,"ACUÑA, COAH.",1,10,11,1,7,3,
11/11/2015,N.L.,"GRAL. ESCOBEDO, N.L.",6,4,10,200,0,650,
11/11/2015,N.L.,"MONTERREY, N.L.",8,0,8,2,0,950,
11/11/2015,COAH.,"SALTILLO, COAH.",7,1,8,4,2,79,
11/11/2015,MEX.,"TECAMAC, MEX.",7,1,8,0,0,90,
11/11/2015,SIN.,"SIN., SIN.",6,0,6,0,4,0,
11/11/2015,COAH.,"TORREÓN, COAH.",4,1,5,0,0,27,
11/11/2015,MEX.,"ISIDRO FABELA, MEX.",3,1,4,1,2,0,
11/11/2015,MEX.,"CHIAUTLA, MEX.",2,1,3,0,0,0,
11/11/2015,B.C.,"TIJUANA, B.C.",2,0,2,0,0,0,
11/11/2015,MOR.,"CUERNAVACA, MOR.",0,2,2,0,1,0,
11/11/2015,MEX.,"MALINALCO, MEX.",2,0,2,1,0,0,
11/11/2015,TAMPS.,"EL MANTE, TAMPS.",2,0,2,0,0,0,
11/11/2015,DGO.,"DGO., DGO.",1,0,1,0,0,0,
11/11/2015,B.C.,"MEXICALI, B.C.",0,1,1,0,0,0,
11/11/2015,TAMPS.,"TAMPICO, TAMPS.",1,0,1,1,0,501,
12/11/2015,COAH.,"TORREÓN, COAH.",7,42,49,10,0,210,
12/11/2015,D.F.,"CUAUHTEMOC, D.F.",14,12,26,0,1,38,
12/11/2015,N.L.,"MONTERREY, N.L.",7,5,12,5,0,1050,
12/11/2015,MEX.,"TECAMAC, MEX.",7,5,12,7,1,129,
12/11/2015,SIN.,"SIN., SIN.",4,3,7,0,3,0,
12/11/2015,N.L.,"GRAL. ESCOBEDO, N.L.",6,0,6,202,0,550,
12/11/2015,B.C.,"MEXICALI, B.C.",3,0,3,0,0,0,
12/11/2015,YUC.,"CALOTMUL, YUC.",2,0,2,0,1,455,
12/11/2015,COAH.,"MATAMOROS, COAH.",2,0,2,0,0,0,
12/11/2015,MEX.,"CHIAUTLA, MEX.",0,2,2,0,0,0,
12/11/2015,TAB.,"BALANCAN, TAB.",1,0,1,0,0,0,
12/11/2015,PUE.,"PUE., PUE.",1,0,1,1,0,7,
12/11/2015,MEX.,"MALINALCO, MEX.",1,0,1,0,0,0,
12/11/2015,TAMPS.,"EL MANTE, TAMPS.",1,0,1,0,0,0,
12/11/2015,MOR.,"CUERNAVACA, MOR.",0,1,1,0,0,0,
12/11/2015,HGO.,"TLAXCOAPAN, HGO.",0,1,1,0,0,0,
12/11/2015,COAH.,"SAN PEDRO, COAH.",1,0,1,0,0,0,
12/11/2015,YUC.,"MERIDA, YUC.",1,0,1,0,0,1620,
12/11/2015,B.C.,"ENSENADA, B.C.",0,1,1,0,0,0,
13/11/2015,COAH.,"SABINAS, COAH.",25,1,26,0,0,0,
13/11/2015,D.F.,"CUAUHTEMOC, D.F.",6,8,14,0,6,1,
13/11/2015,GRO.,"AJUCHITLAN DEL PROGRESO, GRO.",8,4,12,0,0,40,
13/11/2015,COAH.,"SALTILLO, COAH.",11,0,11,0,8,429,
13/11/2015,SIN.,"SIN., SIN.",11,0,11,0,4,0,
13/11/2015,N.L.,"MONTERREY, N.L.",3,1,4,0,0,250,
13/11/2015,COAH.,"PIEDRAS NEGRAS, COAH.",1,3,4,4,0,0,
13/11/2015,COAH.,"TORREÓN, COAH.",4,0,4,5,1,0,
13/11/2015,TAB.,"BALANCAN, TAB.",2,1,3,0,0,0,
13/11/2015,MEX.,"CHIAUTLA, MEX.",2,1,3,0,2,0,
13/11/2015,COAH.,"ACUÑA, COAH.",1,1,2,0,0,0,
13/11/2015,B.C.,"TIJUANA, B.C.",1,1,2,0,0,0,
13/11/2015,N.L.,"GRAL. ESCOBEDO, N.L.",0,1,1,201,0,0,
13/11/2015,COAH.,"MATAMOROS, COAH.",1,0,1,0,0,0,
13/11/2015,TAB.,"JONUTA, TAB.",1,0,1,0,0,0,
13/11/2015,PUE.,"PUE., PUE.",1,0,1,0,0,50,
13/11/2015,B.C.,"ENSENADA, B.C.",0,1,1,0,0,0,
13/11/2015,B.C.,"MEXICALI, B.C.",0,1,1,0,0,0,
13/11/2015,CHIS.,"TUXTLA CHICO, CHIS.",0,1,1,0,0,0,
13/11/2015,CHIS.,"MOTOZINTLA, CHIS.",0,1,1,0,0,214,
13/11/2015,SON.,"HERMOSILLO, SON.",0,0,0,2,0,0,
13/11/2015,SON.,"CAJEME, SON.",0,0,0,0,0,3000,
13/11/2015,VER.,"ALTOTONGA, VER.",0,0,0,0,0,110,
13/11/2015,MEX.,"MALINALCO, MEX.",0,0,0,1,0,0,
13/11/2015,MEX.,"ISIDRO FABELA, MEX.",0,0,0,0,3,0,
14/11/2015,B.C.,"TIJUANA, B.C.",2,1,3,0,0,0,
14/11/2015,MEX.,"CHIAUTLA, MEX.",3,0,3,0,0,0,
14/11/2015,GRO.,"AJUCHITLAN DEL PROGRESO, GRO.",1,1,2,0,0,0,
14/11/2015,GRO.,"AJUCHITLAN DEL PROGRESO, GRO.",1,1,2,0,0,0,
14/11/2015,MEX.,"TECAMAC, MEX.",2,0,2,2,1,2,
14/11/2015,GRO.,"TLALIXTAQUILLA DE MALDONADO, GRO.",1,0,1,0,0,0,
14/11/2015,MOR.,"CUERNAVACA, MOR.",1,0,1,0,1,0,
14/11/2015,GRO.,"TLALIXTAQUILLA DE MALDONADO, GRO.",1,0,1,0,0,0,
14/11/2015,TAMPS.,"MATAMOROS, TAMPS.",1,0,1,0,2,0,
14/11/2015,MEX.,"MALINALCO, MEX.",0,0,0,0,5,0,
15/11/2015,GRO.,"AJUCHITLAN DEL PROGRESO, GRO.",1,1,2,3,0,0,
15/11/2015,CHIH.,"HGO. DEL PARRAL, CHIH.",1,0,1,0,0,0,
15/11/2015,MOR.,"CUERNAVACA, MOR.",1,0,1,1,0,0,
15/11/2015,N.L.,"GRAL. ESCOBEDO, N.L.",0,0,0,35,0,2900,
15/11/2015,YUC.,"PROGRESO, YUC.",0,0,0,0,0,162,
16/11/2015,GRO.,"AJUCHITLAN DEL PROGRESO, GRO.",1,2,3,2,0,0,
16/11/2015,TAB.,"BALANCAN, TAB.",0,1,1,0,0,0,
16/11/2015,N.L.,"MONTERREY, N.L.",0,1,1,0,0,0,
16/11/2015,N.L.,"GRAL. ESCOBEDO, N.L.",0,0,0,0,0,200,
17/11/2015,COAH.,"PIEDRAS NEGRAS, COAH.",25,1,26,0,0,0,
17/11/2015,COAH.,"ACUÑA, COAH.",25,1,26,0,0,0,
17/11/2015,SIN.,"SIN., SIN.",19,0,19,0,9,0,
17/11/2015,D.F.,"CUAUHTEMOC, D.F.",12,6,18,0,17,42,
17/11/2015,COAH.,"TORREÓN, COAH.",4,1,5,6,0,0,
17/11/2015,MEX.,"RAYON, MEX.",1,4,5,0,0,0,
17/11/2015,SON.,"CAJEME, SON.",2,2,4,1,0,500,
17/11/2015,MEX.,"XALATLACO, MEX.",2,2,4,2,0,0,
17/11/2015,MEX.,"OTUMBA, MEX.",4,0,4,2,1,193,
17/11/2015,COAH.,"SALTILLO, COAH.",1,2,3,4,2,410,
17/11/2015,COAH.,"FRONTERA, COAH.",2,1,3,2,0,0,
17/11/2015,N.L.,"GRAL. ESCOBEDO, N.L.",3,0,3,2,0,3000,
17/11/2015,DGO.,"DGO., DGO.",1,1,2,2,0,0,
17/11/2015,B.C.,"MEXICALI, B.C.",1,1,2,0,0,0,
17/11/2015,N.L.,"MONTERREY, N.L.",1,1,2,7,0,0,
17/11/2015,TAMPS.,"MATAMOROS, TAMPS.",0,2,2,0,0,0,
17/11/2015,MEX.,"NOPALTEPEC, MEX.",0,2,2,0,0,0,
17/11/2015,YUC.,"PROGRESO, YUC.",0,1,1,0,0,370,
17/11/2015,GRO.,"AJUCHITLAN DEL PROGRESO, GRO.",1,0,1,0,0,0,
17/11/2015,COAH.,"MÚZQUIZ, COAH.",1,0,1,0,0,0,
17/11/2015,TAMPS.,"MATAMOROS, TAMPS.",0,0,0,3,0,0,
18/11/2015,COAH.,"MÚZQUIZ, COAH.",38,1,39,1,0,0,
18/11/2015,D.F.,"CUAUHTEMOC, D.F.",7,9,16,0,0,920,
18/11/2015,COAH.,"ACUÑA, COAH.",2,3,5,1,0,0,
18/11/2015,B.C.,"TIJUANA, B.C.",5,0,5,0,0,0,
18/11/2015,MEX.,"OTUMBA, MEX.",3,2,5,1,0,41,
18/11/2015,MEX.,"RAYON, MEX.",2,2,4,0,1,0,
18/11/2015,B.C.,"MEXICALI, B.C.",2,2,4,0,0,0,
18/11/2015,COAH.,"SALTILLO, COAH.",2,1,3,0,4,1436,
18/11/2015,TAMPS.,"CIUDAD MADERO, TAMPS.",1,2,3,2,0,11,
18/11/2015,SIN.,"SIN., SIN.",2,0,2,0,0,0,
18/11/2015,DGO.,"DGO., DGO.",2,0,2,20,0,0,
18/11/2015,TAMPS.,"MATAMOROS, TAMPS.",2,0,2,0,0,0,
18/11/2015,COAH.,"MATAMOROS, COAH.",2,0,2,0,0,0,
18/11/2015,MEX.,"NOPALTEPEC, MEX.",0,2,2,0,0,16,
18/11/2015,COAH.,"MONCLOVA, COAH.",1,0,1,1,0,0,
18/11/2015,COAH.,"SALTILLO, COAH.",1,0,1,0,0,0,
18/11/2015,SON.,"HERMOSILLO, SON.",1,0,1,0,0,0,
18/11/2015,COAH.,"PIEDRAS NEGRAS, COAH.",1,0,1,0,0,0,
18/11/2015,HGO.,"TLANCHINOL, HGO.",1,0,1,0,0,0,
18/11/2015,MOR.,"CUERNAVACA, MOR.",1,0,1,0,0,0,
18/11/2015,PUE.,"PUE., PUE.",0,0,0,0,0,52,
19/11/2015,D.F.,"CUAUHTEMOC, D.F.",10,10,20,0,4,2,
19/11/2015,N.L.,"MONTERREY, N.L.",3,11,14,0,0,0,
19/11/2015,SIN.,"SIN., SIN.",8,1,9,0,1,0,
19/11/2015,COAH.,"SALTILLO, COAH.",3,2,5,0,0,0,
19/11/2015,MEX.,"OTUMBA, MEX.",2,3,5,1,0,13,
19/11/2015,MEX.,"XALATLACO, MEX.",3,1,4,1,0,0,
19/11/2015,COAH.,"MONCLOVA, COAH.",3,1,4,3,4,119,
19/11/2015,MOR.,"CUERNAVACA, MOR.",4,0,4,0,0,51,
19/11/2015,COAH.,"TORREÓN, COAH.",2,1,3,4,0,0,
19/11/2015,HGO.,"TEPEAPULCO, HGO.",2,0,2,0,0,500,
19/11/2015,N.L.,"GRAL. ESCOBEDO, N.L.",2,0,2,1,0,0,
19/11/2015,COAH.,"SAN PEDRO, COAH.",2,0,2,1,4,28,
19/11/2015,S.L.P.,"AXTLA DE TERRAZAS, S.L.P.",1,0,1,0,0,0,
19/11/2015,B.C.,"MEXICALI, B.C.",0,1,1,0,0,0,
19/11/2015,HGO.,"TLAXCOAPAN, HGO.",0,1,1,0,0,0,
19/11/2015,HGO.,"TLANCHINOL, HGO.",1,0,1,0,0,0,
19/11/2015,MEX.,"RAYON, MEX.",0,1,1,0,0,0,
19/11/2015,COL.,"COL., COL.",0,1,1,0,0,0,
19/11/2015,SON.,"CAJEME, SON.",0,1,1,0,0,500,
19/11/2015,TAB.,"BALANCAN, TAB.",1,0,1,0,0,0,
19/11/2015,COAH.,"SABINAS, COAH.",1,0,1,0,0,0,
19/11/2015,MEX.,"NOPALTEPEC, MEX.",1,0,1,0,0,0,
20/11/2015,SIN.,"SIN., SIN.",10,0,10,0,0,0,
20/11/2015,B.C.,"TIJUANA, B.C.",3,1,4,0,0,0,
20/11/2015,MEX.,"XALATLACO, MEX.",3,0,3,0,0,0,
20/11/2015,COAH.,"RAMOS ARIZPE, COAH.",2,0,2,0,0,0,
20/11/2015,MEX.,"RAYON, MEX.",2,0,2,1,0,0,
20/11/2015,AGS.,"AGS., AGS.",1,1,2,0,0,10,
20/11/2015,MEX.,"OTUMBA, MEX.",0,2,2,0,0,48,
20/11/2015,HGO.,"TEPEAPULCO, HGO.",1,0,1,0,0,0,
20/11/2015,COAH.,"SALTILLO, COAH.",1,0,1,0,2,0,
20/11/2015,B.C.,"ENSENADA, B.C.",0,1,1,0,0,0,
20/11/2015,B.C.,"MEXICALI, B.C.",0,1,1,0,0,0,
20/11/2015,MEX.,"NOPALTEPEC, MEX.",0,1,1,0,0,0,
20/11/2015,MOR.,"CUERNAVACA, MOR.",0,1,1,0,1,48,
21/11/2015,D.F.,"CUAUHTEMOC, D.F.",13,14,27,0,3,3,
21/11/2015,MEX.,"XALATLACO, MEX.",5,1,6,5,0,300,
21/11/2015,MEX.,"RAYON, MEX.",2,0,2,2,0,0,
21/11/2015,HGO.,"TLAXCOAPAN, HGO.",2,0,2,0,0,0,
21/11/2015,B.C.,"MEXICALI, B.C.",1,0,1,0,0,0,
22/11/2015,D.F.,"CUAUHTEMOC, D.F.",3,11,14,0,0,15,
22/11/2015,MEX.,"OTUMBA, MEX.",4,2,6,2,1,50,
22/11/2015,DGO.,"DGO., DGO.",2,1,3,0,0,0,
22/11/2015,MOR.,"CUERNAVACA, MOR.",2,0,2,0,0,0,
22/11/2015,GRO.,"TELOLOAPAN, GRO.",0,1,1,0,0,0,
22/11/2015,MEX.,"NOPALTEPEC, MEX.",1,0,1,0,0,35,
23/11/2015,D.F.,"CUAUHTEMOC, D.F.",12,9,21,0,4,12,
23/11/2015,COAH.,"PIEDRAS NEGRAS, COAH.",1,8,9,0,0,0,
23/11/2015,COAH.,"TORREÓN, COAH.",7,1,8,0,0,0,
23/11/2015,COAH.,"SALTILLO, COAH.",6,0,6,0,0,200,
23/11/2015,COAH.,"FRONTERA, COAH.",2,2,4,0,0,0,
23/11/2015,YUC.,"TIXKOKOB, YUC.",1,2,3,0,0,101,
23/11/2015,COAH.,"SAN PEDRO, COAH.",2,1,3,1,0,5,
23/11/2015,AGS.,"AGS., AGS.",2,1,3,0,0,0,
23/11/2015,AGS.,"AGS., AGS.",2,1,3,0,0,25,
23/11/2015,N.L.,"MONTERREY, N.L.",2,0,2,1,0,0,
23/11/2015,COAH.,"SABINAS, COAH.",1,1,2,0,0,0,
23/11/2015,DGO.,"DGO., DGO.",1,1,2,0,0,0,
23/11/2015,GRO.,"TELOLOAPAN, GRO.",1,1,2,0,0,0,
23/11/2015,COAH.,"MATAMOROS, COAH.",1,0,1,0,0,0,
23/11/2015,COAH.,"ACUÑA, COAH.",1,0,1,0,0,2,
23/11/2015,GRO.,"CUALAC, GRO.",1,0,1,0,0,0,
23/11/2015,MEX.,"AXAPUSCO, MEX.",1,0,1,1,0,0,
23/11/2015,MEX.,"NOPALTEPEC, MEX.",1,0,1,0,0,0,
23/11/2015,MEX.,"ALMOLOYA DE JUAREZ, MEX.",0,1,1,0,0,0,
24/11/2015,D.F.,"CUAUHTEMOC, D.F.",16,10,26,0,5,155,
24/11/2015,COAH.,"SALTILLO, COAH.",8,2,10,0,20,735,
24/11/2015,SON.,"AGUA PRIETA, SON.",2,4,6,0,0,0,
24/11/2015,AGS.,"AGS., AGS.",4,1,5,6,0,6,
24/11/2015,GRO.,"TELOLOAPAN, GRO.",1,4,5,0,0,0,
24/11/2015,MEX.,"ALMOLOYA DE JUAREZ, MEX.",1,2,3,0,0,0,
24/11/2015,DGO.,"DGO., DGO.",2,1,3,0,0,0,
24/11/2015,SON.,"SAN LUIS RIO COLORADO, SON.",3,0,3,0,0,0,
24/11/2015,N.L.,"GRAL. ESCOBEDO, N.L.",2,0,2,2,0,0,
24/11/2015,COAH.,"SABINAS, COAH.",2,0,2,0,0,0,
24/11/2015,COAH.,"ACUÑA, COAH.",2,0,2,0,0,0,
24/11/2015,SON.,"ALAMOS, SON.",2,0,2,0,0,0,
24/11/2015,B.C.,"MEXICALI, B.C.",1,0,1,0,0,0,
24/11/2015,TAB.,"BALANCAN, TAB.",1,0,1,0,0,0,
24/11/2015,YUC.,"TIXKOKOB, YUC.",1,0,1,1,0,249,
24/11/2015,HGO.,"TEPETITLAN, HGO.",0,1,1,0,0,0,
24/11/2015,COAH.,"MONCLOVA, COAH.",1,0,1,1,0,49,
24/11/2015,COAH.,"SAN PEDRO, COAH.",1,0,1,1,0,0,
24/11/2015,PUE.,"PUE., PUE.",1,0,1,4,0,0,
24/11/2015,SON.,"MAGDALENA, SON.",0,1,1,1,0,0,
24/11/2015,SON.,"PITIQUITO, SON.",0,1,1,0,0,0,
24/11/2015,SON.,"PUERTO PEÑASCO, SON.",1,0,1,1,0,14,
24/11/2015,SON.,"GENERAL PLUTARCO ELIAS CALLES, SON.",0,1,1,0,0,0,
24/11/2015,SON.,"BENITO JUAREZ, SON.",0,1,1,0,0,29,
24/11/2015,MEX.,"AXAPUSCO, MEX.",1,0,1,0,0,0,
24/11/2015,MEX.,"TEMASCALAPA, MEX.",1,0,1,1,6,1009,
24/11/2015,YUC.,"VALLADOLID, YUC.",0,0,0,0,0,26,
24/11/2015,MOR.,"CUERNAVACA, MOR.",0,0,0,0,1,0,
25/11/2015,D.F.,"CUAUHTEMOC, D.F.",14,11,25,0,6,52,
25/11/2015,AGS.,"AGS., AGS.",2,1,3,4,0,2101,
25/11/2015,PUE.,"PUE., PUE.",3,0,3,0,0,12,
25/11/2015,N.L.,"MONTERREY, N.L.",2,0,2,1,0,100,
25/11/2015,SON.,"CAJEME, SON.",0,2,2,0,0,0,
25/11/2015,SON.,"NAVOJOA, SON.",2,0,2,0,0,0,
25/11/2015,SON.,"NOGALES, SON.",2,0,2,2,0,55,
25/11/2015,SON.,"CABORCA, SON.",0,2,2,0,0,100,
25/11/2015,MEX.,"AXAPUSCO, MEX.",2,0,2,0,1,0,
25/11/2015,MEX.,"TEMASCALAPA, MEX.",0,2,2,0,0,98,
25/11/2015,N.L.,"GARCIA, N.L.",1,0,1,2,0,0,
25/11/2015,MEX.,"ALMOLOYA DE JUAREZ, MEX.",1,0,1,1,0,116,
25/11/2015,SON.,"HERMOSILLO, SON.",1,0,1,0,0,0,
25/11/2015,SON.,"ALAMOS, SON.",1,0,1,1,0,0,
25/11/2015,SON.,"MAGDALENA, SON.",1,0,1,0,0,10,
25/11/2015,SON.,"CANANEA, SON.",1,0,1,0,0,0,
25/11/2015,SON.,"AGUA PRIETA, SON.",1,0,1,0,0,8,
25/11/2015,SON.,"PUERTO PEÑASCO, SON.",0,1,1,0,0,0,
25/11/2015,SON.,"GENERAL PLUTARCO ELIAS CALLES, SON.",0,1,1,0,0,0,
25/11/2015,SON.,"EMPALME, SON.",0,0,0,0,1,0,
25/11/2015,SON.,"BENITO JUAREZ, SON.",0,0,0,2,0,0,
25/11/2015,SON.,"SAN LUIS RIO COLORADO, SON.",0,0,0,0,3,240,
26/11/2015,D.F.,"CUAUHTEMOC, D.F.",11,13,24,0,3,64,
26/11/2015,PUE.,"PUE., PUE.",2,1,3,1,0,0,
26/11/2015,DGO.,"DGO., DGO.",3,0,3,2,0,0,
26/11/2015,SON.,"HUATABAMPO, SON.",3,0,3,1,0,0,
26/11/2015,COAH.,"TORREÓN, COAH.",3,0,3,6,0,0,
26/11/2015,COAH.,"SALTILLO, COAH.",3,0,3,0,0,1245,
26/11/2015,MEX.,"AXAPUSCO, MEX.",3,0,3,0,0,131,
26/11/2015,SON.,"AGUA PRIETA, SON.",1,2,3,1,0,75,
26/11/2015,MEX.,"AXAPUSCO, MEX.",2,0,2,0,1,0,
26/11/2015,MEX.,"TEMASCALAPA, MEX.",0,2,2,0,0,98,
26/11/2015,SON.,"EMPALME, SON.",0,2,2,0,0,0,
26/11/2015,COAH.,"MATAMOROS, COAH.",2,0,2,0,0,0,
26/11/2015,SON.,"SAN LUIS RIO COLORADO, SON.",0,2,2,2,0,106,
26/11/2015,YUC.,"VALLADOLID, YUC.",1,0,1,0,0,120,
26/11/2015,SON.,"YECORA, SON.",1,0,1,0,0,0,
26/11/2015,SON.,"NAVOJOA, SON.",1,0,1,0,0,0,
26/11/2015,SON.,"ALAMOS, SON.",0,1,1,0,0,0,
26/11/2015,COAH.,"SAN PEDRO, COAH.",1,0,1,0,0,0,
26/11/2015,COAH.,"SABINAS, COAH.",0,1,1,1,0,0,
26/11/2015,MEX.,"TEMASCALAPA, MEX.",1,0,1,0,0,79,
26/11/2015,SON.,"GENERAL PLUTARCO ELIAS CALLES, SON.",1,0,1,0,0,0,
27/11/2015,D.F.,"CUAUHTEMOC, D.F.",12,15,27,0,3,240,
27/11/2015,GRO.,"IGUALA DE LA INDEPENDENCIA, GRO.",6,1,7,0,0,65,
27/11/2015,COAH.,"SALTILLO, COAH.",4,2,6,3,2,209,
27/11/2015,B.C.,"ENSENADA, B.C.",3,2,5,0,0,0,
27/11/2015,MOR.,"CUERNAVACA, MOR.",1,3,4,0,2,87,
27/11/2015,COAH.,"TORREÓN, COAH.",4,0,4,1,1,224,
27/11/2015,MEX.,"ALMOLOYA DE JUAREZ, MEX.",2,1,3,1,0,0,
27/11/2015,SON.,"CAJEME, SON.",2,0,2,0,0,0,
27/11/2015,SON.,"NOGALES, SON.",2,0,2,3,0,2,
27/11/2015,SON.,"CANANEA, SON.",2,0,2,0,0,0,
27/11/2015,SON.,"PITIQUITO, SON.",2,0,2,8,0,700,
27/11/2015,COAH.,"MÚZQUIZ, COAH.",1,1,2,0,0,0,
27/11/2015,YUC.,"VALLADOLID, YUC.",0,2,2,0,0,27,
27/11/2015,YUC.,"MOTUL, YUC.",2,0,2,3,0,154,
27/11/2015,N.L.,"MONTERREY, N.L.",2,0,2,1,0,200,
27/11/2015,SON.,"NOGALES, SON.",2,0,2,1,0,0,
27/11/2015,SON.,"SAN LUIS RIO COLORADO, SON.",0,2,2,5,0,0,
27/11/2015,SON.,"SAN MIGUEL DE HORCASITAS, SON.",0,1,1,0,0,0,
27/11/2015,SON.,"NAVOJOA, SON.",0,1,1,0,0,0,
27/11/2015,SON.,"BENITO JUAREZ, SON.",1,0,1,0,0,0,
27/11/2015,MEX.,"COATEPEC HARINAS, MEX.",1,0,1,1,0,0,
27/11/2015,SON.,"MAGDALENA, SON.",0,1,1,0,0,0,
27/11/2015,SON.,"SAN LUIS RIO COLORADO, SON.",1,0,1,0,0,0,
27/11/2015,SON.,"PUERTO PEÑASCO, SON.",1,0,1,0,0,0,
27/11/2015,COAH.,"SAN PEDRO, COAH.",1,0,1,1,0,55,
27/11/2015,COAH.,"SABINAS, COAH.",0,1,1,0,0,0,
27/11/2015,COAH.,"ACUÑA, COAH.",1,0,1,0,0,0,
27/11/2015,PUE.,"PUE., PUE.",1,0,1,0,0,0,
27/11/2015,DGO.,"DGO., DGO.",1,0,1,0,0,0,
27/11/2015,MEX.,"AXAPUSCO, MEX.",0,1,1,0,0,0,
27/11/2015,MEX.,"TEMASCALAPA, MEX.",0,1,1,0,5,0,
27/11/2015,SON.,"MAGDALENA, SON.",1,0,1,0,0,0,
27/11/2015,SON.,"GUAYMAS, SON.",0,0,0,0,0,100,
27/11/2015,SON.,"HUATABAMPO, SON.",0,0,0,3,0,0,
27/11/2015,MOR.,"CUERNAVACA, MOR.",0,0,0,0,1,173,
28/11/2015,D.F.,"CUAUHTEMOC, D.F.",10,9,19,0,0,80,
28/11/2015,MEX.,"ALMOLOYA DE JUAREZ, MEX.",8,1,9,3,0,168,
28/11/2015,B.C.,"TIJUANA, B.C.",9,0,9,0,0,0,
28/11/2015,MOR.,"CUERNAVACA, MOR.",6,1,7,0,9,1000,
28/11/2015,DGO.,"DGO., DGO.",3,2,5,2,0,0,
28/11/2015,B.C.,"ENSENADA, B.C.",1,3,4,0,0,0,
28/11/2015,MEX.,"AXAPUSCO, MEX.",3,1,4,0,0,0,
28/11/2015,MEX.,"TEMASCALAPA, MEX.",0,3,3,0,0,0,
28/11/2015,N.L.,"GRAL. ESCOBEDO, N.L.",2,0,2,0,0,1150,
28/11/2015,SON.,"CAJEME, SON.",2,0,2,0,0,0,
28/11/2015,PUE.,"PUE., PUE.",1,0,1,0,0,0,
28/11/2015,B.C.,"MEXICALI, B.C.",0,1,1,0,0,0,
28/11/2015,SON.,"GUAYMAS, SON.",1,0,1,1,0,0,
28/11/2015,SON.,"ALAMOS, SON.",1,0,1,1,0,0,
29/11/2015,D.F.,"CUAUHTEMOC, D.F.",7,16,23,0,0,22,
29/11/2015,GRO.,"IGUALA DE LA INDEPENDENCIA, GRO.",1,3,4,346,0,0,
29/11/2015,N.L.,"MONTERREY, N.L.",1,0,1,17,0,600,
29/11/2015,SON.,"EMPALME, SON.",0,0,0,1,0,0,
30/11/2015,D.F.,"CUAUHTEMOC, D.F.",10,8,18,0,0,11,
30/11/2015,ZAC.,"ZAC., ZAC.",0,2,2,0,0,0,
30/11/2015,AGS.,"AGS., AGS.",0,1,1,44,0,0,
01/12/2015,D.F.,"CUAUHTEMOC, D.F.",13,9,22,0,0,269,
01/12/2015,GRO.,"IGUALA DE LA INDEPENDENCIA, GRO.",8,2,10,0,0,49,
01/12/2015,GRO.,"IGUALA DE LA INDEPENDENCIA, GRO.",4,2,6,0,0,73,
01/12/2015,COAH.,"SALTILLO, COAH.",4,1,5,0,0,300,
01/12/2015,COAH.,"ACUÑA, COAH.",3,2,5,0,0,309,
01/12/2015,COAH.,"SALTILLO, COAH.",2,2,4,0,0,0,
01/12/2015,SON.,"NOGALES, SON.",3,0,3,11,2,0,
01/12/2015,SON.,"CANANEA, SON.",1,2,3,0,0,0,
01/12/2015,GRO.,"TAXCO DE ALARCON, GRO.",1,2,3,0,0,0,
01/12/2015,GRO.,"ATOYAC DE ALVAREZ, GRO.",0,2,2,0,0,0,
01/12/2015,TAB.,"BALANCAN, TAB.",1,1,2,0,0,0,
01/12/2015,COAH.,"RAMOS ARIZPE, COAH.",1,1,2,0,0,0,
01/12/2015,SON.,"CAJEME, SON.",2,0,2,2,0,559,
01/12/2015,HGO.,"TEPETITLAN, HGO.",1,1,2,0,0,0,
01/12/2015,GRO.,"IXCATEOPAN DE CUAUHTEMOC, GRO.",0,1,1,0,0,0,
01/12/2015,B.C.,"MEXICALI, B.C.",1,0,1,0,0,0,
01/12/2015,DGO.,"DGO., DGO.",1,0,1,0,0,0,
01/12/2015,COAH.,"PIEDRAS NEGRAS, COAH.",0,1,1,0,0,70,
01/12/2015,COAH.,"MATAMOROS, COAH.",1,0,1,0,0,0,
01/12/2015,COAH.,"SAN PEDRO, COAH.",1,0,1,0,1,0,
01/12/2015,MOR.,"CUERNAVACA, MOR.",1,0,1,0,0,0,
01/12/2015,SON.,"NAVOJOA, SON.",0,1,1,0,0,0,
01/12/2015,AGS.,"AGS., AGS.",1,0,1,1,0,0,
01/12/2015,SON.,"SAN LUIS RIO COLORADO, SON.",0,1,1,1,0,0,
01/12/2015,SON.,"PUERTO PEÑASCO, SON.",0,1,1,0,0,0,
01/12/2015,VER.,"PAPANTLA, VER.",1,0,1,0,0,0,
01/12/2015,SON.,"SAHUARIPA, SON.",0,0,0,0,0,107,
01/12/2015,GRO.,"IXCATEOPAN DE CUAUHTEMOC, GRO.",0,0,0,0,1,0,
01/12/2015,SON.,"AGUA PRIETA, SON.",0,0,0,0,1,0,
01/12/2015,SON.,"GENERAL PLUTARCO ELIAS CALLES, SON.",0,0,0,0,0,28,
02/12/2015,D.F.,"CUAUHTEMOC, D.F.",25,19,44,0,5,108,
02/12/2015,B.C.,"TIJUANA, B.C.",9,6,15,0,0,0,
02/12/2015,COAH.,"SALTILLO, COAH.",4,3,7,1,0,138,
02/12/2015,COAH.,"MONCLOVA, COAH.",4,3,7,1,0,267,
02/12/2015,SON.,"HERMOSILLO, SON.",5,1,6,1,0,100,
02/12/2015,S.L.P.,"SAN LUIS POTOSI, S.L.P.",3,0,3,0,0,32,
02/12/2015,SON.,"PITIQUITO, SON.",0,3,3,0,0,0,
02/12/2015,SON.,"GENERAL PLUTARCO ELIAS CALLES, SON.",0,3,3,0,0,0,
02/12/2015,SON.,"NAVOJOA, SON.",2,1,3,1,0,0,
02/12/2015,DGO.,"DGO., DGO.",3,0,3,0,1,0,
02/12/2015,COAH.,"PIEDRAS NEGRAS, COAH.",1,2,3,1,0,0,
02/12/2015,TAMPS.,"MATAMOROS, TAMPS.",1,2,3,2,0,11,
02/12/2015,B.C.,"MEXICALI, B.C.",1,2,3,0,0,0,
02/12/2015,SON.,"MAGDALENA, SON.",2,0,2,0,0,0,
02/12/2015,SON.,"HUATABAMPO, SON.",2,0,2,3,0,0,
02/12/2015,AGS.,"AGS., AGS.",1,1,2,8,0,68,
02/12/2015,COAH.,"ACUÑA, COAH.",1,1,2,0,0,0,
02/12/2015,B.C.,"ENSENADA, B.C.",1,1,2,0,0,0,
02/12/2015,S.L.P.,"CIUDAD VALLES, S.L.P.",1,0,1,0,1,0,
02/12/2015,SON.,"NOGALES, SON.",1,0,1,0,0,22,
02/12/2015,SON.,"CABORCA, SON.",0,1,1,1,0,0,
02/12/2015,SON.,"PUERTO PEÑASCO, SON.",1,0,1,2,0,0,
02/12/2015,PUE.,"PUE., PUE.",1,0,1,0,0,0,
02/12/2015,COAH.,"MATAMOROS, COAH.",1,0,1,0,0,6,
02/12/2015,COAH.,"RAMOS ARIZPE, COAH.",1,0,1,0,0,0,
02/12/2015,COAH.,"MATAMOROS, COAH.",1,0,1,0,0,6,
02/12/2015,CHIS.,"REFORMA, CHIS.",1,0,1,1,0,0,
02/12/2015,SON.,"SAN LUIS RIO COLORADO, SON.",0,0,0,6,0,116,
02/12/2015,SON.,"AGUA PRIETA, SON.",0,0,0,2,0,0,
02/12/2015,SON.,"CABORCA, SON.",0,0,0,0,0,1,
02/12/2015,GRO.,"ATOYAC DE ALVAREZ, GRO.",0,0,0,0,2,0,
02/12/2015,TAB.,"PARAISO, TAB.",0,0,0,2,0,47,
03/12/2015,D.F.,"CUAUHTEMOC, D.F.",25,14,39,0,0,206,
03/12/2015,DGO.,"DGO., DGO.",5,1,6,8,1,0,
03/12/2015,SON.,"GENERAL PLUTARCO ELIAS CALLES, SON.",1,2,3,1,0,0,
03/12/2015,PUE.,"PUE., PUE.",3,0,3,0,0,22,
03/12/2015,SON.,"NOGALES, SON.",2,0,2,1,0,65,
03/12/2015,SON.,"AGUA PRIETA, SON.",1,1,2,1,0,24,
03/12/2015,N.L.,"MONTERREY, N.L.",2,0,2,0,0,0,
03/12/2015,N.L.,"SAN NICOLAS DE LOS GARZA, N.L.",1,0,1,0,0,280,
03/12/2015,COAH.,"SAN PEDRO, COAH.",1,0,1,0,0,0,
03/12/2015,GRO.,"TAXCO DE ALARCON, GRO.",1,0,1,0,0,0,
03/12/2015,N.L.,"SAN NICOLAS DE LOS GARZA, N.L.",0,1,1,1,0,350,
03/12/2015,N.L.,"MONTERREY, N.L.",0,0,0,0,1,0,
03/12/2015,SON.,"CABORCA, SON.",0,0,0,3,0,60,
04/12/2015,D.F.,"CUAUHTEMOC, D.F.",15,17,32,0,3,203,
04/12/2015,COAH.,"SALTILLO, COAH.",20,5,25,5,0,793,
04/12/2015,S.L.P.,"SAN LUIS POTOSI, S.L.P.",13,7,20,0,2,0,
04/12/2015,CHIS.,"TUXTLA GUTIÉRREZ, CHIS.",14,4,18,2,2,1148,
04/12/2015,COAH.,"TORREÓN, COAH.",7,2,9,1,0,198,
04/12/2015,SON.,"HUATABAMPO, SON.",5,2,7,1,0,0,
04/12/2015,COAH.,"MONCLOVA, COAH.",3,2,5,2,0,211,
04/12/2015,S.L.P.,"CIUDAD VALLES, S.L.P.",5,0,5,0,2,0,
04/12/2015,SON.,"HERMOSILLO, SON.",4,0,4,0,0,0,
04/12/2015,GRO.,"TAXCO DE ALARCON, GRO.",3,1,4,0,1,0,
04/12/2015,SON.,"ALAMOS, SON.",1,2,3,1,0,184,
04/12/2015,SON.,"ETCHOJOA, SON.",0,3,3,0,0,0,
04/12/2015,B.C.,"TIJUANA, B.C.",0,2,2,0,0,0,
04/12/2015,SON.,"NAVOJOA, SON.",1,1,2,0,0,100,
04/12/2015,SON.,"SAN LUIS RIO COLORADO, SON.",1,1,2,1,1,93,
04/12/2015,TAB.,"TENOSIQUE, TAB.",0,2,2,0,0,0,
04/12/2015,S.L.P.,"SALINAS, S.L.P.",1,1,2,0,0,0,
04/12/2015,COAH.,"ACUÑA, COAH.",0,1,1,0,0,0,
04/12/2015,N.L.,"SAN NICOLAS DE LOS GARZA, N.L.",1,0,1,0,0,0,
04/12/2015,CHIH.,"OJINAGA, CHIH.",0,1,1,0,0,0,
04/12/2015,B.C.,"MEXICALI, B.C.",1,0,1,0,0,0,
04/12/2015,SON.,"CABORCA, SON.",1,0,1,0,0,0,
04/12/2015,SON.,"AGUA PRIETA, SON.",0,1,1,0,0,0,
04/12/2015,SON.,"PUERTO PEÑASCO, SON.",1,0,1,3,0,0,
04/12/2015,DGO.,"DGO., DGO.",1,0,1,0,0,0,
04/12/2015,TAB.,"JONUTA, TAB.",1,0,1,0,0,0,
04/12/2015,S.L.P.,"RIOVERDE, S.L.P.",1,0,1,0,0,100,
04/12/2015,TAB.,"TENOSIQUE, TAB.",1,0,1,0,0,0,
04/12/2015,N.L.,"MONTERREY, N.L.",0,0,0,0,0,3300,
04/12/2015,SON.,"GUAYMAS, SON.",0,0,0,0,1,0,
04/12/2015,HGO.,"TEPETITLAN, HGO.",0,0,0,0,0,200,
04/12/2015,PUE.,"ATLIXCO, PUE.",0,0,0,0,0,31,
05/12/2015,D.F.,"CUAUHTEMOC, D.F.",12,13,25,0,4,1261,
05/12/2015,CHIS.,"TUXTLA GUTIÉRREZ, CHIS.",11,4,15,6,0,1957,
05/12/2015,S.L.P.,"SAN LUIS POTOSI, S.L.P.",12,1,13,0,0,25,
05/12/2015,COAH.,"SALTILLO, COAH.",8,2,10,0,0,0,
05/12/2015,SON.,"HERMOSILLO, SON.",3,5,8,5,0,0,
05/12/2015,DGO.,"DGO., DGO.",5,2,7,22,1,0,
05/12/2015,GRO.,"TAXCO DE ALARCON, GRO.",1,3,4,0,0,0,
05/12/2015,S.L.P.,"CIUDAD VALLES, S.L.P.",3,0,3,0,0,0,
05/12/2015,TAMPS.,"NUEVO LAREDO, TAMPS.",0,2,2,0,0,0,
05/12/2015,TAMPS.,"MATAMOROS, TAMPS.",2,0,2,2,0,0,
05/12/2015,SON.,"EMPALME, SON.",2,0,2,0,0,0,
05/12/2015,SON.,"ALTAR, SON.",1,1,2,0,0,0,
05/12/2015,COAH.,"TORREÓN, COAH.",1,1,2,12,0,0,
05/12/2015,GRO.,"PEDRO ASCENCIO ALQUISIRAS, GRO.",0,1,1,0,0,0,
05/12/2015,CHIH.,"OJINAGA, CHIH.",1,0,1,0,0,0,
05/12/2015,SON.,"NOGALES, SON.",0,1,1,2,0,0,
05/12/2015,SON.,"SANTA ANA, SON.",0,1,1,0,0,0,
05/12/2015,SON.,"CANANEA, SON.",1,0,1,5,0,0,
05/12/2015,SON.,"CABORCA, SON.",1,0,1,0,0,0,
05/12/2015,SON.,"PUERTO PEÑASCO, SON.",0,1,1,0,0,38,
05/12/2015,COAH.,"PIEDRAS NEGRAS, COAH.",1,0,1,24,0,30,
05/12/2015,COAH.,"ACUÑA, COAH.",0,1,1,0,0,0,
05/12/2015,S.L.P.,"RIOVERDE, S.L.P.",1,0,1,1,0,0,
05/12/2015,S.L.P.,"SALINAS, S.L.P.",1,0,1,0,0,0,
05/12/2015,N.L.,"SAN NICOLAS DE LOS GARZA, N.L.",1,0,1,0,0,0,
05/12/2015,COAH.,"MONCLOVA, COAH.",0,0,0,1,0,121,
06/12/2015,D.F.,"CUAUHTEMOC, D.F.",10,17,27,0,3,450,
06/12/2015,COAH.,"MATAMOROS, COAH.",5,0,5,0,0,0,
06/12/2015,COAH.,"MATAMOROS, COAH.",5,0,5,0,0,0,
06/12/2015,COAH.,"SALTILLO, COAH.",4,0,4,0,1,0,
06/12/2015,B.C.,"MEXICALI, B.C.",1,2,3,0,0,0,
06/12/2015,COAH.,"TORREÓN, COAH.",3,0,3,11,0,0,
06/12/2015,COAH.,"TORREÓN, COAH.",3,0,3,11,0,0,
06/12/2015,TAMPS.,"MATAMOROS, TAMPS.",2,0,2,0,0,0,
06/12/2015,GRO.,"TAXCO DE ALARCON, GRO.",1,0,1,0,0,0,
06/12/2015,GRO.,"PEDRO ASCENCIO ALQUISIRAS, GRO.",0,1,1,0,0,0,
06/12/2015,B.C.,"ENSENADA, B.C.",0,1,1,0,0,0,
06/12/2015,SON.,"HERMOSILLO, SON.",1,0,1,0,0,0,
06/12/2015,COAH.,"PIEDRAS NEGRAS, COAH.",1,0,1,0,0,70,
06/12/2015,COAH.,"MONCLOVA, COAH.",1,0,1,0,0,0,
06/12/2015,TAMPS.,"NUEVO LAREDO, TAMPS.",1,0,1,0,1,0,
07/12/2015,S.L.P.,"SAN LUIS POTOSI, S.L.P.",47,11,58,2,2,460,
07/12/2015,D.F.,"CUAUHTEMOC, D.F.",7,9,16,0,2,32,
07/12/2015,S.L.P.,"CIUDAD VALLES, S.L.P.",14,2,16,0,4,434,
07/12/2015,B.C.,"TIJUANA, B.C.",9,5,14,0,0,0,
07/12/2015,S.L.P.,"RIOVERDE, S.L.P.",5,3,8,0,0,100,
07/12/2015,S.L.P.,"SALINAS, S.L.P.",5,1,6,0,0,0,
07/12/2015,DGO.,"DGO., DGO.",3,2,5,3,0,0,
07/12/2015,QRO.,"SAN JUAN DEL RIO, QRO.",3,1,4,0,0,0,
07/12/2015,SON.,"HERMOSILLO, SON.",2,1,3,20,0,0,
07/12/2015,SON.,"ALAMOS, SON.",2,1,3,0,0,0,
07/12/2015,SON.,"SAN LUIS RIO COLORADO, SON.",1,1,2,2,0,38,
07/12/2015,B.C.,"TIJUANA, B.C.",2,0,2,0,0,0,
07/12/2015,B.C.,"ENSENADA, B.C.",0,2,2,0,0,0,
07/12/2015,SON.,"ALTAR, SON.",0,1,1,0,0,0,
07/12/2015,SON.,"CANANEA, SON.",1,0,1,0,0,0,
07/12/2015,SON.,"CABORCA, SON.",1,0,1,0,0,0,
07/12/2015,SON.,"GENERAL PLUTARCO ELIAS CALLES, SON.",0,1,1,0,1,0,
07/12/2015,MOR.,"CUERNAVACA, MOR.",0,1,1,0,0,0,
07/12/2015,SON.,"EMPALME, SON.",0,1,1,0,0,0,
07/12/2015,SON.,"MAGDALENA, SON.",0,0,0,0,0,45,
07/12/2015,Q. ROO,"COZUMEL, Q. ROO",0,0,0,0,0,20,
07/12/2015,SON.,"SAN MIGUEL DE HORCASITAS, SON.",0,0,0,19,0,0,
07/12/2015,SON.,"GUAYMAS, SON.",0,0,0,0,1,0,
08/12/2015,S.L.P.,"SAN LUIS POTOSI, S.L.P.",12,2,14,0,0,0,
08/12/2015,D.F.,"CUAUHTEMOC, D.F.",3,7,10,0,0,25,
08/12/2015,SON.,"HERMOSILLO, SON.",3,7,10,1,0,0,
08/12/2015,CHIH.,"HGO. DEL PARRAL, CHIH.",4,2,6,0,0,538,
08/12/2015,S.L.P.,"CIUDAD VALLES, S.L.P.",1,1,2,0,0,0,
08/12/2015,S.L.P.,"RIOVERDE, S.L.P.",2,0,2,0,0,200,
08/12/2015,SON.,"CANANEA, SON.",0,2,2,0,0,0,
08/12/2015,SON.,"PITIQUITO, SON.",1,1,2,0,0,151,
08/12/2015,S.L.P.,"SALINAS, S.L.P.",1,0,1,0,0,0,
08/12/2015,QRO.,"SAN JUAN DEL RIO, QRO.",0,1,1,0,0,0,
08/12/2015,SON.,"ALAMOS, SON.",1,0,1,0,0,0,
08/12/2015,SON.,"NAVOJOA, SON.",0,1,1,1,0,0,
08/12/2015,SON.,"BENITO JUAREZ, SON.",1,0,1,0,0,0,
08/12/2015,MOR.,"CUERNAVACA, MOR.",0,1,1,0,0,0,
08/12/2015,B.C.,"TIJUANA, B.C.",1,0,1,0,0,0,
08/12/2015,SON.,"SANTA ANA, SON.",1,0,1,0,0,0,
08/12/2015,SON.,"SAN LUIS RIO COLORADO, SON.",0,1,1,0,0,0,
08/12/2015,SON.,"AGUA PRIETA, SON.",0,1,1,0,0,43,
08/12/2015,SON.,"CARBO, SON.",0,0,0,10,0,0,
08/12/2015,Q. ROO,"COZUMEL, Q. ROO",0,0,0,0,0,161,
08/12/2015,SON.,"NOGALES, SON.",0,0,0,0,44,0,
08/12/2015,SON.,"CABORCA, SON.",0,0,0,1,0,0,
09/12/2015,CHIH.,"HGO. DEL PARRAL, CHIH.",12,7,19,1,0,614,
09/12/2015,S.L.P.,"SAN LUIS POTOSI, S.L.P.",15,0,15,1,0,0,
09/12/2015,S.L.P.,"SAN LUIS POTOSI, S.L.P.",10,2,12,2,0,242,
09/12/2015,SON.,"HERMOSILLO, SON.",3,4,7,0,0,0,
09/12/2015,CHIH.,"HGO. DEL PARRAL, CHIH.",4,3,7,1,0,154,
09/12/2015,SON.,"HERMOSILLO, SON.",4,0,4,2,0,100,
09/12/2015,B.C.,"TIJUANA, B.C.",3,1,4,0,0,0,
09/12/2015,S.L.P.,"CIUDAD VALLES, S.L.P.",1,2,3,0,1,270,
09/12/2015,S.L.P.,"RIOVERDE, S.L.P.",2,1,3,0,0,0,
09/12/2015,GTO.,"SAN JUAN DEL RIO, QRO.",2,0,2,0,0,0,
09/12/2015,QRO.,"SAN JUAN DEL RIO, QRO.",2,0,2,0,0,0,
09/12/2015,SON.,"GUAYMAS, SON.",0,2,2,0,0,0,
09/12/2015,SON.,"HUATABAMPO, SON.",2,0,2,0,0,0,
09/12/2015,B.C.,"ENSENADA, B.C.",1,1,2,0,0,0,
09/12/2015,GRO.,"HUITZUCO DE LOS FIGUEROA, GRO.",2,0,2,0,0,0,
09/12/2015,S.L.P.,"CIUDAD VALLES, S.L.P.",0,2,2,0,0,0,
09/12/2015,S.L.P.,"SALINAS, S.L.P.",1,0,1,0,0,0,
09/12/2015,Q. ROO,"COZUMEL, Q. ROO",1,0,1,0,0,184,
09/12/2015,SON.,"SAN LUIS RIO COLORADO, SON.",0,1,1,0,0,0,
09/12/2015,SON.,"PUERTO PEÑASCO, SON.",0,1,1,0,0,250,
09/12/2015,S.L.P.,"RIOVERDE, S.L.P.",0,1,1,1,0,0,
09/12/2015,CHIS.,"JUÁREZ, CHIS.",0,1,1,0,0,0,
09/12/2015,YUC.,"TELCHAC PUEBLO, YUC.",0,0,0,1,0,403,
09/12/2015,SON.,"SAN MIGUEL DE HORCASITAS, SON.",0,0,0,5,0,0,
09/12/2015,N.L.,"SAN NICOLAS DE LOS GARZA, N.L.",0,0,0,220,0,0,
09/12/2015,TAMPS.,"NUEVO LAREDO, TAMPS.",0,0,0,0,0,42,
09/12/2015,SON.,"NOGALES, SON.",0,0,0,0,0,55,
10/12/2015,D.F.,"CUAUHTEMOC, D.F.",5,14,19,0,6,26,
10/12/2015,CHIH.,"HGO. DEL PARRAL, CHIH.",14,2,16,8,3,758,
10/12/2015,S.L.P.,"SAN LUIS POTOSI, S.L.P.",10,3,13,7,0,232,
10/12/2015,B.C.,"MEXICALI, B.C.",2,6,8,0,0,0,
10/12/2015,SON.,"ALAMOS, SON.",5,0,5,0,0,44,
10/12/2015,S.L.P.,"SALINAS, S.L.P.",4,0,4,0,0,0,
10/12/2015,SON.,"HERMOSILLO, SON.",4,0,4,2,0,0,
10/12/2015,S.L.P.,"CIUDAD VALLES, S.L.P.",1,1,2,0,0,0,
10/12/2015,MOR.,"CUERNAVACA, MOR.",1,1,2,0,1,0,
10/12/2015,B.C.,"ENSENADA, B.C.",0,2,2,0,0,0,
10/12/2015,SON.,"NAVOJOA, SON.",2,0,2,1,0,100,
10/12/2015,SON.,"BENITO JUAREZ, SON.",2,0,2,0,0,0,
10/12/2015,SON.,"NOGALES, SON.",1,0,1,0,0,0,
10/12/2015,SON.,"SANTA ANA, SON.",1,0,1,0,0,0,
10/12/2015,SON.,"CANANEA, SON.",1,0,1,0,0,0,
10/12/2015,SON.,"SAN LUIS RIO COLORADO, SON.",0,1,1,1,0,0,
10/12/2015,SON.,"CABORCA, SON.",1,0,1,1,0,0,
10/12/2015,QRO.,"SAN JUAN DEL RIO, QRO.",1,0,1,0,1,0,
10/12/2015,S.L.P.,"RIOVERDE, S.L.P.",1,0,1,0,0,0,
10/12/2015,SON.,"SAN MIGUEL DE HORCASITAS, SON.",0,1,1,7,0,0,
10/12/2015,SON.,"EMPALME, SON.",1,0,1,0,0,0,
10/12/2015,SON.,"HUATABAMPO, SON.",1,0,1,0,0,0,
10/12/2015,TAB.,"TENOSIQUE, TAB.",0,1,1,0,0,0,
10/12/2015,Q. ROO,"COZUMEL, Q. ROO",0,0,0,0,0,130,
10/12/2015,PUE.,"ATLIXCO, PUE.",0,0,0,0,0,67,
10/12/2015,DGO.,"DGO., DGO.",0,0,0,3,0,0,
10/12/2015,SON.,"CARBO, SON.",0,0,0,10,0,0,
11/12/2015,D.F.,"CUAUHTEMOC, D.F.",8,7,15,0,9,10,
11/12/2015,CHIH.,"HGO. DEL PARRAL, CHIH.",10,1,11,5,0,287,
11/12/2015,SON.,"HERMOSILLO, SON.",5,3,8,54,0,300,
11/12/2015,SON.,"SAN LUIS RIO COLORADO, SON.",2,3,5,5,0,30,
11/12/2015,S.L.P.,"SAN LUIS POTOSI, S.L.P.",5,0,5,0,0,120,
11/12/2015,SON.,"CABORCA, SON.",2,2,4,0,0,0,
11/12/2015,S.L.P.,"CIUDAD VALLES, S.L.P.",2,2,4,0,1,36,
11/12/2015,N.L.,"SAN NICOLAS DE LOS GARZA, N.L.",2,1,3,0,0,65,
11/12/2015,SON.,"NAVOJOA, SON.",2,0,2,2,0,0,
11/12/2015,SON.,"NOGALES, SON.",2,0,2,2,0,37,
11/12/2015,SON.,"MAGDALENA, SON.",2,0,2,1,0,0,
11/12/2015,MOR.,"CUERNAVACA, MOR.",1,1,2,0,3,0,
11/12/2015,B.C.,"TIJUANA, B.C.",2,0,2,0,0,0,
11/12/2015,TAB.,"BALANCAN, TAB.",1,0,1,0,0,0,
11/12/2015,SON.,"HERMOSILLO, SON.",1,0,1,0,0,23,
11/12/2015,SON.,"ETCHOJOA, SON.",0,1,1,0,0,0,
11/12/2015,SON.,"ALTAR, SON.",0,1,1,0,0,0,
11/12/2015,SON.,"AGUA PRIETA, SON.",0,1,1,0,0,0,
11/12/2015,SON.,"GENERAL PLUTARCO ELIAS CALLES, SON.",0,1,1,0,0,99,
11/12/2015,B.C.,"ENSENADA, B.C.",0,1,1,0,0,0,
11/12/2015,TAMPS.,"MATAMOROS, TAMPS.",1,0,1,0,0,0,
11/12/2015,PUE.,"PUE., PUE.",1,0,1,0,0,0,
11/12/2015,ZAC.,"ZAC., ZAC.",0,1,1,0,0,74,
11/12/2015,QRO.,"SAN JUAN DEL RIO, QRO.",1,0,1,0,0,0,
11/12/2015,S.L.P.,"SALINAS, S.L.P.",1,0,1,0,0,0,
11/12/2015,SON.,"PUERTO PEÑASCO, SON.",0,0,0,0,0,181,
12/12/2015,SON.,"HERMOSILLO, SON.",17,0,17,79,0,100,
12/12/2015,SON.,"NAVOJOA, SON.",9,3,12,1,0,50,
12/12/2015,D.F.,"CUAUHTEMOC, D.F.",3,7,10,0,6,8,
12/12/2015,B.C.,"TIJUANA, B.C.",1,4,5,0,0,0,
12/12/2015,SON.,"NOGALES, SON.",2,3,5,0,0,128,
12/12/2015,S.L.P.,"SALINAS, S.L.P.",4,0,4,0,0,0,
12/12/2015,S.L.P.,"SAN LUIS POTOSI, S.L.P.",2,1,3,0,0,0,
12/12/2015,SON.,"SAN LUIS RIO COLORADO, SON.",3,0,3,0,0,50,
12/12/2015,N.L.,"SAN NICOLAS DE LOS GARZA, N.L.",3,0,3,221,0,50,
12/12/2015,CHIH.,"HGO. DEL PARRAL, CHIH.",2,0,2,1,0,210,
12/12/2015,SON.,"AGUA PRIETA, SON.",1,1,2,1,0,11,
12/12/2015,S.L.P.,"CIUDAD VALLES, S.L.P.",1,0,1,0,0,0,
12/12/2015,SON.,"CANANEA, SON.",1,0,1,1,0,30,
12/12/2015,SON.,"CABORCA, SON.",1,0,1,1,0,0,
12/12/2015,SON.,"PITIQUITO, SON.",1,0,1,1,0,0,
12/12/2015,SON.,"PUERTO PEÑASCO, SON.",1,0,1,2,0,31,
12/12/2015,MOR.,"CUERNAVACA, MOR.",1,0,1,0,8,1017,
12/12/2015,N.L.,"MONTERREY, N.L.",1,0,1,0,0,0,
12/12/2015,SON.,"GUAYMAS, SON.",0,1,1,0,0,0,
12/12/2015,SON.,"EMPALME, SON.",1,0,1,2,0,124,
12/12/2015,SON.,"MAGDALENA, SON.",0,0,0,0,0,46,
12/12/2015,TAMPS.,"TAMPICO, TAMPS.",0,0,0,7,0,307,
13/12/2015,S.L.P.,"SALINAS, S.L.P.",4,0,4,0,0,0,
13/12/2015,S.L.P.,"SAN LUIS POTOSI, S.L.P.",2,1,3,0,0,0,
13/12/2015,CHIH.,"HGO. DEL PARRAL, CHIH.",2,0,2,0,0,11,
13/12/2015,S.L.P.,"CIUDAD VALLES, S.L.P.",1,0,1,0,0,0,
13/12/2015,N.L.,"SAN NICOLAS DE LOS GARZA, N.L.",0,0,0,260,0,78,
14/12/2015,D.F.,"CUAUHTEMOC, D.F.",8,8,16,0,0,5,
14/12/2015,CHIH.,"HGO. DEL PARRAL, CHIH.",7,2,9,15,1,207,
14/12/2015,QRO.,"SAN JUAN DEL RIO, QRO.",2,2,4,0,0,0,
14/12/2015,B.C.,"MEXICALI, B.C.",0,2,2,0,0,0,
14/12/2015,DGO.,"DGO., DGO.",1,1,2,1,0,0,
14/12/2015,N.L.,"MONTERREY, N.L.",0,1,1,0,0,0,
15/12/2015,D.F.,"CUAUHTEMOC, D.F.",7,4,11,0,10,27,
15/12/2015,CHIH.,"HGO. DEL PARRAL, CHIH.",5,0,5,0,0,289,
15/12/2015,GRO.,"CHILPANCINGO DE LOS BRAVO, GRO.",2,0,2,0,0,0,
15/12/2015,GRO.,"ATOYAC DE ALVAREZ, GRO.",1,1,2,0,0,0,
15/12/2015,Q. ROO,"COZUMEL, Q. ROO",2,0,2,0,0,902,
15/12/2015,GRO.,"GENERAL CANUTO A. NERI, GRO.",0,1,1,0,0,0,
15/12/2015,QRO.,"SAN JUAN DEL RIO, QRO.",1,0,1,0,0,0,
15/12/2015,QRO.,"SAN JUAN DEL RIO, QRO.",1,0,1,0,0,0,
16/12/2015,D.F.,"CUAUHTEMOC, D.F.",5,9,14,0,0,46,
16/12/2015,CHIH.,"HGO. DEL PARRAL, CHIH.",9,0,9,21,1,390,
16/12/2015,DGO.,"DGO., DGO.",2,2,4,1,0,0,
16/12/2015,B.C.,"MEXICALI, B.C.",1,3,4,0,0,0,
16/12/2015,QRO.,"SAN JUAN DEL RIO, QRO.",2,0,2,0,0,0,
16/12/2015,N.L.,"SAN NICOLAS DE LOS GARZA, N.L.",1,0,1,243,0,12100,
16/12/2015,N.L.,"MONTERREY, N.L.",1,0,1,1,0,0,
16/12/2015,YUC.,"CELESTUN, YUC.",0,0,0,0,0,198,
16/12/2015,TAB.,"CARDENAS, TAB.",0,0,0,0,1,0,
16/12/2015,N.L.,"GRAL. ESCOBEDO, N.L.",0,0,0,250,0,100,
17/12/2015,D.F.,"CUAUHTEMOC, D.F.",12,15,27,0,3,16,
17/12/2015,CHIS.,"COMITAN DE DOMÍNGUEZ, CHIS.",3,2,5,4,0,21,
17/12/2015,CHIH.,"HGO. DEL PARRAL, CHIH.",4,1,5,16,0,1412,
17/12/2015,N.L.,"SAN NICOLAS DE LOS GARZA, N.L.",0,1,1,274,0,39,
17/12/2015,YUC.,"ABALA, YUC.",0,1,1,0,0,319,
17/12/2015,B.C.,"TIJUANA, B.C.",0,1,1,0,0,0,
17/12/2015,B.C.,"MEXICALI, B.C.",1,0,1,0,0,0,
18/12/2015,D.F.,"CUAUHTEMOC, D.F.",17,21,38,0,1,64,
18/12/2015,CHIH.,"HGO. DEL PARRAL, CHIH.",4,1,5,16,0,1412,
18/12/2015,CHIH.,"HGO. DEL PARRAL, CHIH.",1,2,3,33,0,1204,
18/12/2015,B.C.,"MEXICALI, B.C.",3,0,3,0,0,0,
18/12/2015,B.C.,"TIJUANA, B.C.",1,0,1,0,0,0,
18/12/2015,B.C.,"ENSENADA, B.C.",0,1,1,0,0,0,
18/12/2015,GRO.,"COAHUAYUTLA DE JOSE MARIA IZAZAGA, GRO.",0,1,1,0,0,219,
18/12/2015,DGO.,"LERDO, DGO.",1,0,1,0,0,0,
18/12/2015,N.L.,"SAN NICOLAS DE LOS GARZA, N.L.",0,0,0,350,0,1050,
19/12/2015,DGO.,"DGO., DGO.",0,4,4,0,0,0,
19/12/2015,DGO.,"LERDO, DGO.",1,0,1,1,0,0,
19/12/2015,TAMPS.,"REYNOSA, TAMPS.",0,1,1,0,0,0,
19/12/2015,N.L.,"SAN NICOLAS DE LOS GARZA, N.L.",0,1,1,120,0,0,
19/12/2015,N.L.,"MONTERREY, N.L.",0,1,1,172,0,2600,
19/12/2015,B.C.,"ENSENADA, B.C.",1,0,1,0,0,0,
19/12/2015,B.C.,"MEXICALI, B.C.",1,0,1,0,0,0,
19/12/2015,CHIS.,"COMITAN DE DOMÍNGUEZ, CHIS.",0,0,0,0,0,122,
20/12/2015,CHIS.,"COMITAN DE DOMÍNGUEZ, CHIS.",1,1,2,0,0,421,
21/12/2015,TAMPS.,"MATAMOROS, TAMPS.",2,1,3,0,0,910,
21/12/2015,NAY.,"TEPIC, NAY.",1,0,1,2,0,0,
21/12/2015,NAY.,"XALISCO, NAY.",0,1,1,0,0,0,
21/12/2015,B.C.,"MEXICALI, B.C.",1,0,1,0,0,0,
21/12/2015,DGO.,"DGO., DGO.",0,1,1,0,0,0,
21/12/2015,CHIS.,"JUÁREZ, CHIS.",0,0,0,2,0,34,
22/12/2015,B.C.,"MEXICALI, B.C.",0,3,3,0,0,0,
22/12/2015,DGO.,"DGO., DGO.",1,1,2,122,1,0,
23/12/2015,TAMPS.,"REYNOSA, TAMPS.",5,0,5,177,0,0,
23/12/2015,B.C.,"MEXICALI, B.C.",0,4,4,0,0,0,
23/12/2015,B.C.,"ENSENADA, B.C.",1,2,3,0,0,0,
23/12/2015,DGO.,"DGO., DGO.",1,1,2,2,0,0,
23/12/2015,B.C.,"TIJUANA, B.C.",0,1,1,0,0,0,
23/12/2015,VER.,"TANTOYUCA, VER.",1,0,1,0,0,0,
24/12/2015,B.C.,"MEXICALI, B.C.",0,6,6,0,0,0,
24/12/2015,B.C.,"TIJUANA, B.C.",4,0,4,0,0,0,
24/12/2015,VER.,"TANTOYUCA, VER.",1,0,1,0,0,0,
25/12/2015,VER.,"TANTOYUCA, VER.",1,0,1,0,0,0,
26/12/2015,B.C.,"ENSENADA, B.C.",1,1,2,0,0,0,
27/12/2015,B.C.,"ENSENADA, B.C.",0,1,1,0,0,0,
28/12/2015,B.C.,"TIJUANA, B.C.",0,4,4,0,0,0,
29/12/2015,GRO.,"FLORENCIO VILLARREAL, GRO.",4,1,5,0,0,0,
29/12/2015,B.C.,"TIJUANA, B.C.",1,1,2,0,0,0,
30/12/2015,GRO.,"FLORENCIO VILLARREAL, GRO.",1,2,3,0,0,0,
30/12/2015,DGO.,"DGO., DGO.",2,0,2,0,0,0,
30/12/2015,B.C.,"TIJUANA, B.C.",2,0,2,0,0,0,
30/12/2015,B.C.,"ENSENADA, B.C.",0,1,1,0,0,0,
30/12/2015,B.C.,"ENSENADA, B.C.",0,1,1,0,0,0,
01/01/2016,TAMPS.,"NUEVO LAREDO, TAMPS.",2,2,4,0,0,171,
02/01/2016,B.C.,"TIJUANA, B.C.",3,2,5,0,0,0,
02/01/2016,B.C.,"MEXICALI, B.C.",0,1,1,0,0,0,
04/01/2016,B.C.,"TIJUANA, B.C.",2,3,5,0,0,0,
04/01/2016,DGO.,"DGO., DGO.",0,1,1,0,0,0,
07/01/2016,B.C.,"TIJUANA, B.C.",1,0,1,0,0,0,
07/01/2016,DGO.,"DGO., DGO.",0,1,1,3,0,0,
07/01/2016,YUC.,"DZILAM DE BRAVO, YUC.",0,0,0,0,0,33,
08/01/2016,B.C.,"TIJUANA, B.C.",4,2,6,0,0,0,
08/01/2016,DGO.,"DGO., DGO.",2,0,2,0,1,0,
08/01/2016,ZAC.,"ZAC., ZAC.",0,1,1,3,0,141,
10/01/2016,TAMPS.,"MATAMOROS, TAMPS.",5,2,7,0,0,0,
11/01/2016,DGO.,"DGO., DGO.",1,0,1,0,0,0,
11/01/2016,COAH.,"MATAMOROS, COAH.",1,0,1,0,0,0,
11/01/2016,CHIS.,"REFORMA, CHIS.",0,1,1,0,0,0,
12/01/2016,D.F.,"CUAUHTEMOC, D.F.",32,34,66,18,0,3,
12/01/2016,COAH.,"PIEDRAS NEGRAS, COAH.",1,3,4,0,0,0,
12/01/2016,B.C.,"ENSENADA, B.C.",0,1,1,0,0,0,
12/01/2016,COAH.,"MONCLOVA, COAH.",1,0,1,1,0,0,
12/01/2016,DGO.,"DGO., DGO.",0,0,0,0,2,0,
13/01/2016,D.F.,"CUAUHTEMOC, D.F.",18,5,23,0,0,363,
13/01/2016,COAH.,"PIEDRAS NEGRAS, COAH.",1,3,4,1,0,30,
13/01/2016,CAMP.,"CAMP., CAMP.",0,3,3,1,0,0,
13/01/2016,B.C.,"TIJUANA, B.C.",2,0,2,0,0,0,
13/01/2016,COAH.,"TORREÓN, COAH.",1,0,1,0,0,0,
13/01/2016,COAH.,"SAN PEDRO, COAH.",1,0,1,0,0,0,
13/01/2016,COAH.,"SALTILLO, COAH.",1,0,1,0,0,0,
13/01/2016,COAH.,"MONCLOVA, COAH.",0,1,1,0,0,0,
13/01/2016,COAH.,"MÚZQUIZ, COAH.",1,0,1,3,0,0,
14/01/2016,D.F.,"CUAUHTEMOC, D.F.",16,9,25,0,2,25,
14/01/2016,COAH.,"SALTILLO, COAH.",5,0,5,2,0,8,
14/01/2016,COAH.,"TORREÓN, COAH.",1,2,3,0,0,0,
14/01/2016,CAMP.,"CAMP., CAMP.",0,3,3,1,0,0,
14/01/2016,COAH.,"SAN PEDRO, COAH.",1,0,1,0,0,0,
14/01/2016,COAH.,"MONCLOVA, COAH.",0,1,1,0,0,705,
14/01/2016,COAH.,"MÚZQUIZ, COAH.",0,1,1,6,0,0,
14/01/2016,COAH.,"SABINAS, COAH.",0,1,1,0,0,400,
14/01/2016,YUC.,"MAXCANU, YUC.",0,0,0,2,0,625,
15/01/2016,D.F.,"CUAUHTEMOC, D.F.",29,15,44,0,4,24,
15/01/2016,COAH.,"PIEDRAS NEGRAS, COAH.",2,3,5,3,0,34,
15/01/2016,COAH.,"SAN PEDRO, COAH.",5,0,5,0,0,0,
15/01/2016,COAH.,"SALTILLO, COAH.",2,3,5,0,0,100,
15/01/2016,B.C.,"MEXICALI, B.C.",2,1,3,0,0,0,
15/01/2016,COAH.,"TORREÓN, COAH.",1,0,1,0,0,0,
15/01/2016,DGO.,"DGO., DGO.",1,0,1,0,0,0,
15/01/2016,CHIS.,"REFORMA, CHIS.",0,0,0,0,0,47,
16/01/2016,COAH.,"PIEDRAS NEGRAS, COAH.",5,5,10,0,0,0,
16/01/2016,CAMP.,"CAMP., CAMP.",0,3,3,1,0,0,
16/01/2016,COAH.,"MATAMOROS, COAH.",3,0,3,0,0,0,
16/01/2016,TAMPS.,"MATAMOROS, TAMPS.",0,2,2,0,0,0,
16/01/2016,B.C.,"ENSENADA, B.C.",0,2,2,0,0,0,
16/01/2016,B.C.,"MEXICALI, B.C.",1,1,2,0,0,0,
16/01/2016,COAH.,"TORREÓN, COAH.",1,0,1,0,0,0,
16/01/2016,COAH.,"MÚZQUIZ, COAH.",0,1,1,0,0,0,
16/01/2016,COAH.,"SAN PEDRO, COAH.",0,0,0,9,0,498,
17/01/2016,CAMP.,"CAMP., CAMP.",0,3,3,1,0,0,
17/01/2016,TAMPS.,"MATAMOROS, TAMPS.",1,2,3,1,0,0,
18/01/2016,D.F.,"COYOACAN, D.F.",20,5,25,0,1,0,
18/01/2016,DGO.,"DGO., DGO.",4,0,4,5,0,0,
18/01/2016,COAH.,"SABINAS, COAH.",2,2,4,0,0,0,
18/01/2016,COAH.,"SALTILLO, COAH.",4,0,4,0,0,50,
18/01/2016,COAH.,"MONCLOVA, COAH.",1,1,2,0,0,0,
18/01/2016,COAH.,"TORREÓN, COAH.",1,0,1,0,0,0,
18/01/2016,COAH.,"SAN PEDRO, COAH.",1,0,1,0,0,0,
18/01/2016,COAH.,"TORREÓN, COAH.",1,0,1,0,0,0,
18/01/2016,COAH.,"SAN PEDRO, COAH.",1,0,1,0,0,0,
19/01/2016,COAH.,"PIEDRAS NEGRAS, COAH.",1,5,6,0,0,0,
19/01/2016,D.F.,"COYOACAN, D.F.",3,3,6,0,2,251,
19/01/2016,COAH.,"SABINAS, COAH.",2,2,4,0,0,0,
19/01/2016,DGO.,"DGO., DGO.",2,0,2,0,0,0,
19/01/2016,OAX.,"MIAHUATLAN DE PORFIRIO DIAZ, OAX.",1,0,1,3,0,0,
19/01/2016,COAH.,"TORREÓN, COAH.",1,0,1,0,0,0,
19/01/2016,COAH.,"MATAMOROS, COAH.",1,0,1,0,0,0,
19/01/2016,COAH.,"SALTILLO, COAH.",1,0,1,0,0,0,
19/01/2016,B.C.,"TIJUANA, B.C.",0,1,1,0,0,0,
20/01/2016,D.F.,"COYOACAN, D.F.",24,13,37,0,7,25,
20/01/2016,COAH.,"ACUÑA, COAH.",1,5,6,0,0,59,
20/01/2016,OAX.,"OAX. DE JUAREZ, OAX.",0,5,5,0,0,0,
20/01/2016,COAH.,"SALTILLO, COAH.",1,2,3,0,0,0,
20/01/2016,B.C.,"MEXICALI, B.C.",1,2,3,0,0,0,
20/01/2016,COAH.,"PIEDRAS NEGRAS, COAH.",2,0,2,0,0,0,
20/01/2016,COAH.,"SAN PEDRO, COAH.",2,0,2,0,0,0,
20/01/2016,CHIH.,"NUEVO CASAS GRANDES, CHIH.",2,0,2,0,0,8,
20/01/2016,COAH.,"MATAMOROS, COAH.",1,0,1,0,0,0,
20/01/2016,COAH.,"RAMOS ARIZPE, COAH.",0,1,1,0,0,0,
20/01/2016,B.C.,"TIJUANA, B.C.",1,0,1,0,0,0,
20/01/2016,OAX.,"MIAHUATLAN DE PORFIRIO DIAZ, OAX.",0,1,1,15,0,0,
21/01/2016,D.F.,"COYOACAN, D.F.",36,8,44,0,4,110,
21/01/2016,COAH.,"PIEDRAS NEGRAS, COAH.",3,2,5,4,0,220,
21/01/2016,COAH.,"TORREÓN, COAH.",2,1,3,0,0,582,
21/01/2016,COAH.,"SALTILLO, COAH.",2,0,2,0,0,46,
21/01/2016,COAH.,"MONCLOVA, COAH.",1,0,1,0,0,0,
21/01/2016,YUC.,"SANAHCAT, YUC.",0,0,0,0,0,432,
22/01/2016,D.F.,"COYOACAN, D.F.",47,10,57,0,3,256,
22/01/2016,OAX.,"CIUDAD IXTEPEC, OAX.",3,0,3,5,7,204,
22/01/2016,DGO.,"DGO., DGO.",3,0,3,3,0,0,
22/01/2016,COAH.,"SALTILLO, COAH.",0,3,3,0,0,0,
22/01/2016,COAH.,"MONCLOVA, COAH.",2,0,2,13,0,348,
22/01/2016,NAY.,"TEPIC, NAY.",1,0,1,0,0,0,
22/01/2016,COL.,"COL., COL.",1,0,1,1,0,0,
22/01/2016,OAX.,"MIAHUATLAN DE PORFIRIO DIAZ, OAX.",0,1,1,8,0,0,
22/01/2016,OAX.,"OAX. DE JUAREZ, OAX.",1,0,1,0,0,300,
22/01/2016,COAH.,"PIEDRAS NEGRAS, COAH.",0,1,1,0,0,20,
22/01/2016,COAH.,"TORREÓN, COAH.",1,0,1,0,0,0,
22/01/2016,COAH.,"MATAMOROS, COAH.",1,0,1,0,0,0,
22/01/2016,COAH.,"ACUÑA, COAH.",1,0,1,0,0,0,
22/01/2016,CHIH.,"NUEVO CASAS GRANDES, CHIH.",1,0,1,6,0,375,
22/01/2016,YUC.,"SANAHCAT, YUC.",0,0,0,0,0,491,
22/01/2016,CHIS.,"REFORMA, CHIS.",0,0,0,1,0,30,
23/01/2016,TAMPS.,"MATAMOROS, TAMPS.",6,3,9,0,0,0,
23/01/2016,COAH.,"PIEDRAS NEGRAS, COAH.",5,3,8,0,0,47,
23/01/2016,B.C.,"ENSENADA, B.C.",1,5,6,0,0,0,
23/01/2016,B.C.,"TIJUANA, B.C.",3,1,4,0,0,0,
23/01/2016,COAH.,"SAN PEDRO, COAH.",2,0,2,0,0,48,
23/01/2016,TAMPS.,"NUEVO LAREDO, TAMPS.",0,1,1,0,0,32,
25/01/2016,D.F.,"COYOACAN, D.F.",18,0,18,0,8,190,
25/01/2016,COAH.,"SALTILLO, COAH.",8,0,8,1,1,254,
25/01/2016,COAH.,"TORREÓN, COAH.",2,0,2,0,0,0,
25/01/2016,COAH.,"TORREÓN, COAH.",2,0,2,0,0,0,
25/01/2016,OAX.,"OAX. DE JUAREZ, OAX.",1,0,1,0,0,0,
25/01/2016,GRO.,"EDUARDO NERI, GRO.",1,0,1,0,3,0,
25/01/2016,COAH.,"PIEDRAS NEGRAS, COAH.",1,0,1,6,0,0,
25/01/2016,COAH.,"ACUÑA, COAH.",1,0,1,2,0,35,
25/01/2016,CHIH.,"NAMIQUIPA, CHIH.",1,0,1,0,0,1219,
25/01/2016,DGO.,"DGO., DGO.",0,1,1,1,0,0,
25/01/2016,OAX.,"MIAHUATLAN DE PORFIRIO DIAZ, OAX.",0,0,0,31,0,0,
25/01/2016,COAH.,"MONCLOVA, COAH.",0,0,0,1,1,10,
25/01/2016,CHIH.,"NUEVO CASAS GRANDES, CHIH.",0,0,0,0,0,179,
26/01/2016,D.F.,"COYOACAN, D.F.",30,17,47,0,2,110,
26/01/2016,OAX.,"OAX. DE JUAREZ, OAX.",1,4,5,0,0,20,
26/01/2016,OAX.,"SAN JUAN BAUTISTA TUXTEPEC, OAX.",4,0,4,1,0,8,
26/01/2016,OAX.,"MIAHUATLAN DE PORFIRIO DIAZ, OAX.",0,3,3,39,0,0,
26/01/2016,COAH.,"TORREÓN, COAH.",2,0,2,0,0,0,
26/01/2016,B.C.,"TIJUANA, B.C.",0,1,1,0,0,0,
27/01/2016,D.F.,"COYOACAN, D.F.",12,7,19,0,0,90,
27/01/2016,CHIH.,"NUEVO CASAS GRANDES, CHIH.",7,5,12,0,0,37,
27/01/2016,COAH.,"SALTILLO, COAH.",4,1,5,0,0,43,
27/01/2016,COAH.,"TORREÓN, COAH.",2,0,2,0,0,0,
27/01/2016,OAX.,"OAX. DE JUAREZ, OAX.",1,0,1,0,0,86,
27/01/2016,CAMP.,"CAMP., CAMP.",0,1,1,0,0,14,
27/01/2016,OAX.,"MIAHUATLAN DE PORFIRIO DIAZ, OAX.",0,1,1,3,0,0,
27/01/2016,COAH.,"PIEDRAS NEGRAS, COAH.",1,0,1,0,0,15,
27/01/2016,COAH.,"MATAMOROS, COAH.",1,0,1,0,0,0,
27/01/2016,COAH.,"SAN PEDRO, COAH.",1,0,1,2,0,9,
27/01/2016,COAH.,"ACUÑA, COAH.",1,0,1,0,0,0,
27/01/2016,OAX.,"OAX. DE JUAREZ, OAX.",0,0,0,1,0,173,
27/01/2016,CHIH.,"NUEVO CASAS GRANDES, CHIH.",0,0,0,4,0,162,
27/01/2016,PUE.,"PUE., PUE.",0,0,0,0,0,94,
28/01/2016,D.F.,"COYOACAN, D.F.",29,13,42,0,0,108,
28/01/2016,CHIH.,"NUEVO CASAS GRANDES, CHIH.",3,3,6,0,0,17,
28/01/2016,DGO.,"DGO., DGO.",1,3,4,1,2,0,
28/01/2016,COAH.,"PIEDRAS NEGRAS, COAH.",1,3,4,0,0,38,
28/01/2016,COAH.,"SALTILLO, COAH.",2,0,2,0,0,28,
28/01/2016,OAX.,"MIAHUATLAN DE PORFIRIO DIAZ, OAX.",0,1,1,3,0,0,
28/01/2016,B.C.,"TIJUANA, B.C.",1,0,1,0,0,0,
28/01/2016,COAH.,"MONCLOVA, COAH.",1,0,1,0,0,0,
28/01/2016,COAH.,"ACUÑA, COAH.",0,1,1,0,0,0,
28/01/2016,COAH.,"TORREÓN, COAH.",0,0,0,1,0,0,
28/01/2016,PUE.,"PUE., PUE.",0,0,0,0,0,28,
29/01/2016,D.F.,"COYOACAN, D.F.",25,15,40,0,4,286,
29/01/2016,B.C.,"MEXICALI, B.C.",2,5,7,0,0,0,
29/01/2016,B.C.,"ENSENADA, B.C.",2,0,2,0,0,0,
29/01/2016,COAH.,"MATAMOROS, COAH.",2,0,2,0,0,0,
29/01/2016,GRO.,"ARCELIA, GRO.",0,2,2,0,0,0,
29/01/2016,OAX.,"OAX. DE JUAREZ, OAX.",1,0,1,2,0,20,
29/01/2016,B.C.,"TIJUANA, B.C.",0,1,1,0,0,0,
29/01/2016,COAH.,"TORREÓN, COAH.",1,0,1,0,0,0,
29/01/2016,COAH.,"SAN PEDRO, COAH.",1,0,1,0,0,0,
29/01/2016,OAX.,"SAN JUAN BAUTISTA TUXTEPEC, OAX.",0,0,0,2,0,12,
29/01/2016,PUE.,"PUE., PUE.",0,0,0,0,0,60,
30/01/2016,TAMPS.,"MATAMOROS, TAMPS.",0,3,3,1,0,0,
31/01/2016,CHIH.,"NUEVO CASAS GRANDES, CHIH.",5,4,9,0,0,88,
31/01/2016,GRO.,"ARCELIA, GRO.",1,5,6,0,3,0,
31/01/2016,OAX.,"OAX. DE JUAREZ, OAX.",1,3,4,0,0,0,
31/01/2016,COAH.,"PIEDRAS NEGRAS, COAH.",2,1,3,0,0,58,
31/01/2016,COAH.,"SALTILLO, COAH.",2,1,3,0,0,0,
31/01/2016,COAH.,"SALTILLO, COAH.",3,0,3,0,0,0,
31/01/2016,COAH.,"MONCLOVA, COAH.",1,1,2,0,0,228,
31/01/2016,COAH.,"MATAMOROS, COAH.",2,0,2,0,0,0,
31/01/2016,B.C.,"TIJUANA, B.C.",1,1,2,0,0,0,
31/01/2016,TAMPS.,"MATAMOROS, TAMPS.",1,0,1,0,0,0,
31/01/2016,COAH.,"TORREÓN, COAH.",1,0,1,0,0,0,
31/01/2016,OAX.,"OAX. DE JUAREZ, OAX.",0,0,0,0,0,32,
01/02/2016,COAH.,"SALTILLO, COAH.",3,1,4,0,2,0,
01/02/2016,TAMPS.,"MATAMOROS, TAMPS.",2,1,3,0,0,0,
01/02/2016,GRO.,"ARCELIA, GRO.",1,0,1,0,0,0,
01/02/2016,TAB.,"CARDENAS, TAB.",1,0,1,0,0,0,
02/02/2016,COAH.,"SALTILLO, COAH.",4,0,4,0,0,45,
02/02/2016,COAH.,"MONCLOVA, COAH.",3,0,3,0,3,91,
02/02/2016,COAH.,"TORREÓN, COAH.",3,0,3,0,0,0,
02/02/2016,COAH.,"MONCLOVA, COAH.",3,0,3,2,0,91,
02/02/2016,COAH.,"TORREÓN, COAH.",3,0,3,0,0,132,
02/02/2016,COAH.,"JIMÉNEZ, COAH.",2,0,2,0,0,122,
02/02/2016,COAH.,"SABINAS, COAH.",0,1,1,0,0,0,
02/02/2016,COAH.,"RAMOS ARIZPE, COAH.",0,1,1,0,0,32,
03/02/2016,COAH.,"SALTILLO, COAH.",4,2,6,0,2,0,
03/02/2016,COAH.,"MONCLOVA, COAH.",3,1,4,2,0,39,
03/02/2016,OAX.,"CIUDAD IXTEPEC, OAX.",0,2,2,3,0,182,
03/02/2016,COAH.,"MATAMOROS, COAH.",2,0,2,0,0,0,
03/02/2016,DGO.,"DGO., DGO.",1,0,1,0,0,0,
03/02/2016,OAX.,"OAX. DE JUAREZ, OAX.",1,0,1,1,0,0,
03/02/2016,COAH.,"PIEDRAS NEGRAS, COAH.",0,1,1,3,1,178,
03/02/2016,COAH.,"SABINAS, COAH.",0,1,1,0,0,0,
03/02/2016,OAX.,"SAN JUAN BAUTISTA TUXTEPEC, OAX.",1,0,1,1,0,0,
03/02/2016,GRO.,"COYUCA DE CATALAN, GRO.",1,0,1,0,0,0,
03/02/2016,COAH.,"TORREÓN, COAH.",0,0,0,1,0,0,
03/02/2016,COAH.,"MÚZQUIZ, COAH.",0,0,0,3,0,0,
03/02/2016,OAX.,"OAX. DE JUAREZ, OAX.",0,0,0,0,0,100,
04/02/2016,COAH.,"SALTILLO, COAH.",6,1,7,0,0,112,
04/02/2016,OAX.,"OAX. DE JUAREZ, OAX.",0,3,3,0,0,0,
04/02/2016,TAB.,"CARDENAS, TAB.",2,0,2,0,0,0,
04/02/2016,COAH.,"TORREÓN, COAH.",1,0,1,0,0,0,
04/02/2016,COAH.,"MONCLOVA, COAH.",1,0,1,0,0,0,
04/02/2016,COAH.,"TORREÓN, COAH.",1,0,1,0,0,0,
04/02/2016,COAH.,"SABINAS, COAH.",1,0,1,0,0,0,
04/02/2016,GRO.,"ARCELIA, GRO.",0,1,1,0,0,0,
04/02/2016,YUC.,"CHANKOM, YUC.",0,0,0,0,0,200,
04/02/2016,TAB.,"TACOTALPA, TAB.",0,0,0,1,0,36,
05/02/2016,OAX.,"CIUDAD IXTEPEC, OAX.",2,1,3,0,0,0,
05/02/2016,DGO.,"DGO., DGO.",0,1,1,0,0,0,
05/02/2016,TAB.,"CARDENAS, TAB.",1,0,1,0,0,0,
05/02/2016,GRO.,"ARCELIA, GRO.",0,1,1,0,0,0,
05/02/2016,YUC.,"TEKAL DE VENEGAS, YUC.",0,0,0,0,0,301,
06/02/2016,TAMPS.,"NUEVO LAREDO, TAMPS.",1,4,5,0,0,66,
06/02/2016,TAMPS.,"MATAMOROS, TAMPS.",4,0,4,0,0,0,
06/02/2016,COAH.,"ACUÑA, COAH.",1,2,3,0,0,25,
06/02/2016,OAX.,"OAX. DE JUAREZ, OAX.",1,0,1,0,0,0,
06/02/2016,COAH.,"GENERAL CEPEDA, COAH.",1,0,1,0,0,0,
06/02/2016,GRO.,"ARCELIA, GRO.",0,0,0,0,1,0,
07/02/2016,TAMPS.,"MATAMOROS, TAMPS.",7,0,7,1,0,30,
07/02/2016,TAMPS.,"NUEVO LAREDO, TAMPS.",1,3,4,0,0,0,
08/02/2016,OAX.,"OAX. DE JUAREZ, OAX.",1,6,7,0,0,0,
08/02/2016,COAH.,"SALTILLO, COAH.",5,2,7,23,0,0,
08/02/2016,COAH.,"PIEDRAS NEGRAS, COAH.",2,1,3,0,0,0,
08/02/2016,DGO.,"SANTIAGO PAPASQUIARO, DGO.",2,0,2,0,0,0,
08/02/2016,COAH.,"MONCLOVA, COAH.",1,1,2,0,0,7,
08/02/2016,COAH.,"MATAMOROS, COAH.",2,0,2,0,0,0,
08/02/2016,TAB.,"CARDENAS, TAB.",1,0,1,0,0,0,
08/02/2016,COAH.,"SAN PEDRO, COAH.",1,0,1,0,0,0,
08/02/2016,COAH.,"SABINAS, COAH.",0,1,1,0,0,0,
08/02/2016,COAH.,"RAMOS ARIZPE, COAH.",1,0,1,0,0,0,
08/02/2016,COAH.,"MÚZQUIZ, COAH.",0,0,0,2,0,0,
09/02/2016,OAX.,"OAX. DE JUAREZ, OAX.",0,5,5,0,0,160,
09/02/2016,COAH.,"PIEDRAS NEGRAS, COAH.",2,2,4,0,0,0,
09/02/2016,TAMPS.,"NUEVO LAREDO, TAMPS.",0,4,4,0,0,0,
09/02/2016,COAH.,"MONCLOVA, COAH.",2,1,3,2,0,15,
09/02/2016,COAH.,"SALTILLO, COAH.",3,0,3,0,0,110,
09/02/2016,COAH.,"SABINAS, COAH.",1,1,2,0,0,0,
09/02/2016,DGO.,"SANTIAGO PAPASQUIARO, DGO.",1,0,1,0,0,0,
09/02/2016,COAH.,"SAN PEDRO, COAH.",1,0,1,0,0,0,
09/02/2016,COAH.,"MÚZQUIZ, COAH.",1,0,1,0,0,0,
09/02/2016,TAB.,"CARDENAS, TAB.",0,1,1,0,0,0,
09/02/2016,OAX.,"SAN JUAN BAUTISTA TUXTEPEC, OAX.",0,0,0,0,0,8,
10/02/2016,CHIH.,"AHUMADA, CHIH.",1,5,6,0,0,120,
10/02/2016,COAH.,"MONCLOVA, COAH.",4,1,5,4,0,245,
10/02/2016,CHIH.,"ASCENSIÓN, CHIH.",1,3,4,0,0,6,
10/02/2016,COAH.,"SALTILLO, COAH.",4,0,4,0,0,644,
10/02/2016,COAH.,"SABINAS, COAH.",0,1,1,0,0,0,
10/02/2016,COAH.,"MÚZQUIZ, COAH.",0,1,1,0,0,0,
10/02/2016,COAH.,"ACUÑA, COAH.",1,0,1,1,0,0,
11/02/2016,COAH.,"TORREÓN, COAH.",6,1,7,50,0,82,
11/02/2016,COAH.,"TORREÓN, COAH.",3,1,4,0,0,41,
11/02/2016,GRO.,"ARCELIA, GRO.",1,0,1,0,0,0,
11/02/2016,COL.,"COL., COL.",1,0,1,0,0,0,
11/02/2016,CHIH.,"ASCENSIÓN, CHIH.",1,0,1,0,0,5796,
12/02/2016,COAH.,"MONCLOVA, COAH.",5,1,6,3,0,220,
12/02/2016,COAH.,"SALTILLO, COAH.",3,2,5,0,0,96,
12/02/2016,COAH.,"TORREÓN, COAH.",4,0,4,3,0,0,
12/02/2016,COAH.,"SABINAS, COAH.",0,3,3,0,0,0,
12/02/2016,COAH.,"MATAMOROS, COAH.",1,1,2,0,0,0,
12/02/2016,COAH.,"SAN PEDRO, COAH.",2,0,2,0,0,0,
12/02/2016,DGO.,"DGO., DGO.",0,1,1,2,0,0,
12/02/2016,COAH.,"MÚZQUIZ, COAH.",1,0,1,0,0,0,
12/02/2016,YUC.,"TEKAX, YUC.",0,0,0,0,0,125,
13/02/2016,OAX.,"SAN JUAN BAUTISTA TUXTEPEC, OAX.",1,0,1,0,0,0,
14/02/2016,TAMPS.,"MATAMOROS, TAMPS.",8,0,8,0,0,0,
14/02/2016,TAMPS.,"MATAMOROS, TAMPS.",3,1,4,0,0,80,
14/02/2016,TAMPS.,"NUEVO LAREDO, TAMPS.",1,0,1,0,0,0,
15/02/2016,COAH.,"MATAMOROS, COAH.",1,1,2,0,0,0,
15/02/2016,OAX.,"SAN JUAN BAUTISTA TUXTEPEC, OAX.",0,1,1,0,0,0,
15/02/2016,COAH.,"TORREÓN, COAH.",1,0,1,0,0,0,
15/02/2016,COAH.,"SAN PEDRO, COAH.",0,1,1,0,0,0,
15/02/2016,COAH.,"SABINAS, COAH.",0,1,1,0,0,0,
15/02/2016,COAH.,"SALTILLO, COAH.",0,1,1,0,0,98,
15/02/2016,CHIH.,"ASCENSIÓN, CHIH.",1,0,1,0,6,0,
15/02/2016,COAH.,"MONCLOVA, COAH.",0,0,0,1,0,0,
16/02/2016,COAH.,"TORREÓN, COAH.",1,0,1,1,0,0,
16/02/2016,HGO.,"TEPEJI DEL RIO DE OCAMPO, HGO.",0,1,1,0,0,0,
16/02/2016,OAX.,"OAX. DE JUAREZ, OAX.",1,0,1,0,0,0,
17/02/2016,HGO.,"TULANCINGO DE BRAVO, HGO.",3,0,3,1,0,11,
17/02/2016,COAH.,"MÚZQUIZ, COAH.",2,1,3,0,0,0,
17/02/2016,HGO.,"PACHUCA DE SOTO, HGO.",1,1,2,0,0,600,
17/02/2016,COAH.,"MONCLOVA, COAH.",1,1,2,0,0,116,
17/02/2016,COAH.,"SALTILLO, COAH.",2,0,2,0,1,0,
17/02/2016,DGO.,"DGO., DGO.",1,0,1,2,0,0,
17/02/2016,OAX.,"SAN JUAN BAUTISTA TUXTEPEC, OAX.",0,1,1,0,0,0,
17/02/2016,COAH.,"TORREÓN, COAH.",0,1,1,0,0,0,
17/02/2016,COAH.,"SABINAS, COAH.",1,0,1,0,0,0,
17/02/2016,YUC.,"TECOH, YUC.",0,0,0,0,0,100,
17/02/2016,TAMPS.,"SAN FERNANDO, TAMPS.",0,0,0,0,0,103,
17/02/2016,TAB.,"TENOSIQUE, TAB.",0,0,0,0,3,0,
17/02/2016,YUC.,"TECOH, YUC.",0,0,0,0,0,551,
17/02/2016,COAH.,"ACUÑA, COAH.",0,0,0,0,1,0,
17/02/2016,COAH.,"RAMOS ARIZPE, COAH.",0,0,0,0,1,0,
18/02/2016,CHIH.,"NUEVO CASAS GRANDES, CHIH.",1,0,1,0,0,5,
18/02/2016,CHIH.,"OJINAGA, CHIH.",0,1,1,0,0,150,
19/02/2016,OAX.,"OAX. DE JUAREZ, OAX.",3,6,9,6,0,0,
19/02/2016,OAX.,"OAX. DE JUAREZ, OAX.",0,6,6,0,0,0,
19/02/2016,CHIH.,"HGO. DEL PARRAL, CHIH.",1,4,5,0,0,0,
19/02/2016,HGO.,"PACHUCA DE SOTO, HGO.",1,0,1,0,0,576,
21/02/2016,TAMPS.,"MATAMOROS, TAMPS.",5,3,8,0,0,0,
21/02/2016,TAB.,"TACOTALPA, TAB.",1,0,1,0,0,25,
21/02/2016,DGO.,"DGO., DGO.",1,0,1,0,0,0,
22/02/2016,HGO.,"TULANCINGO DE BRAVO, HGO.",1,0,1,1,0,0,
23/02/2016,OAX.,"OAX. DE JUAREZ, OAX.",3,8,11,0,0,0,
23/02/2016,COAH.,"TORREÓN, COAH.",4,0,4,0,0,524,
23/02/2016,COAH.,"SALTILLO, COAH.",4,0,4,0,0,0,
23/02/2016,COAH.,"TORREÓN, COAH.",4,0,4,1,0,120,
23/02/2016,COAH.,"SALTILLO, COAH.",2,1,3,0,0,0,
23/02/2016,COAH.,"SABINAS, COAH.",1,2,3,0,0,0,
23/02/2016,CHIH.,"AHUMADA, CHIH.",2,1,3,0,0,0,
23/02/2016,HGO.,"PACHUCA DE SOTO, HGO.",1,2,3,0,0,0,
23/02/2016,COAH.,"SABINAS, COAH.",2,0,2,0,0,0,
23/02/2016,TAB.,"HUIMANGUILLO, TAB.",1,1,2,0,0,0,
23/02/2016,COAH.,"MATAMOROS, COAH.",2,0,2,11,0,0,
23/02/2016,HGO.,"TULANCINGO DE BRAVO, HGO.",1,1,2,0,0,0,
23/02/2016,COAH.,"MATAMOROS, COAH.",1,0,1,0,0,0,
23/02/2016,HGO.,"TEPEJI DEL RIO DE OCAMPO, HGO.",1,0,1,0,0,0,
23/02/2016,DGO.,"DGO., DGO.",1,0,1,4,1,0,
23/02/2016,COAH.,"MONCLOVA, COAH.",1,0,1,0,0,0,
23/02/2016,COAH.,"SAN PEDRO, COAH.",0,1,1,0,0,0,
23/02/2016,COAH.,"ACUÑA, COAH.",1,0,1,0,0,0,
23/02/2016,COAH.,"SALTILLO, COAH.",1,0,1,7,0,83,
23/02/2016,CHIH.,"NUEVO CASAS GRANDES, CHIH.",1,0,1,1,0,11,
24/02/2016,COAH.,"TORREÓN, COAH.",2,3,5,0,0,0,
24/02/2016,COAH.,"SALTILLO, COAH.",4,0,4,0,9,132,
24/02/2016,COAH.,"SABINAS, COAH.",2,1,3,0,0,0,
24/02/2016,COAH.,"MÚZQUIZ, COAH.",2,0,2,0,0,0,
24/02/2016,COAH.,"MONCLOVA, COAH.",1,0,1,0,1,0,
25/02/2016,COAH.,"SABINAS, COAH.",1,3,4,0,0,0,
25/02/2016,COAH.,"PIEDRAS NEGRAS, COAH.",0,3,3,0,0,0,
25/02/2016,HGO.,"TEPEJI DEL RIO DE OCAMPO, HGO.",2,0,2,0,0,0,
25/02/2016,COAH.,"TORREÓN, COAH.",2,0,2,1,0,0,
25/02/2016,YUC.,"TICUL, YUC.",1,0,1,0,0,0,
25/02/2016,DGO.,"DGO., DGO.",0,1,1,0,0,0,
25/02/2016,TAB.,"TENOSIQUE, TAB.",1,0,1,0,0,0,
25/02/2016,COAH.,"MONCLOVA, COAH.",1,0,1,0,0,39,
25/02/2016,COAH.,"MATAMOROS, COAH.",1,0,1,0,0,0,
25/02/2016,COAH.,"SALTILLO, COAH.",1,0,1,5,0,450,
25/02/2016,COAH.,"ACUÑA, COAH.",1,0,1,0,0,0,
25/02/2016,HGO.,"TULANCINGO DE BRAVO, HGO.",0,0,0,0,0,55,
26/02/2016,CHIH.,"MANUEL BENAVIDES, CHIH.",0,2,2,0,0,0,
26/02/2016,HGO.,"TULANCINGO DE BRAVO, HGO.",1,0,1,0,0,0,
26/02/2016,HGO.,"TEPEJI DEL RIO DE OCAMPO, HGO.",1,0,1,0,0,0,
26/02/2016,TAB.,"TENOSIQUE, TAB.",0,0,0,1,0,28,
26/02/2016,YUC.,"TICUL, YUC.",0,0,0,2,0,15,
28/02/2016,TAMPS.,"MATAMOROS, TAMPS.",1,0,1,1,0,95,
29/02/2016,COAH.,"SALTILLO, COAH.",5,3,8,0,0,322,
29/02/2016,COAH.,"MONCLOVA, COAH.",3,0,3,0,0,3,
29/02/2016,COAH.,"SABINAS, COAH.",1,2,3,0,0,0,
29/02/2016,COAH.,"TORREÓN, COAH.",1,1,2,0,0,0,
29/02/2016,HGO.,"PACHUCA DE SOTO, HGO.",1,1,2,0,0,0,
01/03/2016,COAH.,"SALTILLO, COAH.",4,0,4,0,0,429,
01/03/2016,OAX.,"OAX. DE JUAREZ, OAX.",0,4,4,0,0,100,
01/03/2016,COAH.,"TORREÓN, COAH.",3,0,3,3,0,0,
01/03/2016,COAH.,"SABINAS, COAH.",1,1,2,0,0,0,
01/03/2016,COAH.,"MONCLOVA, COAH.",1,0,1,0,0,27,
01/03/2016,COAH.,"MÚZQUIZ, COAH.",0,1,1,0,0,0,
01/03/2016,COAH.,"RAMOS ARIZPE, COAH.",1,0,1,0,0,0,
01/03/2016,COAH.,"ACUÑA, COAH.",1,0,1,0,0,0,
01/03/2016,HGO.,"PACHUCA DE SOTO, HGO.",1,0,1,0,0,0,
01/03/2016,GRO.,"CHILAPA DE ALVAREZ, GRO.",1,0,1,1,0,0,
01/03/2016,GRO.,"CHILAPA DE ALVAREZ, GRO.",1,0,1,0,0,0,
02/03/2016,COAH.,"SALTILLO, COAH.",7,5,12,0,0,0,
03/03/2016,COAH.,"SALTILLO, COAH.",8,3,11,0,0,620,
03/03/2016,OAX.,"OAX. DE JUAREZ, OAX.",0,10,10,0,0,0,
03/03/2016,COAH.,"TORREÓN, COAH.",2,1,3,0,0,40,
03/03/2016,COAH.,"SABINAS, COAH.",3,0,3,0,0,0,
03/03/2016,COAH.,"SAN PEDRO, COAH.",1,0,1,0,0,0,
04/03/2016,OAX.,"OAX. DE JUAREZ, OAX.",1,9,10,0,1,0,
04/03/2016,COAH.,"TORREÓN, COAH.",2,3,5,0,2,0,
04/03/2016,COAH.,"MONCLOVA, COAH.",1,1,2,0,0,14,
04/03/2016,COAH.,"SABINAS, COAH.",0,2,2,0,0,0,
04/03/2016,COAH.,"SAN PEDRO, COAH.",1,0,1,0,0,0,
04/03/2016,COAH.,"SALTILLO, COAH.",1,0,1,0,0,2330,
05/03/2016,TAMPS.,"MATAMOROS, TAMPS.",11,2,13,5,0,492,
06/03/2016,GRO.,"SAN MIGUEL TOTOLAPAN, GRO.",0,2,2,0,0,0,
07/03/2016,D.F.,"TLAHUAC, D.F.",8,22,30,2,5,0,
07/03/2016,GRO.,"SAN MIGUEL TOTOLAPAN, GRO.",1,3,4,0,0,0,
07/03/2016,COAH.,"TORREÓN, COAH.",1,1,2,0,0,0,
07/03/2016,COAH.,"SABINAS, COAH.",1,1,2,0,0,0,
07/03/2016,COAH.,"MÚZQUIZ, COAH.",1,1,2,0,0,0,
07/03/2016,OAX.,"OAX. DE JUAREZ, OAX.",1,0,1,1,0,5,
07/03/2016,HGO.,"YAHUALICA, HGO.",1,0,1,0,0,0,
07/03/2016,COAH.,"MONCLOVA, COAH.",1,0,1,0,0,0,
07/03/2016,COAH.,"SALTILLO, COAH.",1,0,1,0,0,0,
08/03/2016,D.F.,"TLAHUAC, D.F.",13,5,18,11,0,0,
08/03/2016,COAH.,"TORREÓN, COAH.",1,4,5,0,0,75,
08/03/2016,COAH.,"TORREÓN, COAH.",3,2,5,0,0,0,
08/03/2016,COAH.,"TORREÓN, COAH.",3,0,3,0,0,0,
08/03/2016,COAH.,"TORREÓN, COAH.",1,0,1,0,0,0,
08/03/2016,COAH.,"TORREÓN, COAH.",1,0,1,0,0,54,
08/03/2016,COAH.,"TORREÓN, COAH.",1,0,1,0,0,0,
09/03/2016,D.F.,"TLAHUAC, D.F.",1,4,5,48,0,626,
09/03/2016,COAH.,"TORREÓN, COAH.",3,1,4,0,0,88,
09/03/2016,HGO.,"PACHUCA DE SOTO, HGO.",2,1,3,0,0,0,
09/03/2016,COAH.,"MONCLOVA, COAH.",1,2,3,4,0,26,
09/03/2016,CHIS.,"BENEMÉRITO DE LAS AMÉRICAS, CHIS.",0,2,2,0,0,0,
09/03/2016,COAH.,"SABINAS, COAH.",1,1,2,0,0,0,
09/03/2016,COAH.,"SALTILLO, COAH.",1,1,2,0,0,1834,
09/03/2016,COAH.,"MATAMOROS, COAH.",1,0,1,0,0,53,
09/03/2016,B.C.S.,"MULEGÉ, B.C.S.",0,1,1,0,0,0,
09/03/2016,TAB.,"TENOSIQUE, TAB.",0,0,0,0,0,5,
09/03/2016,TAB.,"EMILIANO ZAPATA, TAB.",0,0,0,0,0,5,
10/03/2016,D.F.,"TLAHUAC, D.F.",13,6,19,39,4,0,
10/03/2016,COAH.,"SALTILLO, COAH.",1,2,3,0,0,317,
10/03/2016,COAH.,"SABINAS, COAH.",1,1,2,0,0,0,
10/03/2016,CHIS.,"BENEMÉRITO DE LAS AMÉRICAS, CHIS.",1,0,1,0,0,0,
10/03/2016,HGO.,"VILLA DE TEZONTEPEC, HGO.",1,0,1,0,0,0,
11/03/2016,D.F.,"TLAHUAC, D.F.",8,6,14,42,0,1032,
11/03/2016,COAH.,"TORREÓN, COAH.",3,1,4,0,0,0,
11/03/2016,YUC.,"AKIL, YUC.",0,0,0,2,0,58,
12/03/2016,TAMPS.,"MATAMOROS, TAMPS.",2,2,4,2,0,115,
12/03/2016,COAH.,"NAVA, COAH.",3,1,4,1,0,0,
12/03/2016,COAH.,"NUEVA ROSITA, COAH.",2,0,2,0,0,0,
12/03/2016,COAH.,"MATAMOROS, COAH.",1,0,1,0,0,42,
12/03/2016,COAH.,"MATAMOROS, COAH.",0,0,0,1,0,0,
13/03/2016,TAMPS.,"MATAMOROS, TAMPS.",2,0,2,1,0,0,
13/03/2016,B.C.S.,"MULEGÉ, B.C.S.",0,1,1,0,0,0,
13/03/2016,TAMPS.,"NUEVO LAREDO, TAMPS.",0,0,0,6,0,70,
14/03/2016,D.F.,"TLAHUAC, D.F.",7,2,9,5,0,24,
14/03/2016,COAH.,"SALTILLO, COAH.",1,5,6,0,0,91,
14/03/2016,OAX.,"CIUDAD IXTEPEC, OAX.",0,2,2,0,0,0,
14/03/2016,GRO.,"COYUCA DE BENITEZ, GRO.",1,1,2,0,0,0,
14/03/2016,COAH.,"MONCLOVA, COAH.",1,0,1,1,0,37,
14/03/2016,COAH.,"TORREÓN, COAH.",1,0,1,0,0,0,
14/03/2016,COAH.,"MATAMOROS, COAH.",1,0,1,1,0,0,
14/03/2016,TAB.,"TENOSIQUE, TAB.",0,0,0,3,1,0,
14/03/2016,TAB.,"CUNDUACAN, TAB.",0,0,0,0,0,100,
14/03/2016,HGO.,"NOPALA DE VILLAGRAN, HGO.",0,0,0,0,0,1000,
14/03/2016,COAH.,"SALTILLO, COAH.",0,0,0,4,0,110,
15/03/2016,COAH.,"TORREÓN, COAH.",60,44,104,35,0,4781,
15/03/2016,COAH.,"MONCLOVA, COAH.",1,18,19,0,0,0,
15/03/2016,D.F.,"TLAHUAC, D.F.",11,6,17,123,0,136,
15/03/2016,COAH.,"PIEDRAS NEGRAS, COAH.",1,1,2,0,0,0,
15/03/2016,HGO.,"VILLA DE TEZONTEPEC, HGO.",0,1,1,0,0,200,
15/03/2016,OAX.,"CIUDAD IXTEPEC, OAX.",1,0,1,5,0,0,
15/03/2016,COAH.,"TORREÓN, COAH.",1,0,1,0,0,0,
15/03/2016,COAH.,"SAN PEDRO, COAH.",1,0,1,0,0,0,
15/03/2016,COAH.,"SABINAS, COAH.",1,0,1,0,0,0,
15/03/2016,COAH.,"SALTILLO, COAH.",1,0,1,2,0,61,
15/03/2016,GRO.,"COYUCA DE BENITEZ, GRO.",0,1,1,0,0,0,
15/03/2016,COAH.,"MATAMOROS, COAH.",1,0,1,0,0,0,
15/03/2016,HGO.,"PACHUCA DE SOTO, HGO.",0,0,0,0,0,1200,
16/03/2016,D.F.,"TLAHUAC, D.F.",14,4,18,45,0,135,
16/03/2016,COAH.,"SALTILLO, COAH.",3,2,5,12,1,3040,
16/03/2016,COAH.,"TORREÓN, COAH.",3,0,3,0,0,0,
16/03/2016,COAH.,"MÚZQUIZ, COAH.",1,1,2,0,0,0,
16/03/2016,DGO.,"DGO., DGO.",2,0,2,0,0,0,
16/03/2016,COAH.,"MONCLOVA, COAH.",1,0,1,0,0,66,
16/03/2016,COAH.,"MATAMOROS, COAH.",0,1,1,0,0,0,
16/03/2016,COAH.,"SAN PEDRO, COAH.",0,1,1,0,0,0,
16/03/2016,HGO.,"VILLA DE TEZONTEPEC, HGO.",0,1,1,0,0,0,
16/03/2016,GRO.,"AJUCHITLAN DEL PROGRESO, GRO.",0,1,1,0,0,0,
17/03/2016,D.F.,"TLAHUAC, D.F.",10,13,23,0,0,50,
17/03/2016,GTO.,"SALAMANCA, GTO.",13,1,14,0,0,430,
17/03/2016,COAH.,"SALTILLO, COAH.",1,2,3,19,0,7,
17/03/2016,COAH.,"SAN PEDRO, COAH.",2,0,2,0,0,0,
17/03/2016,COAH.,"PIEDRAS NEGRAS, COAH.",1,0,1,0,0,0,
17/03/2016,COAH.,"ACUÑA, COAH.",0,1,1,0,0,0,
17/03/2016,YUC.,"TEKIT, YUC.",0,0,0,11,0,0,
17/03/2016,COAH.,"TORREÓN, COAH.",0,0,0,0,0,643,
18/03/2016,D.F.,"TLAHUAC, D.F.",22,21,43,46,0,249,
18/03/2016,GTO.,"SALAMANCA, GTO.",12,2,14,1,2,8,
18/03/2016,COAH.,"SAN PEDRO, COAH.",0,3,3,0,0,0,
18/03/2016,COAH.,"PIEDRAS NEGRAS, COAH.",1,2,3,0,0,0,
18/03/2016,COAH.,"MONCLOVA, COAH.",1,1,2,3,0,125,
18/03/2016,COAH.,"TORREÓN, COAH.",1,0,1,0,0,50,
18/03/2016,COAH.,"SABINAS, COAH.",0,1,1,0,0,0,
18/03/2016,COAH.,"SALTILLO, COAH.",1,0,1,0,0,46,
18/03/2016,COAH.,"GENERAL CEPEDA, COAH.",1,0,1,0,0,0,
18/03/2016,YUC.,"TEKIT, YUC.",0,0,0,1,0,6,
19/03/2016,GTO.,"SALAMANCA, GTO.",5,2,7,0,0,0,
19/03/2016,COAH.,"SAN PEDRO, COAH.",4,1,5,0,0,643,
19/03/2016,COL.,"COL., COL.",2,0,2,0,0,0,
19/03/2016,HGO.,"PACHUCA DE SOTO, HGO.",1,0,1,0,1,0,
19/03/2016,HGO.,"VILLA DE TEZONTEPEC, HGO.",1,0,1,0,0,0,
19/03/2016,B.C.S.,"MULEGÉ, B.C.S.",0,1,1,0,0,0,
19/03/2016,HGO.,"NOPALA DE VILLAGRAN, HGO.",1,0,1,0,0,0,
19/03/2016,YUC.,"TEKIT, YUC.",0,0,0,1,0,10,
19/03/2016,DGO.,"DGO., DGO.",0,0,0,0,4,0,
20/03/2016,GTO.,"SALAMANCA, GTO.",1,0,1,0,0,0,
21/03/2016,COAH.,"SALTILLO, COAH.",4,1,5,0,0,0,
21/03/2016,ZAC.,"RIO GRANDE, ZAC.",1,0,1,0,0,0,
21/03/2016,GTO.,"SALAMANCA, GTO.",1,0,1,0,4,0,
22/03/2016,GTO.,"SALAMANCA, GTO.",6,2,8,0,4,0,
22/03/2016,COAH.,"TORREÓN, COAH.",4,0,4,0,0,0,
22/03/2016,COAH.,"SAN PEDRO, COAH.",2,1,3,0,0,34,
22/03/2016,COAH.,"SALTILLO, COAH.",2,1,3,0,0,312,
22/03/2016,GRO.,"IGUALA DE LA INDEPENDENCIA, GRO.",1,0,1,1,0,0,
22/03/2016,HGO.,"TIZAYUCA, HGO.",0,0,0,0,0,38,
24/03/2016,GTO.,"SALAMANCA, GTO.",8,10,18,0,11,0,
24/03/2016,COAH.,"SAN PEDRO, COAH.",0,2,2,0,0,0,
24/03/2016,COAH.,"TORREÓN, COAH.",2,0,2,0,0,0,
24/03/2016,GRO.,"TELOLOAPAN, GRO.",0,1,1,0,0,0,
25/03/2016,COAH.,"PIEDRAS NEGRAS, COAH.",1,1,2,4,0,18,
25/03/2016,COAH.,"SAN PEDRO, COAH.",0,2,2,0,0,0,
25/03/2016,COAH.,"SABINAS, COAH.",1,0,1,0,0,0,
28/03/2016,TAMPS.,"MATAMOROS, TAMPS.",7,0,7,0,0,0,
28/03/2016,COAH.,"SALTILLO, COAH.",1,1,2,0,0,0,
28/03/2016,COAH.,"TORREÓN, COAH.",0,1,1,1,0,40,
28/03/2016,COAH.,"SAN PEDRO, COAH.",1,0,1,0,0,0,
28/03/2016,COAH.,"MONCLOVA, COAH.",1,0,1,3,1,69,
28/03/2016,COAH.,"GENERAL CEPEDA, COAH.",1,0,1,0,0,0,
29/03/2016,GTO.,"SALAMANCA, GTO.",6,1,7,0,3,0,
29/03/2016,COAH.,"TORREÓN, COAH.",2,3,5,0,0,0,
29/03/2016,COAH.,"SALTILLO, COAH.",2,1,3,0,1,0,
29/03/2016,COAH.,"MONCLOVA, COAH.",0,2,2,0,0,78,
29/03/2016,OAX.,"CIUDAD IXTEPEC, OAX.",0,1,1,0,1,0,
29/03/2016,COAH.,"MATAMOROS, COAH.",1,0,1,0,0,0,
29/03/2016,COAH.,"SABINAS, COAH.",0,1,1,0,0,0,
30/03/2016,COAH.,"SALTILLO, COAH.",5,2,7,0,0,0,
30/03/2016,COAH.,"TORREÓN, COAH.",2,1,3,0,0,0,
30/03/2016,COAH.,"SAN PEDRO, COAH.",1,1,2,0,0,0,
30/03/2016,ZAC.,"RIO GRANDE, ZAC.",2,0,2,0,0,0,
30/03/2016,COAH.,"MONCLOVA, COAH.",0,1,1,0,0,0,
30/03/2016,COAH.,"SABINAS, COAH.",1,0,1,0,0,0,
30/03/2016,OAX.,"MIAHUATLAN DE PORFIRIO DIAZ, OAX.",0,1,1,0,0,0,
30/03/2016,GRO.,"IGUALA DE LA INDEPENDENCIA, GRO.",0,1,1,0,0,0,
31/03/2016,COAH.,"TORREÓN, COAH.",6,1,7,0,0,0,
31/03/2016,OAX.,"MIAHUATLAN DE PORFIRIO DIAZ, OAX.",4,1,5,0,0,0,
31/03/2016,COAH.,"MONCLOVA, COAH.",2,1,3,1,0,0,
31/03/2016,OAX.,"CIUDAD IXTEPEC, OAX.",0,3,3,0,0,79,
31/03/2016,COAH.,"FRANCISCO I. MADERO, COAH.",1,1,2,0,0,0,
31/03/2016,COAH.,"SALTILLO, COAH.",1,1,2,0,0,68,
31/03/2016,GRO.,"IGUALA DE LA INDEPENDENCIA, GRO.",2,0,2,0,0,0,
31/03/2016,COAH.,"SAN PEDRO, COAH.",1,0,1,0,0,0,
31/03/2016,OAX.,"MIAHUATLAN DE PORFIRIO DIAZ, OAX.",0,0,0,11,0,0,
01/04/2016,GTO.,"SALAMANCA, GTO.",3,1,4,0,0,0,
01/04/2016,GRO.,"IGUALA DE LA INDEPENDENCIA, GRO.",1,0,1,0,0,0,
01/04/2016,OAX.,"MIAHUATLAN DE PORFIRIO DIAZ, OAX.",0,1,1,0,0,20,
02/04/2016,COAH.,"TORREÓN, COAH.",1,2,3,0,0,0,
02/04/2016,COAH.,"TORREÓN, COAH.",2,0,2,0,0,0,
02/04/2016,GRO.,"TELOLOAPAN, GRO.",1,1,2,0,0,0,
02/04/2016,CHIH.,"AHUMADA, CHIH.",1,0,1,0,0,0,
02/04/2016,TAMPS.,"REYNOSA, TAMPS.",0,1,1,0,0,0,
03/04/2016,TAMPS.,"MATAMOROS, TAMPS.",8,4,12,0,0,0,
03/04/2016,GRO.,"TELOLOAPAN, GRO.",1,0,1,0,0,0,
03/04/2016,GRO.,"IGUALA DE LA INDEPENDENCIA, GRO.",1,0,1,0,0,0,
04/04/2016,S.L.P.,"SAN LUIS POTOSI, S.L.P.",14,2,16,0,0,5,
04/04/2016,S.L.P.,"SAN LUIS POTOSI, S.L.P.",13,2,15,0,0,0,
04/04/2016,COAH.,"TORREÓN, COAH.",4,0,4,0,0,0,
04/04/2016,COAH.,"FRANCISCO I. MADERO, COAH.",2,0,2,10,0,0,
04/04/2016,GTO.,"SALAMANCA, GTO.",1,0,1,0,0,0,
05/04/2016,D.F.,"IZTAPALAPA, D.F.",22,22,44,13,1,371,
05/04/2016,COAH.,"FRANCISCO I. MADERO, COAH.",2,0,2,0,0,0,
05/04/2016,COAH.,"ACUÑA, COAH.",1,1,2,0,0,0,
05/04/2016,TAB.,"CUNDUACAN, TAB.",1,0,1,0,0,0,
05/04/2016,COAH.,"MONCLOVA, COAH.",1,0,1,0,0,0,
05/04/2016,COAH.,"SAN PEDRO, COAH.",1,0,1,0,0,0,
05/04/2016,COAH.,"SABINAS, COAH.",1,0,1,0,2,0,
05/04/2016,COAH.,"SALTILLO, COAH.",1,0,1,0,0,200,
05/04/2016,COAH.,"SAN PEDRO, COAH.",1,0,1,0,0,0,
06/04/2016,D.F.,"IZTAPALAPA, D.F.",10,4,14,88,6,133,
06/04/2016,S.L.P.,"SAN LUIS POTOSI, S.L.P.",10,1,11,0,1,0,
06/04/2016,S.L.P.,"SAN LUIS POTOSI, S.L.P.",3,0,3,0,0,0,
06/04/2016,S.L.P.,"SAN LUIS POTOSI, S.L.P.",3,0,3,0,0,0,
06/04/2016,COAH.,"FRANCISCO I. MADERO, COAH.",3,0,3,0,0,0,
06/04/2016,S.L.P.,"SAN LUIS POTOSI, S.L.P.",1,0,1,0,0,0,
06/04/2016,COAH.,"MONCLOVA, COAH.",1,0,1,0,0,0,
06/04/2016,COAH.,"SAN PEDRO, COAH.",1,0,1,0,0,0,
07/04/2016,D.F.,"IZTAPALAPA, D.F.",11,2,13,169,2,261,
07/04/2016,S.L.P.,"SAN LUIS POTOSI, S.L.P.",1,6,7,0,0,0,
07/04/2016,S.L.P.,"CIUDAD VALLES, S.L.P.",3,0,3,0,0,0,
07/04/2016,S.L.P.,"SOLEDAD DE GRACIANO SANCHEZ, S.L.P.",2,1,3,0,0,0,
07/04/2016,GTO.,"SALAMANCA, GTO.",0,2,2,0,0,0,
07/04/2016,CHIS.,"CATAZAJÁ, CHIS.",1,0,1,0,0,0,
08/04/2016,D.F.,"IZTAPALAPA, D.F.",5,9,14,171,3,165,
08/04/2016,S.L.P.,"SAN LUIS POTOSI, S.L.P.",6,2,8,0,0,0,
08/04/2016,COAH.,"SALTILLO, COAH.",4,2,6,0,0,0,
08/04/2016,GTO.,"SALAMANCA, GTO.",1,2,3,0,0,0,
08/04/2016,COAH.,"FRANCISCO I. MADERO, COAH.",2,0,2,0,0,0,
08/04/2016,S.L.P.,"SOLEDAD DE GRACIANO SANCHEZ, S.L.P.",1,0,1,0,8,0,
08/04/2016,TAB.,"TENOSIQUE, TAB.",1,0,1,0,0,0,
08/04/2016,COAH.,"MONCLOVA, COAH.",0,1,1,0,0,16,
08/04/2016,COAH.,"ACUÑA, COAH.",1,0,1,0,0,0,
09/04/2016,S.L.P.,"SAN LUIS POTOSI, S.L.P.",5,1,6,5,1,0,
09/04/2016,S.L.P.,"SAN LUIS POTOSI, S.L.P.",5,1,6,5,1,0,
09/04/2016,S.L.P.,"CIUDAD VALLES, S.L.P.",1,1,2,1,0,0,
09/04/2016,TAMPS.,"MATAMOROS, TAMPS.",0,1,1,0,0,140,
09/04/2016,S.L.P.,"CIUDAD VALLES, S.L.P.",1,0,1,1,0,0,
10/04/2016,S.L.P.,"CIUDAD VALLES, S.L.P.",2,0,2,1,0,0,
10/04/2016,S.L.P.,"SAN LUIS POTOSI, S.L.P.",2,0,2,0,0,0,
10/04/2016,S.L.P.,"SOLEDAD DE GRACIANO SANCHEZ, S.L.P.",1,1,2,0,0,0,
11/04/2016,COAH.,"SALTILLO, COAH.",27,25,52,19,0,0,
11/04/2016,D.F.,"IZTAPALAPA, D.F.",5,7,12,221,0,41,
11/04/2016,S.L.P.,"SOLEDAD DE GRACIANO SANCHEZ, S.L.P.",2,6,8,0,0,0,
11/04/2016,COAH.,"PIEDRAS NEGRAS, COAH.",3,4,7,1,0,117,
11/04/2016,S.L.P.,"SAN LUIS POTOSI, S.L.P.",2,0,2,11,0,0,
11/04/2016,S.L.P.,"CIUDAD VALLES, S.L.P.",1,0,1,0,0,3,
11/04/2016,COAH.,"FRANCISCO I. MADERO, COAH.",1,0,1,0,0,0,
11/04/2016,COAH.,"RAMOS ARIZPE, COAH.",1,0,1,0,0,0,
12/04/2016,D.F.,"IZTACALCO, D.F.",5,4,9,133,0,0,
12/04/2016,COAH.,"SAN PEDRO, COAH.",2,1,3,0,0,0,
12/04/2016,COAH.,"TORREÓN, COAH.",2,0,2,0,0,55,
12/04/2016,S.L.P.,"CIUDAD VALLES, S.L.P.",1,0,1,0,0,0,
12/04/2016,S.L.P.,"SAN LUIS POTOSI, S.L.P.",1,0,1,0,0,0,
12/04/2016,S.L.P.,"SAN LUIS POTOSI, S.L.P.",1,0,1,0,1,0,
13/04/2016,D.F.,"IZTAPALAPA, D.F.",5,2,7,302,0,848,
13/04/2016,S.L.P.,"CIUDAD VALLES, S.L.P.",7,0,7,0,0,0,
13/04/2016,S.L.P.,"EBANO, S.L.P.",3,0,3,0,0,0,
13/04/2016,COAH.,"TORREÓN, COAH.",1,2,3,0,0,45,
13/04/2016,COAH.,"SALTILLO, COAH.",1,1,2,0,2,0,
13/04/2016,S.L.P.,"SAN LUIS POTOSI, S.L.P.",1,0,1,0,0,0,
13/04/2016,COAH.,"MONCLOVA, COAH.",0,1,1,1,0,64,
14/04/2016,D.F.,"IZTAPALAPA, D.F.",5,9,14,106,0,646,
14/04/2016,COAH.,"MONCLOVA, COAH.",2,3,5,0,0,0,
14/04/2016,S.L.P.,"SAN LUIS POTOSI, S.L.P.",4,0,4,0,1,0,
14/04/2016,COAH.,"SALTILLO, COAH.",3,1,4,0,0,0,
14/04/2016,COAH.,"PIEDRAS NEGRAS, COAH.",2,1,3,0,0,4,
14/04/2016,YUC.,"MUNA, YUC.",1,0,1,0,0,0,
14/04/2016,COAH.,"FRANCISCO I. MADERO, COAH.",1,0,1,0,0,0,
14/04/2016,COAH.,"MATAMOROS, COAH.",1,0,1,0,0,0,
14/04/2016,COAH.,"ACUÑA, COAH.",1,0,1,0,0,0,
15/04/2016,D.F.,"IZTACALCO, D.F.",11,19,30,342,0,736,
16/04/2016,TAMPS.,"MATAMOROS, TAMPS.",0,5,5,0,0,0,
16/04/2016,COAH.,"ALLENDE, COAH.",1,2,3,2,0,14,
16/04/2016,S.L.P.,"SAN LUIS POTOSI, S.L.P.",2,0,2,0,0,0,
16/04/2016,DGO.,"DGO., DGO.",2,0,2,5,0,0,
16/04/2016,S.L.P.,"CIUDAD VALLES, S.L.P.",1,0,1,0,1,0,
16/04/2016,S.L.P.,"SOLEDAD DE GRACIANO SANCHEZ, S.L.P.",1,0,1,0,0,0,
16/04/2016,DGO.,"DGO., DGO.",1,0,1,0,0,0,
16/04/2016,COAH.,"SALTILLO, COAH.",1,0,1,19,0,0,
17/04/2016,S.L.P.,"CIUDAD VALLES, S.L.P.",1,2,3,0,0,0,
17/04/2016,COAH.,"MATAMOROS, COAH.",2,0,2,0,0,0,
17/04/2016,S.L.P.,"EBANO, S.L.P.",1,0,1,0,1,0,
17/04/2016,S.L.P.,"SAN LUIS POTOSI, S.L.P.",1,0,1,3,0,0,
18/04/2016,D.F.,"IZTACALCO, D.F.",5,5,10,405,1,317,
18/04/2016,COAH.,"TORREÓN, COAH.",1,2,3,1,0,0,
18/04/2016,COAH.,"MONCLOVA, COAH.",1,2,3,0,0,25,
18/04/2016,COAH.,"TORREÓN, COAH.",1,2,3,1,0,0,
18/04/2016,TAMPS.,"MATAMOROS, TAMPS.",1,2,3,10,1,380,
18/04/2016,COAH.,"SAN PEDRO, COAH.",1,0,1,0,0,0,
18/04/2016,COAH.,"SAN PEDRO, COAH.",1,0,1,0,0,0,
18/04/2016,COAH.,"SALTILLO, COAH.",1,0,1,0,0,0,
18/04/2016,COAH.,"ACUÑA, COAH.",1,0,1,0,0,0,
19/04/2016,D.F.,"IZTACALCO, D.F.",6,2,8,78,0,0,
19/04/2016,COAH.,"TORREÓN, COAH.",3,0,3,0,1,0,
19/04/2016,COAH.,"FRANCISCO I. MADERO, COAH.",3,0,3,0,0,0,
19/04/2016,COAH.,"PIEDRAS NEGRAS, COAH.",1,1,2,1,0,0,
19/04/2016,COAH.,"MONCLOVA, COAH.",1,1,2,1,0,14,
19/04/2016,TAB.,"CUNDUACAN, TAB.",1,0,1,0,0,0,
19/04/2016,GRO.,"PEDRO ASCENCIO ALQUISIRAS, GRO.",1,0,1,0,0,0,
19/04/2016,COAH.,"MATAMOROS, COAH.",1,0,1,0,0,0,
19/04/2016,COAH.,"RAMOS ARIZPE, COAH.",1,0,1,0,0,0,
19/04/2016,TAB.,"NACAJUCA, TAB.",0,0,0,0,0,10,
19/04/2016,COAH.,"SALTILLO, COAH.",0,0,0,7,1,43,
20/04/2016,D.F.,"IZTACALCO, D.F.",6,3,9,269,0,97,
20/04/2016,COAH.,"FRANCISCO I. MADERO, COAH.",3,0,3,0,0,0,
20/04/2016,COAH.,"SALTILLO, COAH.",0,3,3,0,0,23,
20/04/2016,COAH.,"TORREÓN, COAH.",1,1,2,0,1,0,
20/04/2016,GRO.,"PEDRO ASCENCIO ALQUISIRAS, GRO.",1,0,1,0,0,0,
20/04/2016,COAH.,"MATAMOROS, COAH.",1,0,1,0,0,0,
20/04/2016,COAH.,"ACUÑA, COAH.",1,0,1,0,0,0,
20/04/2016,TAB.,"TENOSIQUE, TAB.",0,0,0,0,0,60,
21/04/2016,D.F.,"IZTACALCO, D.F.",8,8,16,146,2,440,
21/04/2016,GRO.,"CHILPANCINGO DE LOS BRAVO, GRO.",1,0,1,0,0,0,
21/04/2016,COAH.,"TORREÓN, COAH.",0,1,1,0,0,0,
21/04/2016,COAH.,"FRANCISCO I. MADERO, COAH.",0,1,1,0,0,0,
21/04/2016,COAH.,"ACUÑA, COAH.",0,1,1,0,0,0,
21/04/2016,COAH.,"SALTILLO, COAH.",0,0,0,0,0,22,
21/04/2016,COAH.,"RAMOS ARIZPE, COAH.",0,0,0,1,0,0,
22/04/2016,D.F.,"IZTAPALAPA, D.F.",10,8,18,262,6,105,
22/04/2016,COAH.,"SAN PEDRO, COAH.",2,2,4,0,0,0,
22/04/2016,COAH.,"TORREÓN, COAH.",0,1,1,0,0,0,
22/04/2016,COAH.,"FRANCISCO I. MADERO, COAH.",1,0,1,0,0,0,
22/04/2016,COAH.,"ACUÑA, COAH.",0,1,1,0,0,0,
22/04/2016,COAH.,"SALTILLO, COAH.",0,0,0,0,0,22,
22/04/2016,COAH.,"RAMOS ARIZPE, COAH.",0,0,0,1,1,0,
22/04/2016,TAB.,"NACAJUCA, TAB.",0,0,0,2,0,21,
23/04/2016,COAH.,"SAN PEDRO, COAH.",0,2,2,0,0,36,
25/04/2016,COAH.,"TORREÓN, COAH.",2,0,2,0,0,0,
25/04/2016,COAH.,"MONCLOVA, COAH.",0,1,1,0,0,51,
25/04/2016,COAH.,"SALTILLO, COAH.",1,0,1,1,0,190,
25/04/2016,TAB.,"NACAJUCA, TAB.",0,0,0,1,0,50,
26/04/2016,COAH.,"TORREÓN, COAH.",4,0,4,0,0,0,
26/04/2016,COAH.,"SALTILLO, COAH.",2,2,4,0,0,0,
26/04/2016,COAH.,"MONCLOVA, COAH.",1,1,2,0,0,72,
26/04/2016,COAH.,"FRANCISCO I. MADERO, COAH.",2,0,2,0,0,0,
26/04/2016,COAH.,"ACUÑA, COAH.",1,0,1,0,0,0,
27/04/2016,GRO.,"ATOYAC DE ALVAREZ, GRO.",0,1,1,0,0,0,
27/04/2016,CHIS.,"MAZATÁN, CHIS.",0,1,1,0,0,0,
27/04/2016,COAH.,"PIEDRAS NEGRAS, COAH.",0,1,1,0,0,0,
27/04/2016,COAH.,"MONCLOVA, COAH.",1,0,1,0,0,0,
27/04/2016,COAH.,"SALTILLO, COAH.",1,0,1,0,0,50,
27/04/2016,COAH.,"ACUÑA, COAH.",1,0,1,0,0,0,
28/04/2016,COAH.,"TORREÓN, COAH.",1,0,1,0,0,0,
28/04/2016,GRO.,"ATOYAC DE ALVAREZ, GRO.",1,0,1,0,0,0,
28/04/2016,GRO.,"CHILPANCINGO DE LOS BRAVO, GRO.",1,0,1,0,0,0,
29/04/2016,COAH.,"TORREÓN, COAH.",3,2,5,0,0,0,
29/04/2016,COAH.,"PIEDRAS NEGRAS, COAH.",3,1,4,4,0,0,
29/04/2016,DGO.,"DGO., DGO.",3,0,3,1,0,0,
29/04/2016,COAH.,"SALTILLO, COAH.",0,2,2,0,5,0,
29/04/2016,GRO.,"PUNGARABATO, GRO.",1,0,1,0,0,0,
29/04/2016,TAB.,"NACAJUCA, TAB.",0,0,0,3,0,23,
30/04/2016,GRO.,"PUNGARABATO, GRO.",2,0,2,0,0,0,
30/04/2016,COAH.,"FRANCISCO I. MADERO, COAH.",1,0,1,0,0,0,
01/05/2016,COAH.,"FRANCISCO I. MADERO, COAH.",0,1,1,0,0,0,
02/05/2016,COAH.,"SALTILLO, COAH.",0,4,4,0,0,80,
02/05/2016,COAH.,"FRANCISCO I. MADERO, COAH.",2,0,2,0,0,0,
02/05/2016,GRO.,"PEDRO ASCENCIO ALQUISIRAS, GRO.",2,0,2,0,0,0,
02/05/2016,COAH.,"RAMOS ARIZPE, COAH.",1,0,1,0,0,0,
02/05/2016,GTO.,"MANUEL DOBLADO, GTO.",0,1,1,0,0,0,
03/05/2016,GTO.,"MANUEL DOBLADO, GTO.",0,3,3,0,0,0,
03/05/2016,COAH.,"SAN PEDRO, COAH.",0,2,2,0,0,0,
03/05/2016,COAH.,"TORREÓN, COAH.",1,0,1,0,0,0,
03/05/2016,COAH.,"SALTILLO, COAH.",1,0,1,0,0,0,
03/05/2016,DGO.,"DGO., DGO.",1,0,1,0,0,0,
04/05/2016,COAH.,"TORREÓN, COAH.",7,0,7,0,0,0,
04/05/2016,COAH.,"TORREÓN, COAH.",1,1,2,0,0,0,
04/05/2016,GTO.,"MANUEL DOBLADO, GTO.",0,1,1,0,0,0,
05/05/2016,COAH.,"SABINAS, COAH.",1,0,1,0,0,0,
05/05/2016,GRO.,"COYUCA DE BENITEZ, GRO.",1,0,1,0,0,0,
05/05/2016,TAB.,"TENOSIQUE, TAB.",1,0,1,0,0,0,
05/05/2016,COAH.,"ACUÑA, COAH.",0,0,0,0,1,0,
05/05/2016,DGO.,"DGO., DGO.",0,0,0,0,1,0,
06/05/2016,COAH.,"MONCLOVA, COAH.",1,0,1,0,0,0,
06/05/2016,COAH.,"SAN PEDRO, COAH.",1,0,1,0,0,0,
06/05/2016,COAH.,"SABINAS, COAH.",1,0,1,0,0,0,
06/05/2016,COAH.,"SALTILLO, COAH.",1,0,1,0,0,0,
06/05/2016,COAH.,"ACUÑA, COAH.",0,1,1,0,0,0,
06/05/2016,GTO.,"ROMITA, GTO.",1,0,1,0,0,0,
06/05/2016,GRO.,"CHILPANCINGO DE LOS BRAVO, GRO.",1,0,1,0,0,0,
07/05/2016,COAH.,"MOR., COAH.",3,2,5,0,0,40,
07/05/2016,COAH.,"FRANCISCO I. MADERO, COAH.",2,0,2,0,0,0,
07/05/2016,GTO.,"ROMITA, GTO.",0,1,1,0,0,0,
07/05/2016,GRO.,"COYUCA DE CATALAN, GRO.",0,1,1,0,0,0,
07/05/2016,COAH.,"SAN PEDRO, COAH.",0,1,1,0,0,0,
07/05/2016,COAH.,"SALTILLO, COAH.",1,0,1,0,0,0,
08/05/2016,GTO.,"ROMITA, GTO.",3,0,3,0,0,115,
08/05/2016,DGO.,"DGO., DGO.",0,1,1,0,0,0,
09/05/2016,COAH.,"TORREÓN, COAH.",2,1,3,0,0,32,
09/05/2016,DGO.,"DGO., DGO.",2,0,2,0,0,0,
09/05/2016,GRO.,"CHILPANCINGO DE LOS BRAVO, GRO.",2,0,2,0,0,0,
09/05/2016,GTO.,"ROMITA, GTO.",1,0,1,0,0,0,
09/05/2016,GRO.,"TELOLOAPAN, GRO.",0,0,0,0,0,354,
10/05/2016,GTO.,"ROMITA, GTO.",0,2,2,0,0,0,
10/05/2016,COAH.,"PIEDRAS NEGRAS, COAH.",0,2,2,4,0,0,
10/05/2016,DGO.,"DGO., DGO.",1,0,1,0,0,0,
10/05/2016,GRO.,"COYUCA DE CATALAN, GRO.",0,1,1,0,0,0,
10/05/2016,COAH.,"TORREÓN, COAH.",1,0,1,1,0,28,
11/05/2016,COAH.,"SALTILLO, COAH.",1,0,1,0,0,0,
11/05/2016,COAH.,"ACUÑA, COAH.",0,1,1,0,0,0,
11/05/2016,DGO.,"DGO., DGO.",0,0,0,0,2,0,
11/05/2016,DGO.,"DGO., DGO.",0,0,0,0,0,5,
12/05/2016,COAH.,"SALTILLO, COAH.",2,0,2,0,0,0,
12/05/2016,COAH.,"PIEDRAS NEGRAS, COAH.",0,1,1,2,0,10,
12/05/2016,COAH.,"SABINAS, COAH.",0,1,1,0,0,0,
12/05/2016,COAH.,"ACUÑA, COAH.",0,1,1,0,0,0,
12/05/2016,GRO.,"CHILPANCINGO DE LOS BRAVO, GRO.",1,0,1,0,0,0,
12/05/2016,GRO.,"COYUCA DE CATALAN, GRO.",0,1,1,0,0,0,
12/05/2016,YUC.,"UMAN, YUC.",0,0,0,2,0,55,
13/05/2016,GRO.,"COYUCA DE CATALAN, GRO.",2,0,2,0,0,35,
13/05/2016,GRO.,"CHILPANCINGO DE LOS BRAVO, GRO.",2,0,2,0,0,0,
13/05/2016,GTO.,"ROMITA, GTO.",1,0,1,0,0,0,
13/05/2016,YUC.,"UMAN, YUC.",0,0,0,0,0,150,
13/05/2016,TAB.,"TENOSIQUE, TAB.",0,0,0,0,0,100,
13/05/2016,YUC.,"UMAN, YUC.",0,0,0,0,0,150,
14/05/2016,D.F.,"MILPA ALTA, D.F.",70,95,165,"1,971",89,2995,
14/05/2016,COAH.,"PIEDRAS NEGRAS, COAH.",1,1,2,0,0,10,
14/05/2016,COAH.,"MATAMOROS, COAH.",1,0,1,0,0,0,
15/05/2016,GTO.,"ROMITA, GTO.",0,0,0,0,0,5,
16/05/2016,COAH.,"SAN PEDRO, COAH.",1,1,2,0,0,0,
16/05/2016,COAH.,"TORREÓN, COAH.",1,0,1,0,0,0,
16/05/2016,COAH.,"FRANCISCO I. MADERO, COAH.",0,1,1,0,0,0,
16/05/2016,COAH.,"SALTILLO, COAH.",1,0,1,0,0,0,
17/05/2016,COAH.,"TORREÓN, COAH.",1,0,1,0,0,0,
17/05/2016,COAH.,"SALTILLO, COAH.",1,0,1,0,0,0,
18/05/2016,GRO.,"TLAPA DE COMONFORT, GRO.",1,1,2,0,0,0,
18/05/2016,COAH.,"MONCLOVA, COAH.",1,0,1,0,0,38,
18/05/2016,COAH.,"TORREÓN, COAH.",0,1,1,0,0,0,
18/05/2016,GRO.,"BUENAVISTA DE CUELLAR, GRO.",1,0,1,0,0,0,
18/05/2016,DGO.,"DGO., DGO.",0,1,1,0,0,0,
18/05/2016,COAH.,"RAMOS ARIZPE, COAH.",0,0,0,0,0,200,
18/05/2016,N.L.,"MONTERREY, N.L.",0,0,0,4,0,92,
19/05/2016,COAH.,"SALTILLO, COAH.",1,1,2,0,0,50,
19/05/2016,COAH.,"RAMOS ARIZPE, COAH.",1,1,2,0,0,300,
19/05/2016,COAH.,"ACUÑA, COAH.",2,0,2,0,0,0,
19/05/2016,COAH.,"TORREÓN, COAH.",1,0,1,0,0,0,
19/05/2016,COAH.,"TORREÓN, COAH.",1,0,1,0,0,0,
19/05/2016,N.L.,"MONTERREY, N.L.",1,0,1,50,0,100,
19/05/2016,CHIS.,"MAZATÁN, CHIS.",1,0,1,0,0,0,
20/05/2016,D.F.,"MILPA ALTA, D.F.",13,39,52,410,36,342,
20/05/2016,GRO.,"TLAPA DE COMONFORT, GRO.",0,2,2,0,0,0,
20/05/2016,COAH.,"TORREÓN, COAH.",2,0,2,0,0,0,
20/05/2016,COAH.,"FRANCISCO I. MADERO, COAH.",2,0,2,0,2,0,
20/05/2016,N.L.,"MONTERREY, N.L.",2,0,2,0,0,0,
20/05/2016,COAH.,"SABINAS, COAH.",1,0,1,0,0,0,
20/05/2016,N.L.,"GUADALUPE, N.L.",0,0,0,0,0,100,
21/05/2016,COAH.,"RAMOS ARIZPE, COAH.",2,0,2,0,1,30,
21/05/2016,DGO.,"DGO., DGO.",1,0,1,0,0,0,
21/05/2016,COAH.,"TORREÓN, COAH.",1,0,1,0,0,0,
21/05/2016,N.L.,"MONTERREY, N.L.",0,0,0,0,0,500,
21/05/2016,N.L.,"GUADALUPE, N.L.",0,0,0,0,0,500,
22/05/2016,N.L.,"GUADALUPE, N.L.",4,1,5,0,0,100,
22/05/2016,N.L.,"MONTERREY, N.L.",2,0,2,2,0,37,
23/05/2016,N.L.,"MONTERREY, N.L.",6,4,10,0,3,200,
23/05/2016,COAH.,"SALTILLO, COAH.",1,1,2,0,0,0,
23/05/2016,DGO.,"DGO., DGO.",2,0,2,1,0,0,
23/05/2016,GRO.,"CUTZAMALA DE PINZON, GRO.",1,0,1,0,0,0,
24/05/2016,COAH.,"MONCLOVA, COAH.",5,3,8,1,1,30,
24/05/2016,COAH.,"FRANCISCO I. MADERO, COAH.",5,3,8,25,2,0,
24/05/2016,COAH.,"SALTILLO, COAH.",4,3,7,1,1,320,
24/05/2016,COAH.,"ACUÑA, COAH.",5,1,6,25,0,0,
24/05/2016,DGO.,"DGO., DGO.",1,1,2,4,4,0,
24/05/2016,N.L.,"MONTERREY, N.L.",2,0,2,0,0,149,
25/05/2016,N.L.,"MONTERREY, N.L.",3,1,4,0,0,387,
25/05/2016,N.L.,"GUADALUPE, N.L.",2,1,3,0,0,150,
25/05/2016,COAH.,"SAN PEDRO, COAH.",2,0,2,0,0,0,
25/05/2016,COAH.,"FRANCISCO I. MADERO, COAH.",1,0,1,1,0,18,
25/05/2016,COAH.,"SALTILLO, COAH.",0,1,1,0,0,0,
26/05/2016,N.L.,"MONTERREY, N.L.",6,0,6,4,0,17,
26/05/2016,N.L.,"GUADALUPE, N.L.",2,3,5,0,0,100,
26/05/2016,COAH.,"MONCLOVA, COAH.",1,1,2,0,0,37,
26/05/2016,COAH.,"FRANCISCO I. MADERO, COAH.",2,0,2,0,0,0,
26/05/2016,YUC.,"TEMAX, YUC.",0,0,0,3,0,0,
26/05/2016,DGO.,"DGO., DGO.",0,0,0,0,5,0,
26/05/2016,COAH.,"RAMOS ARIZPE, COAH.",0,0,0,2,0,0,
27/05/2016,D.F.,"XOCHIMILCO, D.F.",18,40,58,712,24,544,
27/05/2016,N.L.,"MONTERREY, N.L.",5,9,14,5,0,981,
27/05/2016,N.L.,"GUADALUPE, N.L.",7,1,8,0,0,138,
27/05/2016,COAH.,"SAN PEDRO, COAH.",0,2,2,0,0,0,
27/05/2016,COAH.,"RAMOS ARIZPE, COAH.",0,1,1,0,0,165,
27/05/2016,DGO.,"DGO., DGO.",1,0,1,1,0,0,
28/05/2016,N.L.,"MONTERREY, N.L.",2,0,2,0,0,0,
28/05/2016,N.L.,"GUADALUPE, N.L.",1,1,2,0,0,0,
28/05/2016,COAH.,"FRANCISCO I. MADERO, COAH.",1,0,1,0,0,0,
28/05/2016,COAH.,"FRANCISCO I. MADERO, COAH.",0,1,1,0,0,0,
29/05/2016,N.L.,"GUADALUPE, N.L.",6,0,6,0,0,0,
30/05/2016,N.L.,"GUADALUPE, N.L.",11,5,16,0,0,430,
30/05/2016,GTO.,"MANUEL DOBLADO, GTO.",0,1,1,0,0,0,
30/05/2016,COAH.,"FRANCISCO I. MADERO, COAH.",1,0,1,0,0,0,
30/05/2016,COAH.,"SALTILLO, COAH.",1,0,1,0,0,0,
30/05/2016,N.L.,"MONTERREY, N.L.",1,0,1,0,0,404,
30/05/2016,COAH.,"RAMOS ARIZPE, COAH.",0,0,0,0,1,0,
31/05/2016,N.L.,"APODACA, N.L.",0,2,2,0,0,763,
01/06/2016,COAH.,"PIEDRAS NEGRAS, COAH.",3,0,3,0,0,0,
01/06/2016,COAH.,"FRANCISCO I. MADERO, COAH.",0,1,1,0,0,0,
01/06/2016,COAH.,"MONCLOVA, COAH.",0,0,0,0,0,34,
02/06/2016,COAH.,"SALTILLO, COAH.",0,4,4,0,0,0,
02/06/2016,COAH.,"PIEDRAS NEGRAS, COAH.",0,2,2,0,0,0,
02/06/2016,COAH.,"TORREÓN, COAH.",2,0,2,0,0,55,
02/06/2016,COAH.,"MÚZQUIZ, COAH.",1,1,2,0,0,0,
02/06/2016,N.L.,"APODACA, N.L.",1,0,1,0,0,100,
02/06/2016,COAH.,"FRANCISCO I. MADERO, COAH.",0,1,1,0,0,0,
02/06/2016,COAH.,"MATAMOROS, COAH.",1,0,1,0,0,0,
02/06/2016,COAH.,"SABINAS, COAH.",1,0,1,0,0,0,
02/06/2016,N.L.,"APODACA, N.L.",0,1,1,0,0,350,
02/06/2016,N.L.,"MONTERREY, N.L.",0,0,0,0,0,105,
03/06/2016,D.F.,"XOCHIMILCO, D.F.",7,10,17,60,15,1738,
04/06/2016,COAH.,"TORREÓN, COAH.",7,0,7,0,0,0,
04/06/2016,COAH.,"MÚZQUIZ, COAH.",1,2,3,0,0,0,
04/06/2016,N.L.,"APODACA, N.L.",2,1,3,4,0,80,
04/06/2016,COAH.,"SAN PEDRO, COAH.",1,0,1,0,0,0,
04/06/2016,COAH.,"SAN PEDRO, COAH.",1,0,1,0,0,0,
04/06/2016,COAH.,"SALTILLO, COAH.",0,0,0,1,0,0,
04/06/2016,COAH.,"RAMOS ARIZPE, COAH.",0,0,0,0,1,0,
04/06/2016,CHIS.,"MAZATÁN, CHIS.",0,0,0,0,0,605,
05/06/2016,N.L.,"APODACA, N.L.",1,0,1,0,1,89,
06/06/2016,D.F.,"VENUSTIANO CARRANZA, D.F.",8,9,17,155,0,0,
06/06/2016,COAH.,"SAN PEDRO, COAH.",1,1,2,0,0,0,
06/06/2016,COAH.,"TORREÓN, COAH.",0,1,1,0,0,0,
06/06/2016,COAH.,"RAMOS ARIZPE, COAH.",0,0,0,25,0,0,
06/06/2016,COAH.,"SALTILLO, COAH.",0,0,0,2,0,45,
06/06/2016,COAH.,"RAMOS ARIZPE, COAH.",0,0,0,0,1,0,
06/06/2016,N.L.,"APODACA, N.L.",0,0,0,0,0,150,
07/06/2016,D.F.,"VENUSTIANO CARRANZA, D.F.",8,11,19,0,0,327,
07/06/2016,ZAC.,"ZAC., ZAC.",5,2,7,1,0,62,
07/06/2016,COAH.,"FRANCISCO I. MADERO, COAH.",1,0,1,0,0,0,
07/06/2016,COAH.,"MONCLOVA, COAH.",1,0,1,0,1,33,
08/06/2016,D.F.,"VENUSTIANO CARRANZA, D.F.",10,2,12,324,4,107,
08/06/2016,COAH.,"TORREÓN, COAH.",1,2,3,0,0,0,
08/06/2016,COAH.,"SALTILLO, COAH.",2,0,2,0,0,0,
08/06/2016,COAH.,"MONCLOVA, COAH.",1,0,1,0,0,0,
08/06/2016,N.L.,"APODACA, N.L.",1,0,1,0,0,0,
09/06/2016,D.F.,"VENUSTIANO CARRANZA, D.F.",10,4,14,162,3,1352,
09/06/2016,COAH.,"SALTILLO, COAH.",2,0,2,3,0,54,
09/06/2016,COAH.,"TORREÓN, COAH.",0,1,1,0,0,0,
09/06/2016,COAH.,"FRANCISCO I. MADERO, COAH.",1,0,1,0,0,0,
09/06/2016,COAH.,"SABINAS, COAH.",0,1,1,2,0,0,
09/06/2016,N.L.,"CADEREYTA JIMENEZ, N.L.",0,0,0,0,0,50,
10/06/2016,D.F.,"VENUSTIANO CARRANZA, D.F.",17,23,40,135,1,184,
10/06/2016,N.L.,"CADEREYTA JIMENEZ, N.L.",1,1,2,0,0,0,
10/06/2016,COAH.,"MÚZQUIZ, COAH.",1,1,2,0,0,0,
10/06/2016,GRO.,"ALPOYECA, GRO.",0,1,1,0,0,0,
10/06/2016,N.L.,"SAN NICOLAS DE LOS GARZA, N.L.",1,0,1,0,2,3000,
10/06/2016,COAH.,"TORREÓN, COAH.",1,0,1,0,0,0,
10/06/2016,COAH.,"TORREÓN, COAH.",1,0,1,0,0,0,
10/06/2016,COAH.,"SALTILLO, COAH.",1,0,1,0,0,0,
10/06/2016,COAH.,"MONCLOVA, COAH.",0,0,0,0,0,65,
11/06/2016,COAH.,"TORREÓN, COAH.",2,0,2,0,0,0,
12/06/2016,N.L.,"SAN NICOLAS DE LOS GARZA, N.L.",1,0,1,0,0,103,
13/06/2016,D.F.,"VENUSTIANO CARRANZA, D.F.",8,13,21,0,5,1805,
13/06/2016,N.L.,"SAN NICOLAS DE LOS GARZA, N.L.",2,1,3,0,0,4090,
13/06/2016,N.L.,"CADEREYTA JIMENEZ, N.L.",2,0,2,0,0,50,
13/06/2016,COAH.,"MÚZQUIZ, COAH.",1,1,2,0,0,0,
13/06/2016,COAH.,"FRANCISCO I. MADERO, COAH.",1,0,1,0,0,0,
13/06/2016,COAH.,"MONCLOVA, COAH.",1,0,1,0,0,0,
13/06/2016,COAH.,"FRANCISCO I. MADERO, COAH.",1,0,1,3,0,0,
13/06/2016,COAH.,"SALTILLO, COAH.",1,0,1,0,0,0,
14/06/2016,D.F.,"VENUSTIANO CARRANZA, D.F.",18,22,40,203,0,166,
14/06/2016,COAH.,"MONCLOVA, COAH.",2,0,2,0,0,18,
14/06/2016,N.L.,"CADEREYTA JIMENEZ, N.L.",2,0,2,0,0,0,
14/06/2016,COAH.,"TORREÓN, COAH.",1,0,1,0,0,0,
14/06/2016,COAH.,"SAN PEDRO, COAH.",0,1,1,0,0,0,
14/06/2016,COAH.,"RAMOS ARIZPE, COAH.",0,1,1,2,0,0,
14/06/2016,COAH.,"FRANCISCO I. MADERO, COAH.",0,0,0,2,0,0,
15/06/2016,D.F.,"VENUSTIANO CARRANZA, D.F.",14,15,29,217,5,1403,
15/06/2016,N.L.,"SAN NICOLAS DE LOS GARZA, N.L.",3,0,3,0,0,3435,
15/06/2016,COAH.,"TORREÓN, COAH.",0,1,1,0,0,0,
15/06/2016,COAH.,"SABINAS, COAH.",1,0,1,0,0,0,
15/06/2016,N.L.,"CADEREYTA JIMENEZ, N.L.",1,0,1,0,0,25,
16/06/2016,D.F.,"VENUSTIANO CARRANZA, D.F.",18,18,36,182,8,504,
16/06/2016,VER.,"POZA RICA DE HGO., VER.",1,1,2,0,0,500,
16/06/2016,COAH.,"SALTILLO, COAH.",0,0,0,3,0,35,
16/06/2016,N.L.,"SAN PEDRO GARZA GARCIA, N.L.",0,0,0,0,0,200,
16/06/2016,N.L.,"SANTA CATARINA, N.L.",0,0,0,0,0,100,
17/06/2016,D.F.,"VENUSTIANO CARRANZA, D.F.",9,15,24,0,17,455,
17/06/2016,VER.,"POZA RICA DE HGO., VER.",4,2,6,3,0,0,
17/06/2016,COAH.,"MONCLOVA, COAH.",2,0,2,0,0,50,
17/06/2016,COAH.,"TORREÓN, COAH.",0,1,1,0,0,0,
17/06/2016,COAH.,"FRANCISCO I. MADERO, COAH.",1,0,1,0,0,0,
17/06/2016,PUE.,"XICOTEPEC, PUE.",1,0,1,0,0,0,
17/06/2016,N.L.,"SANTA CATARINA, N.L.",0,0,0,0,1,0,
18/06/2016,COAH.,"SABINAS, COAH.",1,0,1,0,0,0,
18/06/2016,VER.,"TANTOYUCA, VER.",0,1,1,0,0,0,
19/06/2016,N.L.,"SAN PEDRO GARZA GARCIA, N.L.",1,0,1,0,0,4116,
19/06/2016,N.L.,"SAN PEDRO GARZA GARCIA, N.L.",0,0,0,0,0,3510,
20/06/2016,D.F.,"BENITO JUAREZ, D.F.",12,23,35,90,12,96,
20/06/2016,SIN.,"AHOME, SIN.",17,16,33,0,7,0,
20/06/2016,SIN.,"MAZATLAN, SIN.",1,1,2,0,4,0,
20/06/2016,COAH.,"MONCLOVA, COAH.",0,2,2,0,0,0,
20/06/2016,COAH.,"FRANCISCO I. MADERO, COAH.",0,1,1,0,0,0,
20/06/2016,COAH.,"SAN PEDRO, COAH.",0,1,1,0,0,0,
20/06/2016,N.L.,"SANTA CATARINA, N.L.",1,0,1,0,0,0,
20/06/2016,COAH.,"SALTILLO, COAH.",0,0,0,0,1,0,
20/06/2016,COAH.,"ACUÑA, COAH.",0,0,0,1,0,17,
20/06/2016,N.L.,"SAN PEDRO GARZA GARCIA, N.L.",0,0,0,1,0,0,
21/06/2016,SIN.,"AHOME, SIN.",28,9,37,0,5,0,
21/06/2016,D.F.,"BENITO JUAREZ, D.F.",12,11,23,0,10,3491,
21/06/2016,SIN.,"MAZATLAN, SIN.",3,1,4,0,11,0,
21/06/2016,N.L.,"SAN PEDRO GARZA GARCIA, N.L.",2,0,2,0,0,0,
21/06/2016,COAH.,"PIEDRAS NEGRAS, COAH.",1,1,2,0,0,4,
21/06/2016,N.L.,"SANTA CATARINA, N.L.",0,1,1,0,0,0,
21/06/2016,COAH.,"SABINAS, COAH.",1,0,1,0,0,0,
21/06/2016,COAH.,"SALTILLO, COAH.",1,0,1,0,0,0,
21/06/2016,PUE.,"PUE., PUE.",1,0,1,0,0,0,
21/06/2016,COAH.,"MÚZQUIZ, COAH.",0,0,0,17,0,0,
22/06/2016,SIN.,"AHOME, SIN.",23,13,36,0,5,0,
22/06/2016,D.F.,"BENITO JUAREZ, D.F.",6,13,19,335,5,2480,
22/06/2016,SIN.,"MAZATLAN, SIN.",5,3,8,0,12,0,
22/06/2016,N.L.,"SANTA CATARINA, N.L.",1,1,2,0,0,0,
22/06/2016,COAH.,"SALTILLO, COAH.",0,1,1,0,0,0,
22/06/2016,COAH.,"SABINAS, COAH.",1,0,1,0,0,0,
22/06/2016,YUC.,"KANTUNIL, YUC.",1,0,1,0,0,0,
22/06/2016,VER.,"POZA RICA DE HGO., VER.",0,0,0,0,0,156,
23/06/2016,SIN.,"AHOME, SIN.",20,11,31,0,6,0,
23/06/2016,D.F.,"BENITO JUAREZ, D.F.",9,5,14,0,16,0,
23/06/2016,N.L.,"SANTA CATARINA, N.L.",2,0,2,0,0,50,
23/06/2016,SIN.,"MAZATLAN, SIN.",1,0,1,0,9,0,
23/06/2016,PUE.,"PUE., PUE.",1,0,1,0,0,0,
23/06/2016,COAH.,"SALTILLO, COAH.",1,0,1,0,0,104,
23/06/2016,COAH.,"RAMOS ARIZPE, COAH.",1,0,1,0,0,0,
23/06/2016,VER.,"COATZACOALCOS, VER.",0,1,1,0,0,0,
24/06/2016,SIN.,"AHOME, SIN.",31,8,39,0,3,0,
24/06/2016,D.F.,"BENITO JUAREZ, D.F.",21,14,35,70,6,289,
24/06/2016,SIN.,"MAZATLAN, SIN.",6,5,11,0,11,0,
24/06/2016,CHIH.,"HGO. DEL PARRAL, CHIH.",1,2,3,0,0,0,
24/06/2016,COAH.,"MONCLOVA, COAH.",1,1,2,0,0,7,
24/06/2016,COAH.,"FRANCISCO I. MADERO, COAH.",0,2,2,0,0,0,
24/06/2016,VER.,"TANTOYUCA, VER.",1,0,1,0,0,0,
24/06/2016,COAH.,"SAN PEDRO, COAH.",0,1,1,0,0,0,
24/06/2016,COAH.,"SALTILLO, COAH.",0,1,1,0,0,0,
24/06/2016,COAH.,"SABINAS, COAH.",1,0,1,0,0,0,
24/06/2016,VER.,"POZA RICA DE HGO., VER.",0,0,0,0,0,120,
24/06/2016,N.L.,"SAN PEDRO GARZA GARCIA, N.L.",0,0,0,0,0,396,
25/06/2016,VER.,"TUXPAM, VER.",1,0,1,0,0,0,
26/06/2016,GRO.,"HUAMUXTITLAN, GRO.",0,1,1,0,0,0,
26/06/2016,N.L.,"GARCIA, N.L.",1,0,1,0,0,0,
26/06/2016,N.L.,"SABINAS HGO., N.L.",0,0,0,0,0,1000,
27/06/2016,D.F.,"BENITO JUAREZ, D.F.",18,16,34,145,12,0,
27/06/2016,SIN.,"AHOME, SIN.",24,10,34,0,15,0,
27/06/2016,SIN.,"MAZATLAN, SIN.",6,3,9,0,12,0,
27/06/2016,N.L.,"SABINAS HGO., N.L.",1,5,6,0,0,110,
27/06/2016,COAH.,"MONCLOVA, COAH.",1,1,2,0,0,0,
27/06/2016,COAH.,"TORREÓN, COAH.",0,1,1,0,0,0,
27/06/2016,COAH.,"SALTILLO, COAH.",0,0,0,1,0,8,
28/06/2016,SIN.,"AHOME, SIN.",31,5,36,0,4,0,
28/06/2016,D.F.,"BENITO JUAREZ, D.F.",14,14,28,242,7,398,
28/06/2016,SIN.,"MAZATLAN, SIN.",11,1,12,0,4,0,
28/06/2016,COAH.,"MONCLOVA, COAH.",0,1,1,0,0,96,
28/06/2016,COAH.,"FRANCISCO I. MADERO, COAH.",0,1,1,0,0,0,
28/06/2016,COAH.,"SALTILLO, COAH.",1,0,1,0,0,50,
28/06/2016,COAH.,"RAMOS ARIZPE, COAH.",1,0,1,0,0,0,
28/06/2016,COAH.,"MÚZQUIZ, COAH.",0,1,1,0,0,0,
28/06/2016,CHIH.,"HGO. DEL PARRAL, CHIH.",0,1,1,0,0,0,
28/06/2016,COAH.,"TORREÓN, COAH.",0,1,1,0,0,0,
28/06/2016,HGO.,"PACHUCA DE SOTO, HGO.",1,0,1,0,0,0,
29/06/2016,SIN.,"AHOME, SIN.",30,1,31,0,6,0,
29/06/2016,D.F.,"BENITO JUAREZ, D.F.",9,14,23,290,8,291,
29/06/2016,SIN.,"MAZATLAN, SIN.",8,4,12,0,16,0,
29/06/2016,COAH.,"TORREÓN, COAH.",4,0,4,0,0,0,
29/06/2016,HGO.,"PACHUCA DE SOTO, HGO.",0,2,2,0,0,0,
29/06/2016,N.L.,"SABINAS HGO., N.L.",1,0,1,0,0,0,
29/06/2016,COAH.,"SALTILLO, COAH.",1,0,1,1,0,0,
29/06/2016,COAH.,"ACUÑA, COAH.",0,1,1,0,0,0,
30/06/2016,SIN.,"AHOME, SIN.",37,8,45,0,14,0,
30/06/2016,D.F.,"BENITO JUAREZ, D.F.",21,11,32,243,0,620,
30/06/2016,COAH.,"PIEDRAS NEGRAS, COAH.",2,2,4,0,0,0,
30/06/2016,SIN.,"MAZATLAN, SIN.",3,1,4,0,2,0,
30/06/2016,HGO.,"PACHUCA DE SOTO, HGO.",2,0,2,0,0,0,
30/06/2016,COAH.,"TORREÓN, COAH.",0,2,2,0,1,0,
30/06/2016,N.L.,"GARCIA, N.L.",1,0,1,0,0,95,
30/06/2016,COAH.,"MONCLOVA, COAH.",0,0,0,0,0,17,
01/07/2016,D.F.,"BENITO JUAREZ, D.F.",8,15,23,404,9,100,
01/07/2016,SIN.,"AHOME, SIN.",8,4,12,0,2,0,
01/07/2016,COAH.,"SALTILLO, COAH.",2,1,3,0,0,0,
01/07/2016,COAH.,"TORREÓN, COAH.",2,0,2,0,0,0,
01/07/2016,COAH.,"FRANCISCO I. MADERO, COAH.",1,0,1,0,0,0,
01/07/2016,COAH.,"MONCLOVA, COAH.",1,0,1,0,0,0,
01/07/2016,COAH.,"SABINAS, COAH.",1,0,1,0,0,0,
02/07/2016,COAH.,"ACUÑA, COAH.",0,2,2,0,0,0,
02/07/2016,COAH.,"NUEVA ROSITA, COAH.",1,0,1,0,0,0,
02/07/2016,COAH.,"CUATROCIÉNEGAS, COAH.",0,0,0,0,0,36,
04/07/2016,D.F.,"GUSTAVO A. MADERO, D.F.",9,19,28,107,1,115,
04/07/2016,COAH.,"SALTILLO, COAH.",1,3,4,7,0,268,
04/07/2016,HGO.,"PACHUCA DE SOTO, HGO.",2,0,2,0,0,0,
04/07/2016,COAH.,"SAN PEDRO, COAH.",1,0,1,0,0,0,
04/07/2016,COAH.,"RAMOS ARIZPE, COAH.",1,0,1,0,0,41,
04/07/2016,COAH.,"MONCLOVA, COAH.",0,1,1,0,0,1,
04/07/2016,COAH.,"ACUÑA, COAH.",0,0,0,1,0,23,
05/07/2016,D.F.,"GUSTAVO A. MADERO, D.F.",10,22,32,203,5,0,
05/07/2016,SIN.,"CULIACAN, SIN.",1,3,4,0,0,0,
05/07/2016,COAH.,"SALTILLO, COAH.",2,1,3,0,0,0,
05/07/2016,SIN.,"SAN IGNACIO, SIN.",2,0,2,0,0,0,
05/07/2016,COAH.,"FRANCISCO I. MADERO, COAH.",1,0,1,0,0,0,
05/07/2016,COAH.,"SAN PEDRO, COAH.",1,0,1,0,0,0,
05/07/2016,COAH.,"MATAMOROS, COAH.",1,0,1,0,0,0,
05/07/2016,COAH.,"MONCLOVA, COAH.",0,0,0,1,0,0,
06/07/2016,D.F.,"GUSTAVO A. MADERO, D.F.",23,13,36,0,1,603,
06/07/2016,SIN.,"CULIACAN, SIN.",4,1,5,0,6,0,
06/07/2016,HGO.,"PACHUCA DE SOTO, HGO.",1,2,3,0,0,1000,
06/07/2016,SIN.,"SAN IGNACIO, SIN.",3,0,3,0,0,0,
06/07/2016,HGO.,"ZEMPOALA, HGO.",0,2,2,0,0,0,
06/07/2016,N.L.,"SALINAS VICTORIA, N.L.",2,0,2,0,0,0,
06/07/2016,N.L.,"VALLECILLO, N.L.",2,0,2,0,0,0,
06/07/2016,COAH.,"SALTILLO, COAH.",1,1,2,0,0,0,
06/07/2016,COAH.,"MÚZQUIZ, COAH.",1,0,1,0,0,73,
06/07/2016,YUC.,"KANTUNIL, YUC.",1,0,1,0,0,4,
07/07/2016,D.F.,"GUSTAVO A. MADERO, D.F.",13,26,39,0,1,1097,
07/07/2016,SIN.,"CULIACAN, SIN.",5,0,5,0,0,0,
07/07/2016,SIN.,"SAN IGNACIO, SIN.",0,3,3,0,0,0,
07/07/2016,COAH.,"SALTILLO, COAH.",2,0,2,0,0,0,
07/07/2016,SIN.,"COSALA, SIN.",0,1,1,0,0,0,
07/07/2016,N.L.,"SALINAS VICTORIA, N.L.",0,0,0,0,0,31,
08/07/2016,D.F.,"GUSTAVO A. MADERO, D.F.",9,7,16,0,2,31,
08/07/2016,ZAC.,"GUADALUPE, ZAC.",6,1,7,0,0,0,
08/07/2016,SIN.,"CULIACAN, SIN.",4,0,4,0,0,0,
08/07/2016,COAH.,"RAMOS ARIZPE, COAH.",1,1,2,0,0,300,
08/07/2016,HGO.,"PACHUCA DE SOTO, HGO.",2,0,2,0,0,0,
08/07/2016,ZAC.,"CALERA, ZAC.",1,0,1,0,0,0,
08/07/2016,COAH.,"SALTILLO, COAH.",1,0,1,0,0,50,
08/07/2016,COAH.,"MONCLOVA, COAH.",0,1,1,0,0,0,
08/07/2016,HGO.,"ZEMPOALA, HGO.",1,0,1,0,0,0,
08/07/2016,N.L.,"VALLECILLO, N.L.",0,0,0,0,0,250,
09/07/2016,COAH.,"SAN PEDRO, COAH.",1,0,1,0,0,0,
09/07/2016,N.L.,"SALINAS VICTORIA, N.L.",0,0,0,0,0,610,
11/07/2016,D.F.,"GUSTAVO A. MADERO, D.F.",28,15,43,0,0,991,
11/07/2016,SIN.,"CULIACAN, SIN.",5,1,6,0,7,0,
11/07/2016,SIN.,"COSALA, SIN.",4,2,6,0,0,0,
11/07/2016,N.L.,"SALINAS VICTORIA, N.L.",1,0,1,0,0,533,
11/07/2016,N.L.,"VALLECILLO, N.L.",1,0,1,0,0,0,
11/07/2016,SIN.,"SAN IGNACIO, SIN.",0,1,1,0,0,0,
11/07/2016,N.L.,"SALINAS VICTORIA, N.L.",0,1,1,0,0,0,
12/07/2016,D.F.,"GUSTAVO A. MADERO, D.F.",16,4,20,0,2,1169,
12/07/2016,SIN.,"CULIACAN, SIN.",5,0,5,0,10,0,
12/07/2016,SIN.,"SAN IGNACIO, SIN.",1,0,1,0,0,0,
12/07/2016,SIN.,"COSALA, SIN.",0,0,0,0,1,0,
13/07/2016,D.F.,"GUSTAVO A. MADERO, D.F.",17,7,24,0,5,4461,
13/07/2016,SIN.,"CULIACAN, SIN.",2,3,5,0,4,0,
13/07/2016,ZAC.,"GUADALUPE, ZAC.",2,0,2,0,0,400,
13/07/2016,COAH.,"MÚZQUIZ, COAH.",2,0,2,2,0,0,
13/07/2016,COAH.,"SAN PEDRO, COAH.",2,0,2,0,0,0,
13/07/2016,SIN.,"SAN IGNACIO, SIN.",1,0,1,0,0,0,
13/07/2016,COAH.,"MONCLOVA, COAH.",1,0,1,0,0,0,
14/07/2016,D.F.,"GUSTAVO A. MADERO, D.F.",17,17,34,0,0,981,
14/07/2016,SIN.,"CULIACAN, SIN.",1,3,4,0,1,0,
14/07/2016,COAH.,"SALTILLO, COAH.",1,1,2,0,0,0,
14/07/2016,ZAC.,"GUADALUPE, ZAC.",1,0,1,0,0,750,
14/07/2016,COAH.,"RAMOS ARIZPE, COAH.",1,0,1,0,0,0,
14/07/2016,COAH.,"FRANCISCO I. MADERO, COAH.",0,1,1,0,0,0,
14/07/2016,COAH.,"MONCLOVA, COAH.",0,1,1,0,0,36,
15/07/2016,D.F.,"GUSTAVO A. MADERO, D.F.",16,15,31,0,1,215,
15/07/2016,B.C.,"TIJUANA, B.C.",1,2,3,0,1,0,
15/07/2016,COAH.,"MONCLOVA, COAH.",2,0,2,0,0,1,
15/07/2016,COAH.,"ACUÑA, COAH.",2,0,2,0,0,0,
15/07/2016,SIN.,"CULIACAN, SIN.",1,1,2,0,0,0,
15/07/2016,COAH.,"TORREÓN, COAH.",1,0,1,1,0,23,
15/07/2016,COAH.,"SAN PEDRO, COAH.",1,0,1,0,0,31,
15/07/2016,COAH.,"SALTILLO, COAH.",1,0,1,0,0,0,
15/07/2016,ZAC.,"GUADALUPE, ZAC.",1,0,1,0,0,36,
15/07/2016,SIN.,"COSALA, SIN.",1,0,1,0,0,0,
15/07/2016,N.L.,"SALINAS VICTORIA, N.L.",0,0,0,0,1,0,
17/07/2016,N.L.,"GUADALUPE, N.L.",3,0,3,0,0,0,
18/07/2016,D.F.,"GUSTAVO A. MADERO, D.F.",14,8,22,0,0,145,
18/07/2016,B.C.,"TIJUANA, B.C.",3,2,5,0,0,0,
18/07/2016,COAH.,"SAN PEDRO, COAH.",1,0,1,0,0,0,
18/07/2016,COAH.,"SALTILLO, COAH.",1,0,1,0,0,0,
18/07/2016,COAH.,"SALTILLO, COAH.",0,0,0,0,0,51,
19/07/2016,D.F.,"GUSTAVO A. MADERO, D.F.",18,3,21,0,4,0,
19/07/2016,N.L.,"GUADALUPE, N.L.",2,0,2,4,1,366,
19/07/2016,COAH.,"MONCLOVA, COAH.",0,1,1,0,0,50,
19/07/2016,COAH.,"PIEDRAS NEGRAS, COAH.",0,1,1,0,0,0,
19/07/2016,COAH.,"ACUÑA, COAH.",0,1,1,0,0,0,
19/07/2016,TAB.,"TEAPA, TAB.",1,0,1,0,0,0,
19/07/2016,COAH.,"SALTILLO, COAH.",0,0,0,15,1,9,
19/07/2016,COAH.,"SABINAS, COAH.",0,0,0,1,0,0,
20/07/2016,D.F.,"GUSTAVO A. MADERO, D.F.",11,11,22,0,0,1331,
20/07/2016,TLAX.,"TLAX., TLAX.",1,1,2,0,0,0,
20/07/2016,HGO.,"PACHUCA DE SOTO, HGO.",2,0,2,0,0,0,
21/07/2016,D.F.,"GUSTAVO A. MADERO, D.F.",26,13,39,0,3,0,
21/07/2016,COAH.,"PIEDRAS NEGRAS, COAH.",1,5,6,0,1,38,
21/07/2016,B.C.,"TIJUANA, B.C.",2,2,4,0,0,0,
21/07/2016,B.C.,"MEXICALI, B.C.",1,2,3,0,0,0,
21/07/2016,TLAX.,"PANOTLA, TLAX.",1,1,2,1,0,0,
21/07/2016,TLAX.,"HUAMANTLA, TLAX.",2,0,2,0,0,0,
21/07/2016,COAH.,"MONCLOVA, COAH.",1,1,2,0,0,49,
21/07/2016,B.C.,"TIJUANA, B.C.",0,2,2,0,0,0,
21/07/2016,B.C.,"TIJUANA, B.C.",1,0,1,0,0,0,
21/07/2016,B.C.,"MEXICALI, B.C.",1,0,1,0,0,0,
21/07/2016,COAH.,"FRANCISCO I. MADERO, COAH.",1,0,1,1,0,0,
21/07/2016,COAH.,"SALTILLO, COAH.",1,0,1,5,1,267,
21/07/2016,B.C.,"TIJUANA, B.C.",0,1,1,0,0,0,
21/07/2016,B.C.,"TIJUANA, B.C.",1,0,1,0,0,0,
21/07/2016,N.L.,"GUADALUPE, N.L.",0,0,0,0,0,101,
21/07/2016,COAH.,"SALTILLO, COAH.",0,0,0,0,0,22,
22/07/2016,D.F.,"GUSTAVO A. MADERO, D.F.",28,14,42,0,0,1531,
22/07/2016,COAH.,"SALTILLO, COAH.",6,0,6,14,0,0,
22/07/2016,COAH.,"MONCLOVA, COAH.",2,3,5,0,0,0,
22/07/2016,COAH.,"PIEDRAS NEGRAS, COAH.",1,2,3,0,0,0,
22/07/2016,B.C.,"MEXICALI, B.C.",1,2,3,0,0,0,
22/07/2016,B.C.,"MEXICALI, B.C.",2,0,2,0,0,0,
22/07/2016,CHIS.,"CATAZAJÁ, CHIS.",1,0,1,0,0,0,
22/07/2016,TLAX.,"TLAX., TLAX.",0,1,1,0,0,0,
22/07/2016,N.L.,"GUADALUPE, N.L.",1,0,1,0,0,11,
23/07/2016,COAH.,"MATAMOROS, COAH.",4,0,4,0,0,0,
23/07/2016,B.C.,"TIJUANA, B.C.",0,2,2,0,0,0,
23/07/2016,CHIH.,"HGO. DEL PARRAL, CHIH.",1,0,1,0,0,0,
23/07/2016,N.L.,"GUADALUPE, N.L.",1,0,1,0,0,55,
23/07/2016,COAH.,"FRANCISCO I. MADERO, COAH.",1,0,1,0,0,0,
24/07/2016,B.C.,"MEXICALI, B.C.",1,2,3,0,0,0,
24/07/2016,B.C.,"TIJUANA, B.C.",1,1,2,0,0,0,
24/07/2016,TLAX.,"HUAMANTLA, TLAX.",0,1,1,0,0,0,
25/07/2016,D.F.,"GUSTAVO A. MADERO, D.F.",27,16,43,0,0,1828,
25/07/2016,B.C.,"TIJUANA, B.C.",3,1,4,0,0,0,
25/07/2016,TLAX.,"CUAPIAXTLA, TLAX.",2,1,3,0,0,0,
25/07/2016,TLAX.,"CHIAUTEMPAN, TLAX.",0,1,1,0,0,0,
25/07/2016,ZAC.,"GUADALUPE, ZAC.",1,0,1,0,0,1748,
25/07/2016,CAMP.,"PALIZADA, CAMP.",1,0,1,0,0,0,
25/07/2016,N.L.,"GUADALUPE, N.L.",0,1,1,0,0,82,
26/07/2016,D.F.,"GUSTAVO A. MADERO, D.F.",12,21,33,0,0,0,
26/07/2016,B.C.,"MEXICALI, B.C.",4,0,4,0,0,0,
26/07/2016,COAH.,"PIEDRAS NEGRAS, COAH.",1,1,2,1,0,40,
26/07/2016,COAH.,"SALTILLO, COAH.",2,0,2,2,0,100,
26/07/2016,COAH.,"TORREÓN, COAH.",1,0,1,0,0,0,
26/07/2016,COAH.,"MONCLOVA, COAH.",0,1,1,0,0,0,
26/07/2016,COAH.,"TORREÓN, COAH.",1,0,1,0,0,0,
26/07/2016,COAH.,"PIEDRAS NEGRAS, COAH.",0,1,1,0,0,0,
26/07/2016,B.C.,"TIJUANA, B.C.",0,1,1,0,0,0,
26/07/2016,HGO.,"PACHUCA DE SOTO, HGO.",0,1,1,0,3,0,
26/07/2016,HGO.,"APAN, HGO.",0,1,1,0,0,0,
26/07/2016,TLAX.,"CHIAUTEMPAN, TLAX.",1,0,1,0,0,0,
26/07/2016,CHIH.,"HGO. DEL PARRAL, CHIH.",1,0,1,0,0,0,
26/07/2016,COAH.,"MONCLOVA, COAH.",0,0,0,0,0,129,
27/07/2016,D.F.,"GUSTAVO A. MADERO, D.F.",24,17,41,0,1,420,
27/07/2016,N.L.,"GUADALUPE, N.L.",2,2,4,0,0,8,
27/07/2016,COAH.,"SALTILLO, COAH.",2,0,2,0,0,0,
27/07/2016,COAH.,"MONCLOVA, COAH.",1,0,1,0,0,40,
27/07/2016,N.L.,"MONTERREY, N.L.",1,0,1,0,0,0,
27/07/2016,HGO.,"YAHUALICA, HGO.",1,0,1,0,0,0,
27/07/2016,N.L.,"MONTERREY, N.L.",0,0,0,0,0,80,
27/07/2016,COAH.,"TORREÓN, COAH.",0,0,0,0,0,54,
28/07/2016,D.F.,"GUSTAVO A. MADERO, D.F.",25,16,41,0,0,66,
28/07/2016,N.L.,"GUADALUPE, N.L.",2,1,3,2,0,0,
28/07/2016,COAH.,"MÚZQUIZ, COAH.",1,2,3,0,0,0,
28/07/2016,COAH.,"TORREÓN, COAH.",1,1,2,0,0,0,
28/07/2016,COAH.,"SALTILLO, COAH.",2,0,2,1,0,22,
28/07/2016,B.C.,"TIJUANA, B.C.",1,1,2,0,0,0,
28/07/2016,N.L.,"MONTERREY, N.L.",1,0,1,0,0,0,
28/07/2016,HGO.,"APAN, HGO.",0,1,1,0,0,0,
28/07/2016,ZAC.,"GUADALUPE, ZAC.",1,0,1,0,0,181,
28/07/2016,COAH.,"MONCLOVA, COAH.",1,0,1,0,1,0,
28/07/2016,COAH.,"ACUÑA, COAH.",0,1,1,0,0,0,
29/07/2016,D.F.,"GUSTAVO A. MADERO, D.F.",28,18,46,0,2,1380,
29/07/2016,COAH.,"SAN PEDRO, COAH.",3,0,3,0,0,0,
29/07/2016,COAH.,"SALTILLO, COAH.",2,0,2,0,0,0,
29/07/2016,N.L.,"GUADALUPE, N.L.",2,0,2,1,0,117,
29/07/2016,TLAX.,"CUAPIAXTLA, TLAX.",1,0,1,0,0,0,
29/07/2016,COAH.,"MONCLOVA, COAH.",1,0,1,0,0,25,
29/07/2016,COAH.,"MÚZQUIZ, COAH.",1,0,1,1,0,0,
29/07/2016,N.L.,"MONTERREY, N.L.",1,0,1,0,0,0,
29/07/2016,ZAC.,"CALERA, ZAC.",1,0,1,0,0,1000,
29/07/2016,TLAX.,"CUAPIAXTLA, TLAX.",1,0,1,0,0,0,
29/07/2016,ZAC.,"GUADALUPE, ZAC.",0,0,0,0,0,1002,
30/07/2016,COAH.,"FRANCISCO I. MADERO, COAH.",3,0,3,0,0,0,
30/07/2016,HGO.,"PACHUCA DE SOTO, HGO.",0,2,2,0,0,0,
30/07/2016,HGO.,"TECOZAUTLA, HGO.",2,0,2,0,0,2010,
30/07/2016,B.C.,"MEXICALI, B.C.",1,1,2,0,0,0,
01/08/2016,D.F.,"TLALPAN, D.F.",19,13,32,0,1,0,
01/08/2016,SIN.,"NAVOLATO, SIN.",5,1,6,0,0,0,
01/08/2016,S.L.P.,"SAN LUIS POTOSI, S.L.P.",5,0,5,3,0,0,
01/08/2016,COAH.,"PIEDRAS NEGRAS, COAH.",1,2,3,0,0,0,
01/08/2016,S.L.P.,"CIUDAD VALLES, S.L.P.",1,1,2,0,0,0,
01/08/2016,COAH.,"TORREÓN, COAH.",1,1,2,0,0,0,
01/08/2016,COAH.,"MONCLOVA, COAH.",2,0,2,0,0,25,
01/08/2016,B.C.,"TIJUANA, B.C.",0,1,1,0,0,0,
01/08/2016,ZAC.,"GUADALUPE, ZAC.",1,0,1,0,0,0,
01/08/2016,COAH.,"SABINAS, COAH.",1,0,1,0,0,0,
01/08/2016,COAH.,"ACUÑA, COAH.",0,1,1,0,0,0,
01/08/2016,COAH.,"FRANCISCO I. MADERO, COAH.",0,0,0,1,0,0,
01/08/2016,COAH.,"RAMOS ARIZPE, COAH.",0,0,0,4,0,213,
01/08/2016,N.L.,"GRAL. ESCOBEDO, N.L.",0,0,0,0,0,44,
02/08/2016,D.F.,"TLALPAN, D.F.",22,15,37,0,1,67,
02/08/2016,S.L.P.,"SAN LUIS POTOSI, S.L.P.",7,0,7,2,0,134,
02/08/2016,SIN.,"NAVOLATO, SIN.",2,0,2,0,0,0,
02/08/2016,TLAX.,"APIZACO, TLAX.",1,1,2,0,0,0,
02/08/2016,COAH.,"TORREÓN, COAH.",1,0,1,0,0,0,
02/08/2016,COAH.,"FRANCISCO I. MADERO, COAH.",1,0,1,0,0,0,
02/08/2016,COAH.,"SAN PEDRO, COAH.",1,0,1,0,0,0,
02/08/2016,COAH.,"SALTILLO, COAH.",1,0,1,0,0,0,
02/08/2016,COAH.,"MONCLOVA, COAH.",0,1,1,0,0,213,
02/08/2016,SIN.,"ELOTA, SIN.",1,0,1,0,1,0,
03/08/2016,D.F.,"TLALPAN, D.F.",22,5,27,0,3,1344,
03/08/2016,SIN.,"NAVOLATO, SIN.",4,0,4,0,0,0,
03/08/2016,COAH.,"MONCLOVA, COAH.",1,1,2,0,0,0,
03/08/2016,COAH.,"SALTILLO, COAH.",1,0,1,0,0,20,
04/08/2016,D.F.,"TLALPAN, D.F.",22,29,51,0,0,20,
04/08/2016,S.L.P.,"SAN LUIS POTOSI, S.L.P.",7,0,7,0,0,382,
04/08/2016,B.C.,"TIJUANA, B.C.",0,3,3,0,0,0,
04/08/2016,COAH.,"FRANCISCO I. MADERO, COAH.",0,3,3,0,0,0,
04/08/2016,SON.,"GUAYMAS, SON.",0,2,2,0,0,0,
04/08/2016,S.L.P.,"CIUDAD VALLES, S.L.P.",2,0,2,1,0,14,
04/08/2016,B.C.,"TIJUANA, B.C.",0,1,1,0,0,0,
04/08/2016,COAH.,"SALTILLO, COAH.",1,0,1,0,0,0,
04/08/2016,N.L.,"GRAL. ESCOBEDO, N.L.",1,0,1,0,0,0,
04/08/2016,TLAX.,"APIZACO, TLAX.",1,0,1,0,0,0,
05/08/2016,D.F.,"TLALPAN, D.F.",20,17,37,0,0,686,
05/08/2016,SON.,"GUAYMAS, SON.",1,2,3,0,0,0,
05/08/2016,TLAX.,"SAN PABLO DEL MONTE, TLAX.",1,2,3,0,0,0,
05/08/2016,SIN.,"NAVOLATO, SIN.",2,0,2,0,5,0,
05/08/2016,B.C.,"ENSENADA, B.C.",0,2,2,0,0,0,
05/08/2016,COAH.,"SALTILLO, COAH.",1,0,1,2,1,0,
05/08/2016,COAH.,"RAMOS ARIZPE, COAH.",0,1,1,0,0,0,
05/08/2016,D.F.,"TLALPAN, D.F.",0,0,0,0,16,0,
05/08/2016,Q. ROO,"BENITO JUAREZ, Q. ROO",0,0,0,0,0,70,
06/08/2016,S.L.P.,"SAN LUIS POTOSI, S.L.P.",6,4,10,1,0,105,
06/08/2016,TLAX.,"APIZACO, TLAX.",3,0,3,0,0,0,
06/08/2016,COAH.,"ALLENDE, COAH.",2,0,2,0,0,0,
06/08/2016,SON.,"HERMOSILLO, SON.",1,0,1,0,0,20,
06/08/2016,N.L.,"GRAL. ESCOBEDO, N.L.",1,0,1,0,0,0,
06/08/2016,COAH.,"ARTEAGA, COAH.",0,0,0,2,0,100,
07/08/2016,TLAX.,"APIZACO, TLAX.",1,0,1,0,0,0,
07/08/2016,S.L.P.,"SAN LUIS POTOSI, S.L.P.",1,0,1,0,0,107,
08/08/2016,D.F.,"TLALPAN, D.F.",22,14,36,0,4,25,
08/08/2016,S.L.P.,"CIUDAD VALLES, S.L.P.",8,1,9,4,0,266,
08/08/2016,MEX.,"ACOLMAN, MEX.",4,1,5,0,0,13,
08/08/2016,COAH.,"TORREÓN, COAH.",4,0,4,10,0,0,
08/08/2016,B.C.,"TIJUANA, B.C.",2,1,3,0,0,0,
08/08/2016,TLAX.,"TLAXCO, TLAX.",1,1,2,0,0,0,
08/08/2016,HGO.,"PACHUCA DE SOTO, HGO.",1,1,2,0,0,0,
08/08/2016,COAH.,"SALTILLO, COAH.",0,2,2,0,0,37,
08/08/2016,COAH.,"PIEDRAS NEGRAS, COAH.",2,0,2,0,0,50,
08/08/2016,MEX.,"METEPEC, MEX.",1,0,1,0,0,0,
08/08/2016,MEX.,"LERMA, MEX.",1,0,1,0,0,0,
08/08/2016,B.C.,"TIJUANA, B.C.",1,0,1,0,0,0,
08/08/2016,COAH.,"SAN PEDRO, COAH.",1,0,1,0,0,0,
08/08/2016,COAH.,"MONCLOVA, COAH.",1,0,1,1,0,180,
08/08/2016,S.L.P.,"CIUDAD VALLES, S.L.P.",0,1,1,0,0,0,
08/08/2016,Q. ROO,"BENITO JUAREZ, Q. ROO",0,0,0,0,0,160,
09/08/2016,D.F.,"TLALPAN, D.F.",19,11,30,0,0,0,
09/08/2016,S.L.P.,"SAN LUIS POTOSI, S.L.P.",5,2,7,0,0,37,
09/08/2016,MEX.,"METEPEC, MEX.",0,2,2,0,0,0,
09/08/2016,MEX.,"LERMA, MEX.",1,1,2,1,0,0,
09/08/2016,SIN.,"ELOTA, SIN.",1,1,2,0,0,0,
09/08/2016,HGO.,"PACHUCA DE SOTO, HGO.",0,1,1,0,0,0,
09/08/2016,SIN.,"NAVOLATO, SIN.",0,1,1,0,0,0,
09/08/2016,B.C.,"MEXICALI, B.C.",0,1,1,0,0,0,
09/08/2016,S.L.P.,"CIUDAD VALLES, S.L.P.",1,0,1,1,1,0,
09/08/2016,Q. ROO,"BENITO JUAREZ, Q. ROO",0,0,0,0,0,204,
10/08/2016,D.F.,"TLALPAN, D.F.",22,21,43,0,0,0,
10/08/2016,MEX.,"METEPEC, MEX.",6,1,7,0,0,0,
10/08/2016,MEX.,"HUEHUETOCA, MEX.",4,2,6,0,0,0,
10/08/2016,MEX.,"ACOLMAN, MEX.",3,2,5,0,0,35,
10/08/2016,S.L.P.,"SAN LUIS POTOSI, S.L.P.",2,2,4,0,0,241,
10/08/2016,SIN.,"NAVOLATO, SIN.",3,0,3,0,5,0,
10/08/2016,MEX.,"LERMA, MEX.",0,3,3,1,0,13,
10/08/2016,S.L.P.,"CIUDAD VALLES, S.L.P.",3,0,3,1,1,0,
10/08/2016,TLAX.,"TLAXCO, TLAX.",0,2,2,1,0,0,
10/08/2016,N.L.,"GRAL. ESCOBEDO, N.L.",2,0,2,0,0,18,
10/08/2016,SIN.,"ELOTA, SIN.",1,0,1,0,0,0,
10/08/2016,HGO.,"PACHUCA DE SOTO, HGO.",0,1,1,0,0,0,
10/08/2016,COAH.,"SALTILLO, COAH.",1,0,1,0,0,0,
10/08/2016,COAH.,"PIEDRAS NEGRAS, COAH.",0,1,1,0,0,0,
10/08/2016,COAH.,"MÚZQUIZ, COAH.",1,0,1,0,0,0,
10/08/2016,SON.,"GUAYMAS, SON.",1,0,1,1,0,38,
10/08/2016,Q. ROO,"BENITO JUAREZ, Q. ROO",0,0,0,0,0,200,
11/08/2016,D.F.,"TLALPAN, D.F.",15,20,35,0,0,90,
11/08/2016,S.L.P.,"SAN LUIS POTOSI, S.L.P.",7,4,11,1,0,0,
11/08/2016,COAH.,"TORREÓN, COAH.",3,2,5,0,0,0,
11/08/2016,SIN.,"NAVOLATO, SIN.",5,0,5,0,0,0,
11/08/2016,MEX.,"HUEHUETOCA, MEX.",2,2,4,0,0,10,
11/08/2016,MEX.,"METEPEC, MEX.",3,0,3,4,0,50,
11/08/2016,S.L.P.,"CIUDAD VALLES, S.L.P.",1,1,2,0,0,37,
11/08/2016,SIN.,"ELOTA, SIN.",0,2,2,0,0,0,
11/08/2016,MEX.,"ACOLMAN, MEX.",0,2,2,0,0,0,
11/08/2016,B.C.,"MEXICALI, B.C.",0,2,2,0,0,0,
11/08/2016,SON.,"GUAYMAS, SON.",1,0,1,0,0,82,
11/08/2016,SON.,"CAJEME, SON.",1,0,1,0,0,0,
11/08/2016,CHIH.,"HGO. DEL PARRAL, CHIH.",1,0,1,0,0,95,
11/08/2016,Q. ROO,"BENITO JUAREZ, Q. ROO",0,0,0,0,0,489,
12/08/2016,D.F.,"TLALPAN, D.F.",16,30,46,0,7,8,
12/08/2016,MEX.,"ACOLMAN, MEX.",7,1,8,0,1,4,
12/08/2016,S.L.P.,"SAN LUIS POTOSI, S.L.P.",4,2,6,5,0,0,
12/08/2016,MEX.,"METEPEC, MEX.",5,1,6,0,0,6,
12/08/2016,MEX.,"LERMA, MEX.",4,0,4,2,0,31,
12/08/2016,S.L.P.,"CIUDAD VALLES, S.L.P.",3,0,3,0,1,0,
12/08/2016,COAH.,"MONCLOVA, COAH.",1,1,2,1,0,186,
12/08/2016,TLAX.,"TLAXCO, TLAX.",0,1,1,0,0,0,
12/08/2016,B.C.,"MEXICALI, B.C.",0,1,1,0,0,0,
12/08/2016,TAB.,"TEAPA, TAB.",1,0,1,1,0,1,
12/08/2016,SON.,"HERMOSILLO, SON.",1,0,1,1,0,0,
12/08/2016,SON.,"GUAYMAS, SON.",1,0,1,0,0,0,
12/08/2016,SON.,"CAJEME, SON.",1,0,1,0,0,0,
12/08/2016,SIN.,"NAVOLATO, SIN.",1,0,1,0,3,0,
12/08/2016,Q. ROO,"BENITO JUAREZ, Q. ROO",0,0,0,0,0,1001,
13/08/2016,S.L.P.,"SAN LUIS POTOSI, S.L.P.",4,2,6,0,1,250,
13/08/2016,CHIS.,"BENEMÉRITO DE LAS AMÉRICAS, CHIS.",1,2,3,0,0,0,
13/08/2016,MEX.,"METEPEC, MEX.",2,0,2,0,4,55,
13/08/2016,MEX.,"LERMA, MEX.",2,0,2,2,0,13,
14/08/2016,SON.,"CAJEME, SON.",2,1,3,0,0,0,
14/08/2016,S.L.P.,"CIUDAD VALLES, S.L.P.",2,1,3,0,1,0,
14/08/2016,S.L.P.,"CIUDAD VALLES, S.L.P.",3,0,3,0,0,38,
14/08/2016,MEX.,"HUEHUETOCA, MEX.",2,0,2,0,0,0,
14/08/2016,N.L.,"CADEREYTA JIMENEZ, N.L.",0,2,2,0,0,0,
14/08/2016,TLAX.,"ZACATELCO, TLAX.",1,0,1,1,0,0,
14/08/2016,Q. ROO,"BACALAR, Q. ROO",1,0,1,0,2,101,
14/08/2016,MEX.,"ACOLMAN, MEX.",0,0,0,0,0,48,
15/08/2016,D.F.,"TLALPAN, D.F.",23,18,41,0,5,0,
15/08/2016,MEX.,"TLALNEPANTLA DE BAZ, MEX.",7,2,9,1,6,40,
15/08/2016,MEX.,"TOLUCA, MEX.",5,0,5,3,0,5,
15/08/2016,MEX.,"AMECAMECA, MEX.",4,1,5,0,0,0,
15/08/2016,COAH.,"TORREÓN, COAH.",3,1,4,1,0,40,
15/08/2016,TLAX.,"CALPULALPAN, TLAX.",1,1,2,0,0,0,
15/08/2016,SON.,"HERMOSILLO, SON.",1,1,2,0,0,0,
15/08/2016,SON.,"CAJEME, SON.",2,0,2,0,0,0,
15/08/2016,MEX.,"ZUMPANGO, MEX.",2,0,2,2,0,314,
15/08/2016,Q. ROO,"COZUMEL, Q. ROO",0,0,0,0,0,236,
15/08/2016,Q. ROO,"BENITO JUAREZ, Q. ROO",0,0,0,0,0,729,
16/08/2016,D.F.,"MIGUEL HGO., D.F.",9,8,17,0,2,0,
16/08/2016,MEX.,"AMECAMECA, MEX.",8,3,11,7,0,356,
16/08/2016,MEX.,"TLALNEPANTLA DE BAZ, MEX.",7,0,7,3,0,29,
16/08/2016,SON.,"HERMOSILLO, SON.",2,2,4,6,0,195,
16/08/2016,MEX.,"ZUMPANGO, MEX.",4,0,4,1,0,0,
16/08/2016,MEX.,"TOLUCA, MEX.",3,0,3,0,0,0,
16/08/2016,SON.,"CAJEME, SON.",1,1,2,1,0,0,
16/08/2016,CHIS.,"BENEMÉRITO DE LAS AMÉRICAS, CHIS.",1,1,2,0,0,0,
16/08/2016,SIN.,"BADIRAGUATO, SIN.",1,1,2,0,0,0,
16/08/2016,COAH.,"PIEDRAS NEGRAS, COAH.",0,2,2,0,0,0,
16/08/2016,CHIH.,"GUADALUPE, CHIH.",0,1,1,0,0,0,
16/08/2016,COAH.,"SALTILLO, COAH.",1,0,1,0,0,0,
16/08/2016,COAH.,"RAMOS ARIZPE, COAH.",1,0,1,0,0,0,
16/08/2016,COAH.,"ACUÑA, COAH.",0,1,1,0,0,0,
16/08/2016,N.L.,"SAN NICOLAS DE LOS GARZA, N.L.",1,0,1,0,0,264,
16/08/2016,CHIH.,"HGO. DEL PARRAL, CHIH.",1,0,1,0,0,14,
16/08/2016,Q. ROO,"COZUMEL, Q. ROO",0,0,0,0,0,384,
16/08/2016,Q. ROO,"BENITO JUAREZ, Q. ROO",0,0,0,0,0,411,
16/08/2016,Q. ROO,"ISLA MUJERES, Q. ROO",0,0,0,0,0,140,
17/08/2016,D.F.,"MIGUEL HGO., D.F.",17,14,31,0,0,45,
17/08/2016,SIN.,"BADIRAGUATO, SIN.",1,2,3,0,0,0,
17/08/2016,B.C.,"TIJUANA, B.C.",2,0,2,0,0,0,
17/08/2016,B.C.,"MEXICALI, B.C.",0,2,2,0,0,0,
17/08/2016,CHIH.,"HGO. DEL PARRAL, CHIH.",1,0,1,0,0,212,
17/08/2016,TLAX.,"CALPULALPAN, TLAX.",0,1,1,0,0,0,
17/08/2016,Q. ROO,"COZUMEL, Q. ROO",0,0,0,0,0,410,
17/08/2016,Q. ROO,"BENITO JUAREZ, Q. ROO",0,0,0,0,0,1143,
18/08/2016,MEX.,"TLALNEPANTLA DE BAZ, MEX.",7,5,12,5,0,77,
18/08/2016,MEX.,"AMECAMECA, MEX.",6,1,7,1,0,5,
18/08/2016,MEX.,"TOLUCA, MEX.",5,1,6,1,0,51,
18/08/2016,MEX.,"ZUMPAHUACAN, MEX.",5,0,5,0,1,0,
18/08/2016,MEX.,"AMECAMECA, MEX.",3,1,4,0,0,0,
18/08/2016,COAH.,"SALTILLO, COAH.",3,0,3,0,1,134,
18/08/2016,MEX.,"ZUMPANGO, MEX.",2,1,3,1,0,26,
18/08/2016,SON.,"HERMOSILLO, SON.",1,1,2,1,0,0,
18/08/2016,COAH.,"TORREÓN, COAH.",1,1,2,0,0,0,
18/08/2016,TLAX.,"ZACATELCO, TLAX.",1,1,2,0,0,22,
18/08/2016,TLAX.,"CALPULALPAN, TLAX.",2,0,2,0,0,0,
18/08/2016,N.L.,"SAN NICOLAS DE LOS GARZA, N.L.",1,0,1,0,0,0,
18/08/2016,B.C.,"ENSENADA, B.C.",0,1,1,0,0,0,
18/08/2016,SON.,"CAJEME, SON.",0,1,1,0,0,0,
18/08/2016,COAH.,"MATAMOROS, COAH.",1,0,1,0,0,0,
18/08/2016,COAH.,"MONCLOVA, COAH.",1,0,1,0,0,0,
18/08/2016,COAH.,"PIEDRAS NEGRAS, COAH.",0,1,1,0,0,0,
18/08/2016,N.L.,"SAN NICOLAS DE LOS GARZA, N.L.",1,0,1,0,0,0,
18/08/2016,SIN.,"BADIRAGUATO, SIN.",1,0,1,0,0,0,
18/08/2016,SON.,"GUAYMAS, SON.",0,0,0,0,0,172,
18/08/2016,Q. ROO,"COZUMEL, Q. ROO",0,0,0,0,0,147,
19/08/2016,D.F.,"MIGUEL HGO., D.F.",8,10,18,0,5,15,
19/08/2016,MEX.,"AMECAMECA, MEX.",7,10,17,13,3,73,
19/08/2016,MEX.,"ZUMPANGO, MEX.",7,1,8,3,0,12,
19/08/2016,SON.,"HERMOSILLO, SON.",1,1,2,35,0,1119,
19/08/2016,COAH.,"SALTILLO, COAH.",2,0,2,0,0,228,
19/08/2016,COAH.,"MONCLOVA, COAH.",2,0,2,1,0,7,
19/08/2016,SIN.,"BADIRAGUATO, SIN.",0,1,1,0,0,0,
19/08/2016,CHIH.,"HGO. DEL PARRAL, CHIH.",1,0,1,0,1,362,
19/08/2016,Q. ROO,"BENITO JUAREZ, Q. ROO",1,0,1,0,0,453,
19/08/2016,B.C.,"ENSENADA, B.C.",1,0,1,0,0,0,
19/08/2016,COAH.,"TORREÓN, COAH.",0,1,1,0,0,0,
19/08/2016,COAH.,"SAN PEDRO, COAH.",1,0,1,0,0,0,
19/08/2016,COAH.,"RAMOS ARIZPE, COAH.",1,0,1,0,0,0,
19/08/2016,Q. ROO,"COZUMEL, Q. ROO",0,0,0,0,0,597,
20/08/2016,MEX.,"TLALNEPANTLA DE BAZ, MEX.",9,4,13,3,1,319,
20/08/2016,MEX.,"TOLUCA, MEX.",7,2,9,4,0,18,
20/08/2016,TLAX.,"CALPULALPAN, TLAX.",3,0,3,0,0,0,
20/08/2016,COAH.,"ARTEAGA, COAH.",2,1,3,0,0,100,
20/08/2016,B.C.S.,"COMONDÚ, B.C.S.",0,1,1,0,0,0,
20/08/2016,N.L.,"SAN NICOLAS DE LOS GARZA, N.L.",1,0,1,0,0,0,
20/08/2016,COAH.,"ALLENDE, COAH.",0,1,1,0,0,0,
20/08/2016,TAMPS.,"MATAMOROS, TAMPS.",0,1,1,4,0,40,
20/08/2016,SON.,"HERMOSILLO, SON.",0,0,0,25,0,0,
21/08/2016,MEX.,"AMECAMECA, MEX.",2,0,2,0,4,6,
21/08/2016,TLAX.,"CALPULALPAN, TLAX.",1,0,1,0,0,0,
21/08/2016,MEX.,"ZUMPANGO, MEX.",0,1,1,0,0,8,
21/08/2016,N.L.,"SAN NICOLAS DE LOS GARZA, N.L.",1,0,1,0,0,62,
21/08/2016,B.C.,"TIJUANA, B.C.",1,0,1,0,0,0,
22/08/2016,D.F.,"MIGUEL HGO., D.F.",9,12,21,0,0,0,
22/08/2016,MEX.,"CUAUTITLAN IZCALLI, MEX.",4,4,8,6,1,51,
22/08/2016,MEX.,"CHIMALHUACAN, MEX.",3,1,4,0,0,0,
22/08/2016,MEX.,"CUAUTITLAN, MEX.",2,1,3,1,0,39,
22/08/2016,SIN.,"BADIRAGUATO, SIN.",0,2,2,0,1,0,
23/08/2016,D.F.,"MIGUEL HGO., D.F.",12,6,18,0,8,425,
23/08/2016,MEX.,"CUAUTITLAN IZCALLI, MEX.",7,2,9,3,0,904,
23/08/2016,MEX.,"CHIMALHUACAN, MEX.",5,1,6,0,0,0,
23/08/2016,N.L.,"SAN NICOLAS DE LOS GARZA, N.L.",1,2,3,0,0,33,
23/08/2016,CHIH.,"HGO. DEL PARRAL, CHIH.",2,1,3,0,0,0,
23/08/2016,MEX.,"EL ORO, MEX.",1,1,2,0,0,0,
23/08/2016,SON.,"GUAYMAS, SON.",1,0,1,0,0,0,
23/08/2016,N.L.,"CADEREYTA JIMENEZ, N.L.",1,0,1,0,0,0,
24/08/2016,D.F.,"MIGUEL HGO., D.F.",11,20,31,0,0,407,
24/08/2016,MEX.,"CUAUTITLAN IZCALLI, MEX.",5,2,7,3,1,189,
24/08/2016,MEX.,"CHIMALHUACAN, MEX.",3,4,7,0,0,137,
24/08/2016,SON.,"CAJEME, SON.",2,3,5,0,0,73,
24/08/2016,MEX.,"CUAUTITLAN, MEX.",2,2,4,0,0,1,
24/08/2016,SIN.,"BADIRAGUATO, SIN.",1,1,2,0,0,20,
24/08/2016,MEX.,"EL ORO, MEX.",1,1,2,1,0,82,
24/08/2016,SON.,"HERMOSILLO, SON.",1,0,1,11,0,0,
24/08/2016,N.L.,"SAN NICOLAS DE LOS GARZA, N.L.",0,1,1,0,0,151,
24/08/2016,COAH.,"TORREÓN, COAH.",0,0,0,0,0,2,
25/08/2016,D.F.,"MIGUEL HGO., D.F.",14,11,25,0,2,100,
25/08/2016,B.C.,"TIJUANA, B.C.",2,2,4,0,0,0,
25/08/2016,MEX.,"EL ORO, MEX.",1,2,3,0,0,4,
25/08/2016,SON.,"HERMOSILLO, SON.",1,2,3,1,0,0,
25/08/2016,SON.,"CAJEME, SON.",0,3,3,0,0,0,
25/08/2016,MEX.,"CUAUTITLAN, MEX.",3,0,3,1,0,59,
25/08/2016,SIN.,"BADIRAGUATO, SIN.",1,0,1,0,0,0,
25/08/2016,B.C.,"MEXICALI, B.C.",0,1,1,0,0,0,
26/08/2016,MEX.,"CUAUTITLAN, MEX.",8,2,10,8,0,65,
26/08/2016,MEX.,"CHIMALHUACAN, MEX.",8,2,10,0,0,152,
26/08/2016,OAX.,"MIAHUATLAN DE PORFIRIO DIAZ, OAX.",0,2,2,18,0,0,
26/08/2016,SON.,"CAJEME, SON.",1,0,1,0,0,0,
26/08/2016,B.C.,"TIJUANA, B.C.",1,0,1,2,0,0,
26/08/2016,B.C.,"ENSENADA, B.C.",1,0,1,0,0,0,
26/08/2016,B.C.,"TIJUANA, B.C.",0,1,1,0,0,0,
27/08/2016,D.F.,"MIGUEL HGO., D.F.",14,20,34,0,5,1071,
27/08/2016,MEX.,"CUAUTITLAN IZCALLI, MEX.",7,1,8,2,0,292,
27/08/2016,MEX.,"CUAUTITLAN, MEX.",7,0,7,0,1,202,
27/08/2016,SON.,"CAJEME, SON.",5,1,6,1,0,0,
27/08/2016,MEX.,"CHIMALHUACAN, MEX.",5,1,6,0,2,0,
27/08/2016,MEX.,"EL ORO, MEX.",3,0,3,1,0,119,
27/08/2016,TAMPS.,"MATAMOROS, TAMPS.",2,1,3,2,0,50,
27/08/2016,OAX.,"CIUDAD IXTEPEC, OAX.",2,0,2,0,0,0,
27/08/2016,CHIH.,"HGO. DEL PARRAL, CHIH.",1,0,1,0,0,0,
27/08/2016,TLAX.,"PANOTLA, TLAX.",1,0,1,0,0,0,
27/08/2016,B.C.,"ENSENADA, B.C.",0,0,0,0,1,0,
27/08/2016,SON.,"HERMOSILLO, SON.",0,0,0,30,0,0,
28/08/2016,B.C.,"ENSENADA, B.C.",1,1,2,0,0,0,
28/08/2016,TAMPS.,"MATAMOROS, TAMPS.",1,0,1,0,0,0,
29/08/2016,D.F.,"GUSTAVO A. MADERO, D.F.",26,28,54,0,8,562,
29/08/2016,CHIS.,"CHAMULA, CHIS.",4,4,8,0,0,0,
29/08/2016,MEX.,"SAN MATEO ATENCO, MEX.",6,1,7,1,0,0,
29/08/2016,OAX.,"MIAHUATLAN DE PORFIRIO DIAZ, OAX.",2,4,6,5,0,0,
29/08/2016,GRO.,"IGUALA DE LA INDEPENDENCIA, GRO.",1,2,3,0,0,0,
29/08/2016,SIN.,"MOCORITO, SIN.",2,0,2,0,0,0,
29/08/2016,MEX.,"OTZOLOTEPEC, MEX.",1,1,2,0,0,0,
29/08/2016,CHIS.,"SAN CRISTOBAL DE LAS CASAS, CHIS.",1,1,2,0,0,0,
29/08/2016,COAH.,"SALTILLO, COAH.",1,0,1,0,0,0,
29/08/2016,COAH.,"MONCLOVA, COAH.",1,0,1,0,0,30,
29/08/2016,COAH.,"TORREÓN, COAH.",1,0,1,0,1,0,
29/08/2016,COAH.,"SAN PEDRO, COAH.",1,0,1,0,0,0,
29/08/2016,COAH.,"ACUÑA, COAH.",1,0,1,0,0,0,
29/08/2016,TAB.,"CARDENAS, TAB.",1,0,1,0,0,0,
29/08/2016,COAH.,"PIEDRAS NEGRAS, COAH.",0,0,0,35,0,0,
30/08/2016,D.F.,"AZCAPOTZALCO, D.F.",13,15,28,0,2,192,
30/08/2016,CHIS.,"TUXTLA GUTIÉRREZ, CHIS.",1,11,12,0,0,0,
30/08/2016,SIN.,"MOCORITO, SIN.",4,3,7,0,0,0,
30/08/2016,MEX.,"TULTEPEC, MEX.",4,0,4,2,0,0,
30/08/2016,COAH.,"TORREÓN, COAH.",1,3,4,0,0,0,
30/08/2016,SON.,"CAJEME, SON.",3,0,3,0,0,0,
30/08/2016,MEX.,"TULTEPEC, MEX.",3,0,3,0,0,0,
30/08/2016,B.C.,"TIJUANA, B.C.",0,2,2,0,0,0,
30/08/2016,B.C.,"TIJUANA, B.C.",0,2,2,0,0,0,
30/08/2016,B.C.,"TIJUANA, B.C.",0,2,2,0,0,0,
30/08/2016,MEX.,"CHICONCUAC, MEX.",2,0,2,0,0,38,
30/08/2016,SON.,"HERMOSILLO, SON.",1,0,1,25,0,0,
30/08/2016,COL.,"COL., COL.",1,0,1,0,0,335,
30/08/2016,OAX.,"OAX. DE JUAREZ, OAX.",0,1,1,0,0,0,
30/08/2016,SON.,"GUAYMAS, SON.",1,0,1,24,0,0,
30/08/2016,CHIS.,"TUXTLA GUTIÉRREZ, CHIS.",1,0,1,0,0,0,
30/08/2016,TAB.,"COMALCALCO, TAB.",1,0,1,1,0,2,
30/08/2016,COAH.,"SAN PEDRO, COAH.",0,1,1,0,0,0,
30/08/2016,COAH.,"SALTILLO, COAH.",0,1,1,0,0,0,
30/08/2016,B.C.,"ENSENADA, B.C.",1,0,1,0,0,0,
30/08/2016,TAMPS.,"NUEVO LAREDO, TAMPS.",1,0,1,0,0,0,
30/08/2016,MEX.,"CHICONCUAC, MEX.",0,0,0,0,6,0,
30/08/2016,N.L.,"SAN NICOLAS DE LOS GARZA, N.L.",0,0,0,0,7,0,
31/08/2016,D.F.,"AZCAPOTZALCO, D.F.",18,14,32,0,1,0,
31/08/2016,CHIS.,"CHAMULA, CHIS.",2,12,14,0,0,0,
31/08/2016,B.C.,"TIJUANA, B.C.",2,6,8,0,0,0,
31/08/2016,SIN.,"MOCORITO, SIN.",4,3,7,0,4,0,
31/08/2016,MEX.,"TULTEPEC, MEX.",5,0,5,3,0,3,
31/08/2016,CHIS.,"SAN CRISTOBAL DE LAS CASAS, CHIS.",3,1,4,0,0,0,
31/08/2016,MEX.,"OTZOLOTEPEC, MEX.",3,1,4,0,0,12,
31/08/2016,MEX.,"CHICONCUAC, MEX.",2,2,4,0,0,22,
31/08/2016,CHIS.,"PUEBLO NUEVO SOLISTAHUACÁN, CHIS.",1,2,3,0,0,20,
31/08/2016,GRO.,"IGUALA DE LA INDEPENDENCIA, GRO.",2,1,3,0,0,0,
31/08/2016,OAX.,"OAX. DE JUAREZ, OAX.",2,0,2,0,0,0,
31/08/2016,OAX.,"SAN JUAN BAUTISTA TUXTEPEC, OAX.",1,1,2,0,0,0,
31/08/2016,N.L.,"SAN PEDRO GARZA GARCIA, N.L.",0,2,2,0,0,0,
31/08/2016,OAX.,"CIUDAD IXTEPEC, OAX.",1,1,2,0,0,0,
31/08/2016,MEX.,"SAN MATEO ATENCO, MEX.",2,0,2,0,0,72,
31/08/2016,SON.,"HERMOSILLO, SON.",1,1,2,16,0,0,
31/08/2016,SON.,"CAJEME, SON.",0,2,2,0,0,0,
31/08/2016,COAH.,"FRANCISCO I. MADERO, COAH.",2,0,2,0,0,0,
31/08/2016,COAH.,"SABINAS, COAH.",1,1,2,3,0,50,
31/08/2016,COAH.,"TORREÓN, COAH.",1,0,1,0,0,0,
31/08/2016,COAH.,"SAN PEDRO, COAH.",0,1,1,0,0,0,
31/08/2016,COAH.,"SALTILLO, COAH.",1,0,1,0,0,0,
31/08/2016,COAH.,"MÚZQUIZ, COAH.",0,1,1,0,0,0,
31/08/2016,CHIH.,"HGO. DEL PARRAL, CHIH.",1,0,1,22,0,0,
01/09/2016,CHIS.,"CHAMULA, CHIS.",7,37,44,0,0,0,
01/09/2016,D.F.,"AZCAPOTZALCO, D.F.",13,13,26,0,0,85,
01/09/2016,CHIS.,"PUEBLO NUEVO SOLISTAHUACÁN, CHIS.",6,5,11,0,0,234,
01/09/2016,CHIS.,"SAN CRISTOBAL DE LAS CASAS, CHIS.",2,7,9,0,0,0,
01/09/2016,N.L.,"SAN NICOLAS DE LOS GARZA, N.L.",6,2,8,55,0,400,
01/09/2016,MEX.,"TULTEPEC, MEX.",1,4,5,0,0,67,
01/09/2016,B.C.,"TIJUANA, B.C.",2,2,4,0,0,0,
01/09/2016,COAH.,"SALTILLO, COAH.",3,1,4,0,0,0,
01/09/2016,CHIH.,"HGO. DEL PARRAL, CHIH.",3,0,3,0,0,0,
01/09/2016,COAH.,"PIEDRAS NEGRAS, COAH.",2,1,3,0,0,200,
01/09/2016,SON.,"CAJEME, SON.",1,1,2,0,0,0,
01/09/2016,MEX.,"SAN MATEO ATENCO, MEX.",2,0,2,0,0,28,
01/09/2016,COAH.,"MONCLOVA, COAH.",1,1,2,0,0,0,
01/09/2016,MEX.,"CHICONCUAC, MEX.",2,0,2,0,0,0,
01/09/2016,MEX.,"OTZOLOTEPEC, MEX.",0,1,1,0,0,0,
01/09/2016,OAX.,"SAN JUAN BAUTISTA TUXTEPEC, OAX.",1,0,1,0,0,0,
01/09/2016,COAH.,"SAN PEDRO, COAH.",1,0,1,1,0,0,
01/09/2016,SON.,"HERMOSILLO, SON.",0,0,0,7,0,720,
02/09/2016,CHIS.,"CHAMULA, CHIS.",3,110,113,0,0,0,
02/09/2016,D.F.,"AZCAPOTZALCO, D.F.",16,8,24,0,2,0,
02/09/2016,SIN.,"MOCORITO, SIN.",7,7,14,0,0,0,
02/09/2016,CHIS.,"SAN CRISTOBAL DE LAS CASAS, CHIS.",3,8,11,1,1,0,
02/09/2016,MEX.,"TULTEPEC, MEX.",6,0,6,2,0,31,
02/09/2016,CHIS.,"PUEBLO NUEVO SOLISTAHUACÁN, CHIS.",1,3,4,0,0,232,
02/09/2016,GRO.,"IGUALA DE LA INDEPENDENCIA, GRO.",4,0,4,0,0,6,
02/09/2016,SON.,"HERMOSILLO, SON.",2,1,3,0,1,20,
02/09/2016,SON.,"CAJEME, SON.",1,1,2,0,0,0,
02/09/2016,COAH.,"ACUÑA, COAH.",0,1,1,0,0,0,
02/09/2016,N.L.,"SAN PEDRO GARZA GARCIA, N.L.",1,0,1,0,0,400,
02/09/2016,OAX.,"SAN JUAN BAUTISTA TUXTEPEC, OAX.",0,1,1,0,0,0,
02/09/2016,MEX.,"CHICONCUAC, MEX.",1,0,1,0,0,216,
02/09/2016,COAH.,"SALTILLO, COAH.",0,0,0,1,0,20,
02/09/2016,COAH.,"MONCLOVA, COAH.",0,0,0,0,0,105,
03/09/2016,GRO.,"IGUALA DE LA INDEPENDENCIA, GRO.",0,1,1,0,0,0,
03/09/2016,MEX.,"OTZOLOTEPEC, MEX.",0,1,1,0,0,3,
03/09/2016,MEX.,"SAN MATEO ATENCO, MEX.",0,1,1,0,0,3,
03/09/2016,OAX.,"OAX. DE JUAREZ, OAX.",1,0,1,0,0,0,
04/09/2016,B.C.,"ENSENADA, B.C.",1,6,7,0,0,0,
04/09/2016,MEX.,"TULTEPEC, MEX.",6,1,7,5,0,4,
04/09/2016,B.C.,"TIJUANA, B.C.",2,0,2,0,0,0,
04/09/2016,N.L.,"SAN PEDRO GARZA GARCIA, N.L.",1,0,1,0,0,0,
04/09/2016,N.L.,"SANTA CATARINA, N.L.",1,0,1,1,0,1944,
04/09/2016,SON.,"HERMOSILLO, SON.",1,0,1,34,0,0,
04/09/2016,SON.,"CAJEME, SON.",1,0,1,0,0,0,
04/09/2016,COAH.,"MATAMOROS, COAH.",1,0,1,0,0,0,
04/09/2016,CHIH.,"HGO. DEL PARRAL, CHIH.",0,1,1,0,0,0,
04/09/2016,MEX.,"CHICONCUAC, MEX.",0,1,1,0,0,0,
04/09/2016,B.C.,"ENSENADA, B.C.",1,0,1,0,1,0,
05/09/2016,CHIS.,"CHAMULA, CHIS.",3,136,139,0,0,0,
05/09/2016,CHIS.,"SAN CRISTOBAL DE LAS CASAS, CHIS.",5,32,37,2,0,0,
05/09/2016,D.F.,"AZCAPOTZALCO, D.F.",13,6,19,0,3,80,
05/09/2016,MEX.,"COACALCO DE BERRIOZABAL, MEX.",4,0,4,1,0,273,
05/09/2016,MEX.,"SAN MARTIN DE LAS PIRAMIDES, MEX.",2,1,3,0,0,2,
05/09/2016,MEX.,"VILLA VICTORIA, MEX.",1,1,2,0,0,0,
05/09/2016,GRO.,"IGUALA DE LA INDEPENDENCIA, GRO.",2,0,2,0,0,0,
05/09/2016,N.L.,"SAN PEDRO GARZA GARCIA, N.L.",1,1,2,14,0,67,
05/09/2016,OAX.,"OAX. DE JUAREZ, OAX.",1,0,1,0,0,0,
05/09/2016,OAX.,"SANTO DOMINGO TEPUXTEPEC, OAX.",1,0,1,0,0,0,
05/09/2016,MEX.,"VILLA GRO., MEX.",1,0,1,0,0,0,
05/09/2016,COAH.,"SALTILLO, COAH.",1,0,1,7,0,0,
06/09/2016,CHIS.,"CHAMULA, CHIS.",2,49,51,0,0,0,
06/09/2016,CHIS.,"SAN CRISTOBAL DE LAS CASAS, CHIS.",3,47,50,0,0,0,
06/09/2016,D.F.,"AZCAPOTZALCO, D.F.",11,17,28,0,0,1847,
06/09/2016,CHIS.,"PUEBLO NUEVO SOLISTAHUACÁN, CHIS.",3,1,4,0,0,119,
06/09/2016,COAH.,"PIEDRAS NEGRAS, COAH.",1,1,2,35,0,200,
06/09/2016,MEX.,"VILLA GRO., MEX.",2,0,2,0,0,0,
06/09/2016,MEX.,"VILLA VICTORIA, MEX.",1,1,2,0,0,0,
06/09/2016,SON.,"HERMOSILLO, SON.",1,0,1,73,0,933,
06/09/2016,SON.,"CAJEME, SON.",1,0,1,0,0,0,
06/09/2016,COAH.,"TORREÓN, COAH.",1,0,1,0,0,0,
06/09/2016,N.L.,"SAN PEDRO GARZA GARCIA, N.L.",1,0,1,0,0,0,
07/09/2016,D.F.,"AZCAPOTZALCO, D.F.",16,7,23,0,0,100,
07/09/2016,MEX.,"COACALCO DE BERRIOZABAL, MEX.",3,4,7,1,0,16,
07/09/2016,MEX.,"COACALCO DE BERRIOZABAL, MEX.",6,0,6,1,0,6,
07/09/2016,MEX.,"SAN MARTIN DE LAS PIRAMIDES, MEX.",0,4,4,0,0,45,
07/09/2016,COAH.,"SALTILLO, COAH.",0,2,2,0,0,0,
07/09/2016,B.C.,"TIJUANA, B.C.",1,1,2,0,0,0,
07/09/2016,MEX.,"VILLA VICTORIA, MEX.",1,1,2,0,0,0,
07/09/2016,MEX.,"SAN MARTIN DE LAS PIRAMIDES, MEX.",2,0,2,0,7,0,
07/09/2016,COAH.,"MÚZQUIZ, COAH.",0,1,1,0,0,0,
07/09/2016,OAX.,"CIUDAD IXTEPEC, OAX.",1,0,1,0,0,0,
08/09/2016,CHIS.,"CHAMULA, CHIS.",7,113,120,0,0,0,
08/09/2016,CHIS.,"SAN CRISTOBAL DE LAS CASAS, CHIS.",10,39,49,2,0,50,
08/09/2016,D.F.,"AZCAPOTZALCO, D.F.",15,7,22,0,5,541,
08/09/2016,MEX.,"COACALCO DE BERRIOZABAL, MEX.",3,1,4,0,0,13,
08/09/2016,CHIS.,"PUEBLO NUEVO SOLISTAHUACÁN, CHIS.",2,1,3,0,0,3,
08/09/2016,N.L.,"SAN PEDRO GARZA GARCIA, N.L.",3,0,3,6,0,2200,
08/09/2016,OAX.,"OAX. DE JUAREZ, OAX.",1,1,2,0,0,0,
08/09/2016,COAH.,"SALTILLO, COAH.",2,0,2,0,0,90,
08/09/2016,B.C.,"TIJUANA, B.C.",2,0,2,0,1,0,
08/09/2016,MEX.,"SAN MARTIN DE LAS PIRAMIDES, MEX.",1,1,2,0,0,0,
08/09/2016,MEX.,"VILLA VICTORIA, MEX.",1,1,2,0,0,0,
08/09/2016,OAX.,"SAN JUAN BAUTISTA TUXTEPEC, OAX.",1,0,1,1,0,49,
08/09/2016,MEX.,"VILLA GRO., MEX.",0,1,1,0,0,0,
09/09/2016,MEX.,"VILLA VICTORIA, MEX.",5,2,7,0,0,0,
09/09/2016,MEX.,"SAN MARTIN DE LAS PIRAMIDES, MEX.",3,2,5,0,4,0,
09/09/2016,MEX.,"COACALCO DE BERRIOZABAL, MEX.",4,0,4,1,1,10,
09/09/2016,COAH.,"SALTILLO, COAH.",1,1,2,0,0,100,
09/09/2016,COAH.,"SABINAS, COAH.",1,1,2,2,0,0,
09/09/2016,MEX.,"VILLA GRO., MEX.",1,0,1,0,0,0,
09/09/2016,SON.,"HERMOSILLO, SON.",1,0,1,59,0,219,
09/09/2016,N.L.,"SANTA CATARINA, N.L.",1,0,1,0,0,50,
09/09/2016,OAX.,"SAN JUAN BAUTISTA TUXTEPEC, OAX.",1,0,1,0,0,0,
09/09/2016,N.L.,"SAN PEDRO GARZA GARCIA, N.L.",0,0,0,16,0,0,
10/09/2016,MEX.,"VILLA VICTORIA, MEX.",6,1,7,2,0,3,
10/09/2016,MEX.,"VILLA GRO., MEX.",3,0,3,0,0,0,
10/09/2016,B.C.,"TIJUANA, B.C.",2,0,2,0,0,0,
10/09/2016,B.C.,"ENSENADA, B.C.",0,2,2,0,0,0,
10/09/2016,SON.,"HERMOSILLO, SON.",1,0,1,0,0,40,
10/09/2016,TAMPS.,"MATAMOROS, TAMPS.",1,0,1,2,0,109,
10/09/2016,GRO.,"TEPECOACUILCO DE TRUJANO, GRO.",1,0,1,0,0,0,
11/09/2016,MEX.,"COACALCO DE BERRIOZABAL, MEX.",4,3,7,1,0,270,
12/09/2016,SON.,"CAJEME, SON.",6,2,8,21,0,0,
12/09/2016,OAX.,"CIUDAD IXTEPEC, OAX.",0,1,1,0,0,0,
12/09/2016,OAX.,"SAN JUAN BAUTISTA TUXTEPEC, OAX.",0,1,1,0,0,0,
12/09/2016,CHIH.,"HGO. DEL PARRAL, CHIH.",1,0,1,0,0,277,
12/09/2016,B.C.,"TIJUANA, B.C.",0,1,1,0,0,0,
12/09/2016,CHIS.,"BENEMÉRITO DE LAS AMÉRICAS, CHIS.",0,0,0,2,0,30,
13/09/2016,SON.,"CAJEME, SON.",1,3,4,0,0,0,
13/09/2016,SON.,"HERMOSILLO, SON.",0,1,1,1,0,800,
14/09/2016,B.C.,"TIJUANA, B.C.",0,1,1,0,0,0,
14/09/2016,B.C.,"MEXICALI, B.C.",0,1,1,0,0,0,
14/09/2016,OAX.,"SAN JUAN BAUTISTA TUXTEPEC, OAX.",1,0,1,1,0,0,
14/09/2016,B.C.,"TIJUANA, B.C.",0,1,1,0,0,0,
15/09/2016,OAX.,"OAX. DE JUAREZ, OAX.",1,1,2,1,0,0,
15/09/2016,B.C.,"MEXICALI, B.C.",0,1,1,0,0,0,
15/09/2016,OAX.,"SAN JUAN BAUTISTA TUXTEPEC, OAX.",0,1,1,1,0,0,
15/09/2016,PUE.,"PUE., PUE.",1,0,1,0,0,0,
15/09/2016,SON.,"HERMOSILLO, SON.",1,0,1,0,0,0,
15/09/2016,CHIH.,"HGO. DEL PARRAL, CHIH.",0,0,0,0,0,90,
15/09/2016,PUE.,"PUE., PUE.",0,0,0,1,0,4,
17/09/2016,SON.,"HERMOSILLO, SON.",2,0,2,1,0,0,
19/09/2016,SIN.,"SIN., SIN.",14,2,16,0,7,0,
19/09/2016,MEX.,"TULTITLAN, MEX.",2,4,6,2,0,6,
19/09/2016,MEX.,"CHALCO, MEX.",6,0,6,3,4,13,
19/09/2016,COAH.,"TORREÓN, COAH.",4,1,5,0,0,40,
19/09/2016,COAH.,"MÚZQUIZ, COAH.",4,1,5,0,0,0,
19/09/2016,SON.,"HERMOSILLO, SON.",3,0,3,18,0,75,
19/09/2016,COAH.,"PIEDRAS NEGRAS, COAH.",1,1,2,0,0,0,
19/09/2016,SIN.,"CONCORDIA, SIN.",0,1,1,0,3,0,
19/09/2016,COAH.,"ACUÑA, COAH.",0,1,1,0,0,7,
19/09/2016,SON.,"CAJEME, SON.",1,0,1,0,0,0,
20/09/2016,SIN.,"SIN., SIN.",15,4,19,0,5,0,
20/09/2016,MEX.,"TULTITLAN, MEX.",2,4,6,2,0,6,
20/09/2016,MEX.,"ATLACOMULCO, MEX.",3,2,5,0,3,170,
20/09/2016,COAH.,"PIEDRAS NEGRAS, COAH.",1,3,4,2,0,0,
20/09/2016,MEX.,"CHALCO, MEX.",3,1,4,0,2,0,
20/09/2016,COAH.,"SALTILLO, COAH.",3,0,3,0,1,21,
20/09/2016,SIN.,"CONCORDIA, SIN.",3,0,3,0,2,0,
20/09/2016,B.C.,"MEXICALI, B.C.",0,2,2,0,0,0,
20/09/2016,OAX.,"OAX. DE JUAREZ, OAX.",1,0,1,0,0,0,
20/09/2016,OAX.,"SAN JUAN BAUTISTA TUXTEPEC, OAX.",0,1,1,0,0,0,
20/09/2016,GRO.,"PUNGARABATO, GRO.",1,0,1,0,0,0,
20/09/2016,COAH.,"MATAMOROS, COAH.",1,0,1,0,0,139,
20/09/2016,MEX.,"VILLA DEL CARBON, MEX.",0,1,1,0,0,0,
20/09/2016,SON.,"HERMOSILLO, SON.",0,0,0,29,0,0,
21/09/2016,D.F.,"CUAUHTEMOC, D.F.",45,18,63,0,8,977,
21/09/2016,SON.,"CAJEME, SON.",3,1,4,0,0,0,
21/09/2016,MEX.,"ATLACOMULCO, MEX.",3,1,4,0,1,0,
21/09/2016,SON.,"HERMOSILLO, SON.",0,2,2,5,0,0,
21/09/2016,MEX.,"VILLA DEL CARBON, MEX.",1,1,2,0,0,0,
21/09/2016,SON.,"GUAYMAS, SON.",1,0,1,1,0,5,
21/09/2016,B.C.,"TIJUANA, B.C.",1,0,1,0,0,0,
21/09/2016,PUE.,"PUE., PUE.",1,0,1,12,0,101,
22/09/2016,SIN.,"SIN., SIN.",13,1,14,0,10,0,
22/09/2016,MEX.,"CHALCO, MEX.",3,4,7,0,2,0,
22/09/2016,MEX.,"ATLACOMULCO, MEX.",2,3,5,0,0,0,
22/09/2016,SON.,"CAJEME, SON.",2,0,2,1,0,0,
22/09/2016,MEX.,"VILLA DEL CARBON, MEX.",1,1,2,0,0,0,
22/09/2016,SON.,"HERMOSILLO, SON.",1,0,1,36,0,65,
22/09/2016,MEX.,"TULTITLAN, MEX.",1,0,1,0,0,0,
22/09/2016,SIN.,"CONCORDIA, SIN.",0,1,1,0,0,0,
22/09/2016,GRO.,"PUNGARABATO, GRO.",1,0,1,0,0,0,
23/09/2016,SIN.,"SIN., SIN.",10,2,12,0,2,0,
23/09/2016,MEX.,"ATLACOMULCO, MEX.",3,2,5,0,0,0,
23/09/2016,MEX.,"CHALCO, MEX.",3,1,4,0,0,0,
23/09/2016,MEX.,"TULTITLAN, MEX.",2,1,3,0,0,9,
23/09/2016,SIN.,"CONCORDIA, SIN.",1,2,3,0,8,0,
23/09/2016,SON.,"HERMOSILLO, SON.",1,1,2,21,0,0,
23/09/2016,MEX.,"VILLA DEL CARBON, MEX.",1,1,2,0,0,0,
23/09/2016,B.C.,"TIJUANA, B.C.",2,0,2,0,0,0,
23/09/2016,COAH.,"SALTILLO, COAH.",1,1,2,15,0,100,
23/09/2016,VER.,"TANTOYUCA, VER.",1,0,1,0,0,0,
23/09/2016,N.L.,"SABINAS HGO., N.L.",0,0,0,24,0,0,
24/09/2016,SON.,"CAJEME, SON.",3,0,3,0,0,0,
24/09/2016,VER.,"TANTOYUCA, VER.",2,0,2,0,0,0,
24/09/2016,COAH.,"JIMÉNEZ, COAH.",0,1,1,0,0,0,
24/09/2016,SON.,"HERMOSILLO, SON.",0,0,0,0,0,873,
26/09/2016,D.F.,"ALVARO OBREGON, D.F.",12,12,24,0,11,100,
26/09/2016,SIN.,"SIN., SIN.",13,0,13,0,6,0,
26/09/2016,CHIS.,"VILLAFLORES, CHIS.",4,3,7,0,0,0,
26/09/2016,COAH.,"TORREÓN, COAH.",1,2,3,0,0,0,
26/09/2016,MEX.,"TEMASCALTEPEC, MEX.",1,1,2,0,0,15,
26/09/2016,MEX.,"TEMASCALCINGO, MEX.",2,0,2,0,0,0,
26/09/2016,COAH.,"FRANCISCO I. MADERO, COAH.",0,1,1,0,0,0,
26/09/2016,COAH.,"SAN PEDRO, COAH.",0,1,1,0,0,0,
26/09/2016,COAH.,"MONCLOVA, COAH.",1,0,1,0,0,0,
26/09/2016,COAH.,"SALTILLO, COAH.",0,1,1,0,0,0,
26/09/2016,SON.,"HERMOSILLO, SON.",0,0,0,8,0,0,
27/09/2016,CHIH.,"HGO. DEL PARRAL, CHIH.",34,6,40,0,0,132,
27/09/2016,D.F.,"ALVARO OBREGON, D.F.",20,7,27,0,0,148,
27/09/2016,SIN.,"SIN., SIN.",13,2,15,0,3,0,
27/09/2016,MEX.,"TEZOYUCA, MEX.",5,1,6,0,0,25,
27/09/2016,SIN.,"CONCORDIA, SIN.",0,3,3,0,0,0,
27/09/2016,CHIS.,"VILLAFLORES, CHIS.",2,1,3,0,0,195,
27/09/2016,COAH.,"TORREÓN, COAH.",2,0,2,0,0,0,
27/09/2016,SON.,"HERMOSILLO, SON.",0,1,1,0,0,0,
27/09/2016,MEX.,"TLALMANALCO, MEX.",0,1,1,0,1,0,
27/09/2016,MEX.,"TEMASCALCINGO, MEX.",1,0,1,0,0,0,
27/09/2016,COAH.,"SAN PEDRO, COAH.",1,0,1,0,0,0,
27/09/2016,COAH.,"MATAMOROS, COAH.",1,0,1,1,0,0,
27/09/2016,COAH.,"ACUÑA, COAH.",0,1,1,0,0,0,
27/09/2016,COAH.,"PIEDRAS NEGRAS, COAH.",1,0,1,0,0,0,
27/09/2016,VER.,"POZA RICA DE HGO., VER.",1,0,1,0,0,0,
27/09/2016,SON.,"CAJEME, SON.",0,0,0,2,0,0,
28/09/2016,D.F.,"ALVARO OBREGON, D.F.",13,11,24,0,8,372,
28/09/2016,MEX.,"TEZOYUCA, MEX.",3,1,4,0,0,0,
28/09/2016,MEX.,"TLALMANALCO, MEX.",1,1,2,0,0,0,
28/09/2016,CHIS.,"VILLAFLORES, CHIS.",1,1,2,0,0,319,
28/09/2016,N.L.,"VALLECILLO, N.L.",2,0,2,0,0,0,
28/09/2016,COAH.,"MONCLOVA, COAH.",1,0,1,0,0,42,
28/09/2016,PUE.,"PUE., PUE.",1,0,1,0,0,0,
28/09/2016,SON.,"HERMOSILLO, SON.",0,0,0,4,0,300,
29/09/2016,SIN.,"SIN., SIN.",22,7,29,0,8,0,
29/09/2016,CHIS.,"VILLAFLORES, CHIS.",5,3,8,1,0,657,
29/09/2016,OAX.,"OAX. DE JUAREZ, OAX.",3,0,3,0,0,391,
29/09/2016,MEX.,"TEMASCALCINGO, MEX.",1,1,2,0,0,0,
29/09/2016,TAB.,"CENTRO, TAB.",0,2,2,0,0,0,
29/09/2016,MEX.,"TEZOYUCA, MEX.",1,1,2,0,0,0,
29/09/2016,MEX.,"TLALMANALCO, MEX.",2,0,2,0,1,0,
29/09/2016,MOR.,"XOCHITEPEC, MOR.",1,0,1,2,2,106,
29/09/2016,SIN.,"CONCORDIA, SIN.",1,0,1,0,4,0,
30/09/2016,D.F.,"ALVARO OBREGON, D.F.",17,7,24,0,4,0,
30/09/2016,SIN.,"SIN., SIN.",9,2,11,0,4,0,
30/09/2016,SON.,"CAJEME, SON.",2,4,6,3,0,0,
30/09/2016,CHIS.,"VILLAFLORES, CHIS.",3,3,6,0,0,1166,
30/09/2016,MOR.,"XOCHITEPEC, MOR.",4,1,5,0,5,1197,
30/09/2016,SIN.,"CONCORDIA, SIN.",4,1,5,0,4,0,
30/09/2016,COAH.,"SAN PEDRO, COAH.",1,0,1,0,0,0,
30/09/2016,COAH.,"MATAMOROS, COAH.",0,1,1,0,0,0,
30/09/2016,COAH.,"MONCLOVA, COAH.",0,1,1,0,0,683,
01/10/2016,SIN.,"GUASAVE, SIN.",10,5,15,0,4,0,
01/10/2016,SON.,"GUAYMAS, SON.",5,5,10,11,0,304,
01/10/2016,B.C.,"MEXICALI, B.C.",4,3,7,0,0,0,
01/10/2016,MEX.,"MELCHOR OCAMPO, MEX.",5,1,6,1,0,49,
01/10/2016,MEX.,"TEZOYUCA, MEX.",3,1,4,0,0,0,
01/10/2016,B.C.,"TIJUANA, B.C.",1,2,3,0,0,0,
01/10/2016,SON.,"HERMOSILLO, SON.",3,0,3,0,0,31,
01/10/2016,MEX.,"TLALMANALCO, MEX.",1,1,2,0,0,9,
01/10/2016,MEX.,"COCOTITLAN, MEX.",2,0,2,0,0,0,
01/10/2016,COAH.,"SABINAS, COAH.",1,0,1,0,0,0,
01/10/2016,COAH.,"MÚZQUIZ, COAH.",0,1,1,0,0,52,
01/10/2016,SON.,"GUAYMAS, SON.",0,1,1,0,0,0,
01/10/2016,MEX.,"CALIMAYA, MEX.",1,0,1,0,0,0,
01/10/2016,B.C.,"MEXICALI, B.C.",1,0,1,0,0,0,
01/10/2016,SON.,"HERMOSILLO, SON.",0,0,0,15,0,0,
01/10/2016,MOR.,"XOCHITEPEC, MOR.",0,0,0,0,0,394,
02/10/2016,B.C.,"MEXICALI, B.C.",4,3,7,0,0,0,
02/10/2016,B.C.,"TIJUANA, B.C.",1,2,3,0,0,0,
02/10/2016,MOR.,"XOCHITEPEC, MOR.",0,0,0,74,0,0,
03/10/2016,D.F.,"ALVARO OBREGON, D.F.",10,9,19,0,5,18,
03/10/2016,SIN.,"CHOIX, SIN.",10,0,10,0,3,0,
03/10/2016,MEX.,"TEPOTZOTLAN, MEX.",5,0,5,1,0,40,
03/10/2016,CHIS.,"VILLAFLORES, CHIS.",1,2,3,0,0,806,
03/10/2016,MEX.,"OCOYOACAC, MEX.",3,0,3,0,0,0,
03/10/2016,SIN.,"ROSARIO, SIN.",0,2,2,0,0,0,
03/10/2016,MEX.,"NICOLAS ROMERO, MEX.",1,1,2,0,8,0,
03/10/2016,MEX.,"TEOLOYUCAN, MEX.",1,1,2,1,0,0,
03/10/2016,SON.,"HERMOSILLO, SON.",1,0,1,0,0,240,
03/10/2016,VER.,"MARTINEZ DE LA TORRE, VER.",1,0,1,0,0,0,
04/10/2016,D.F.,"ALVARO OBREGON, D.F.",17,10,27,0,0,242,
04/10/2016,SIN.,"CHOIX, SIN.",7,5,12,0,4,0,
04/10/2016,SIN.,"SALVADOR ALVARADO, SIN.",2,2,4,0,1,0,
04/10/2016,SON.,"CAJEME, SON.",3,0,3,0,0,0,
04/10/2016,COAH.,"TORREÓN, COAH.",1,1,2,0,0,0,
04/10/2016,COAH.,"MONCLOVA, COAH.",2,0,2,0,0,4,
04/10/2016,COAH.,"SABINAS, COAH.",2,0,2,0,0,0,
04/10/2016,MEX.,"TEOLOYUCAN, MEX.",2,0,2,1,0,0,
04/10/2016,MEX.,"OCOYOACAC, MEX.",2,0,2,0,0,0,
04/10/2016,B.C.,"TIJUANA, B.C.",0,1,1,0,0,0,
04/10/2016,B.C.,"MEXICALI, B.C.",0,1,1,0,0,0,
04/10/2016,VER.,"MARTINEZ DE LA TORRE, VER.",1,0,1,1,0,0,
04/10/2016,MEX.,"TEPOTZOTLAN, MEX.",1,0,1,1,0,34,
04/10/2016,COAH.,"FRANCISCO I. MADERO, COAH.",1,0,1,0,0,0,
04/10/2016,SIN.,"ROSARIO, SIN.",0,0,0,0,7,0,
04/10/2016,MOR.,"XOCHITEPEC, MOR.",0,0,0,15,9,226,
05/10/2016,D.F.,"ALVARO OBREGON, D.F.",11,5,16,0,1,810,
05/10/2016,SIN.,"CHOIX, SIN.",7,4,11,0,8,0,
05/10/2016,MEX.,"TEPOTZOTLAN, MEX.",4,2,6,9,0,566,
05/10/2016,SON.,"CAJEME, SON.",3,2,5,4,0,0,
05/10/2016,MOR.,"XOCHITEPEC, MOR.",1,2,3,6,9,225,
05/10/2016,SON.,"HERMOSILLO, SON.",1,1,2,56,0,0,
05/10/2016,SIN.,"SALVADOR ALVARADO, SIN.",1,1,2,0,0,0,
05/10/2016,HGO.,"PACHUCA DE SOTO, HGO.",0,2,2,0,0,0,
05/10/2016,VER.,"MARTINEZ DE LA TORRE, VER.",0,1,1,0,0,0,
05/10/2016,COAH.,"MONCLOVA, COAH.",0,1,1,0,0,0,
05/10/2016,MEX.,"NICOLAS ROMERO, MEX.",1,0,1,1,0,0,
05/10/2016,COAH.,"MONCLOVA, COAH.",0,1,1,0,0,0,
06/10/2016,D.F.,"ALVARO OBREGON, D.F.",11,8,19,0,0,0,
06/10/2016,SIN.,"CHOIX, SIN.",12,2,14,0,4,0,
06/10/2016,MEX.,"OCOYOACAC, MEX.",4,0,4,1,0,0,
06/10/2016,MEX.,"TEOLOYUCAN, MEX.",2,1,3,0,0,0,
06/10/2016,COAH.,"SALTILLO, COAH.",2,0,2,8,0,184,
06/10/2016,SIN.,"SALVADOR ALVARADO, SIN.",1,1,2,0,0,9,
06/10/2016,MOR.,"XOCHITEPEC, MOR.",1,1,2,0,6,270,
06/10/2016,TAB.,"JONUTA, TAB.",2,0,2,1,0,0,
06/10/2016,MEX.,"NICOLAS ROMERO, MEX.",2,0,2,0,0,0,
06/10/2016,COAH.,"FRANCISCO I. MADERO, COAH.",1,0,1,0,0,0,
06/10/2016,COAH.,"SABINAS, COAH.",1,0,1,0,0,0,
06/10/2016,N.L.,"VALLECILLO, N.L.",1,0,1,0,0,0,
06/10/2016,PUE.,"PUE., PUE.",0,1,1,0,0,0,
06/10/2016,SON.,"CAJEME, SON.",1,0,1,0,0,0,
06/10/2016,MEX.,"TEPOTZOTLAN, MEX.",0,1,1,0,0,288,
06/10/2016,HGO.,"TEPEJI DEL RIO DE OCAMPO, HGO.",1,0,1,0,0,442,
06/10/2016,SIN.,"ROSARIO, SIN.",0,0,0,0,4,0,
06/10/2016,OAX.,"OAX. DE JUAREZ, OAX.",0,0,0,4,0,73,
06/10/2016,HGO.,"TULANCINGO DE BRAVO, HGO.",0,0,0,0,0,198,
07/10/2016,D.F.,"ALVARO OBREGON, D.F.",16,8,24,0,2,0,
07/10/2016,SIN.,"CHOIX, SIN.",7,0,7,0,0,0,
07/10/2016,MEX.,"OCOYOACAC, MEX.",1,3,4,0,0,0,
07/10/2016,SON.,"CAJEME, SON.",2,1,3,0,1,0,
07/10/2016,MOR.,"XOCHITEPEC, MOR.",1,2,3,0,2,390,
07/10/2016,SIN.,"ROSARIO, SIN.",2,0,2,0,7,0,
07/10/2016,SON.,"HERMOSILLO, SON.",1,0,1,1,0,100,
07/10/2016,MEX.,"NICOLAS ROMERO, MEX.",1,0,1,1,0,0,
07/10/2016,N.L.,"VALLECILLO, N.L.",1,0,1,0,0,0,
08/10/2016,MEX.,"TEPOTZOTLAN, MEX.",4,0,4,2,0,18,
08/10/2016,MEX.,"TEPOTZOTLAN, MEX.",2,1,3,0,0,1,
08/10/2016,B.C.,"MEXICALI, B.C.",0,3,3,0,0,0,
08/10/2016,SON.,"CAJEME, SON.",2,1,3,0,0,0,
08/10/2016,COAH.,"NAVA, COAH.",1,2,3,2,0,500,
08/10/2016,MOR.,"XOCHITEPEC, MOR.",1,2,3,0,2,390,
08/10/2016,MEX.,"TEOLOYUCAN, MEX.",1,1,2,0,0,0,
08/10/2016,MEX.,"TEOLOYUCAN, MEX.",1,0,1,0,0,0,
08/10/2016,SON.,"HERMOSILLO, SON.",0,0,0,45,0,0,
09/10/2016,B.C.,"MEXICALI, B.C.",2,1,3,0,0,0,
10/10/2016,D.F.,"CUAJIMALPA DE MOR., D.F.",12,5,17,0,0,0,
10/10/2016,MEX.,"ECATEPEC DE MOR., MEX.",16,0,16,0,1,1,
10/10/2016,MEX.,"IXTAPALUCA, MEX.",7,0,7,1,0,5,
10/10/2016,SIN.,"CHOIX, SIN.",2,3,5,0,2,0,
10/10/2016,COAH.,"ACUÑA, COAH.",2,2,4,0,0,0,
10/10/2016,CHIS.,"TAPACHULA, CHIS.",3,0,3,0,0,0,
10/10/2016,SIN.,"ROSARIO, SIN.",3,0,3,0,4,0,
10/10/2016,B.C.,"TIJUANA, B.C.",2,0,2,0,0,0,
10/10/2016,MEX.,"TEQUIXQUIAC, MEX.",2,0,2,0,0,0,
10/10/2016,B.C.,"MEXICALI, B.C.",0,1,1,0,0,0,
10/10/2016,SON.,"HERMOSILLO, SON.",1,0,1,0,0,0,
10/10/2016,COAH.,"TORREÓN, COAH.",1,0,1,0,0,0,
10/10/2016,HGO.,"PACHUCA DE SOTO, HGO.",1,0,1,0,0,0,
10/10/2016,TAB.,"CENTRO, TAB.",1,0,1,0,0,0,
10/10/2016,SIN.,"SALVADOR ALVARADO, SIN.",1,0,1,0,0,0,
10/10/2016,MOR.,"XOCHITEPEC, MOR.",0,1,1,0,4,0,
10/10/2016,COAH.,"SALTILLO, COAH.",0,0,0,0,0,398,
11/10/2016,D.F.,"CUAJIMALPA DE MOR., D.F.",10,11,21,0,2,618,
11/10/2016,COAH.,"TORREÓN, COAH.",5,1,6,6,0,0,
11/10/2016,SIN.,"CHOIX, SIN.",5,0,5,0,0,0,
11/10/2016,SIN.,"ROSARIO, SIN.",2,2,4,0,0,0,
11/10/2016,HGO.,"MOLANGO DE ESCAMILLA, HGO.",2,0,2,0,0,0,
11/10/2016,CHIS.,"TAPACHULA, CHIS.",0,2,2,0,0,50,
11/10/2016,PUE.,"PUE., PUE.",1,1,2,0,0,0,
11/10/2016,COAH.,"MONCLOVA, COAH.",1,0,1,1,0,7,
11/10/2016,MOR.,"XOCHITEPEC, MOR.",0,1,1,0,0,0,
11/10/2016,VER.,"CAMERINO Z. MENDOZA, VER.",1,0,1,0,0,19,
11/10/2016,HGO.,"TEPEJI DEL RIO DE OCAMPO, HGO.",0,0,0,0,2,270,
12/10/2016,MEX.,"ECATEPEC DE MOR., MEX.",6,2,8,2,0,706,
12/10/2016,SIN.,"SALVADOR ALVARADO, SIN.",2,4,6,0,0,0,
12/10/2016,MEX.,"IXTAPALUCA, MEX.",5,0,5,1,0,127,
12/10/2016,SON.,"HERMOSILLO, SON.",5,0,5,14,0,46,
12/10/2016,SIN.,"CHOIX, SIN.",1,2,3,0,4,0,
12/10/2016,B.C.,"TIJUANA, B.C.",1,1,2,0,0,0,
12/10/2016,COAH.,"ACUÑA, COAH.",1,1,2,3,0,0,
12/10/2016,HGO.,"TEPEJI DEL RIO DE OCAMPO, HGO.",1,1,2,0,0,0,
12/10/2016,B.C.,"MEXICALI, B.C.",1,1,2,0,0,0,
12/10/2016,CHIS.,"TAPACHULA, CHIS.",1,0,1,0,0,0,
12/10/2016,SIN.,"ROSARIO, SIN.",1,0,1,0,0,0,
12/10/2016,PUE.,"PUE., PUE.",0,0,0,1,0,50,
13/10/2016,D.F.,"CUAJIMALPA DE MOR., D.F.",13,11,24,0,1,168,
13/10/2016,MEX.,"IXTAPALUCA, MEX.",5,2,7,6,1,123,
13/10/2016,SIN.,"SALVADOR ALVARADO, SIN.",4,3,7,0,3,0,
13/10/2016,SIN.,"ROSARIO, SIN.",4,0,4,0,0,0,
13/10/2016,CHIS.,"TAPACHULA, CHIS.",2,0,2,0,0,14,
13/10/2016,MEX.,"ECATEPEC DE MOR., MEX.",2,0,2,0,1,0,
13/10/2016,MOR.,"XOCHITEPEC, MOR.",1,1,2,1,0,0,
13/10/2016,VER.,"CAMERINO Z. MENDOZA, VER.",0,1,1,0,0,0,
13/10/2016,MEX.,"TEQUIXQUIAC, MEX.",1,0,1,0,0,0,
13/10/2016,COAH.,"TORREÓN, COAH.",0,1,1,0,0,0,
13/10/2016,VER.,"POZA RICA DE HGO., VER.",1,0,1,0,0,0,
13/10/2016,MEX.,"TIANGUISTENCO, MEX.",1,0,1,15,0,0,
13/10/2016,SON.,"HERMOSILLO, SON.",0,0,0,1,0,370,
14/10/2016,D.F.,"CUAJIMALPA DE MOR., D.F.",19,5,24,0,0,576,
14/10/2016,MEX.,"TULTEPEC, MEX.",16,3,19,0,0,0,
14/10/2016,MEX.,"IXTAPALUCA, MEX.",5,3,8,3,0,1,
14/10/2016,SIN.,"SALVADOR ALVARADO, SIN.",5,1,6,0,1,0,
14/10/2016,CHIS.,"TAPACHULA, CHIS.",2,1,3,0,1,100,
14/10/2016,TAB.,"CENTRO, TAB.",2,0,2,0,0,0,
14/10/2016,N.L.,"MONTERREY, N.L.",1,0,1,0,0,0,
14/10/2016,VER.,"MARTINEZ DE LA TORRE, VER.",1,0,1,0,0,0,
14/10/2016,VER.,"CAMERINO Z. MENDOZA, VER.",1,0,1,0,0,0,
14/10/2016,OAX.,"OAX. DE JUAREZ, OAX.",1,0,1,1,0,0,
14/10/2016,SIN.,"ROSARIO, SIN.",1,0,1,0,0,0,
14/10/2016,HGO.,"TEPEJI DEL RIO DE OCAMPO, HGO.",0,1,1,0,0,0,
14/10/2016,HGO.,"TULANCINGO DE BRAVO, HGO.",1,0,1,0,0,0,
14/10/2016,N.L.,"GUADALUPE, N.L.",0,0,0,0,0,150,
15/10/2016,MEX.,"ECATEPEC DE MOR., MEX.",11,3,14,0,0,0,
15/10/2016,SON.,"CAJEME, SON.",1,2,3,0,0,0,
15/10/2016,COAH.,"FRANCISCO I. MADERO, COAH.",1,1,2,0,0,0,
15/10/2016,MEX.,"IXTAPALUCA, MEX.",1,1,2,0,0,69,
15/10/2016,HGO.,"MOLANGO DE ESCAMILLA, HGO.",0,1,1,0,0,0,
15/10/2016,B.C.,"TIJUANA, B.C.",1,0,1,0,0,0,
15/10/2016,HGO.,"TEPEJI DEL RIO DE OCAMPO, HGO.",0,0,0,1,0,248,
16/10/2016,MEX.,"TONATICO, MEX.",2,0,2,1,0,0,
16/10/2016,VER.,"POZA RICA DE HGO., VER.",1,0,1,0,0,0,
17/10/2016,D.F.,"CUAJIMALPA DE MOR., D.F.",16,6,22,0,0,160,
17/10/2016,CHIS.,"TAPACHULA, CHIS.",4,1,5,1,1,191,
17/10/2016,COAH.,"MONCLOVA, COAH.",2,1,3,0,0,0,
17/10/2016,SIN.,"ESCUINAPA, SIN.",3,0,3,0,0,0,
17/10/2016,MEX.,"NEXTLALPAN, MEX., MEX.",2,0,2,1,0,0,
17/10/2016,MEX.,"AYAPANGO, MEX.",1,1,2,0,0,0,
17/10/2016,MEX.,"POLOTITLAN, MEX.",2,0,2,0,0,0,
17/10/2016,MEX.,"POLOTITLAN, MEX.",2,0,2,0,0,0,
17/10/2016,B.C.,"MEXICALI, B.C.",0,1,1,0,0,0,
17/10/2016,CHIS.,"PALENQUE, CHIS.",0,0,0,0,2,0,
17/10/2016,MOR.,"XOCHITEPEC, MOR.",0,0,0,30,0,272,
17/10/2016,SON.,"HERMOSILLO, SON.",0,0,0,0,0,637,
18/10/2016,D.F.,"CUAJIMALPA DE MOR., D.F.",15,4,19,0,2,0,
18/10/2016,SIN.,"EL FUERTE, SIN.",10,0,10,0,13,0,
18/10/2016,SIN.,"ESCUINAPA, SIN.",6,0,6,0,7,0,
18/10/2016,MEX.,"NEXTLALPAN, MEX., MEX.",1,0,1,0,0,0,
18/10/2016,COAH.,"MONCLOVA, COAH.",1,0,1,1,0,66,
18/10/2016,COAH.,"MATAMOROS, COAH.",1,0,1,0,0,0,
18/10/2016,COAH.,"TORREÓN, COAH.",0,1,1,0,0,0,
18/10/2016,MEX.,"AYAPANGO, MEX.",0,0,0,0,2,0,
19/10/2016,D.F.,"CUAJIMALPA DE MOR., D.F.",16,6,22,0,0,0,
19/10/2016,SIN.,"EL FUERTE, SIN.",11,4,15,0,8,0,
19/10/2016,SIN.,"ESCUINAPA, SIN.",1,2,3,0,4,0,
19/10/2016,SON.,"CAJEME, SON.",3,0,3,0,0,0,
19/10/2016,SON.,"HERMOSILLO, SON.",1,1,2,0,0,0,
19/10/2016,HGO.,"TEPEJI DEL RIO DE OCAMPO, HGO.",1,0,1,0,0,0,
19/10/2016,MEX.,"NEXTLALPAN, MEX., MEX.",0,1,1,0,0,20,
19/10/2016,MOR.,"XOCHITEPEC, MOR.",1,0,1,2,0,0,
19/10/2016,TAB.,"PARAISO, TAB.",0,0,0,0,2,0,
20/10/2016,D.F.,"CUAJIMALPA DE MOR., D.F.",12,8,20,0,0,70,
20/10/2016,SIN.,"EL FUERTE, SIN.",6,0,6,0,0,0,
20/10/2016,SON.,"CAJEME, SON.",3,0,3,0,0,0,
20/10/2016,COAH.,"SALTILLO, COAH.",2,0,2,0,0,0,
20/10/2016,B.C.,"MEXICALI, B.C.",1,1,2,0,0,0,
20/10/2016,MOR.,"XOCHITEPEC, MOR.",1,0,1,0,0,250,
20/10/2016,TAB.,"PARAISO, TAB.",0,1,1,2,0,0,
20/10/2016,N.L.,"MONTERREY, N.L.",1,0,1,0,0,1200,
20/10/2016,MEX.,"AYAPANGO, MEX.",0,1,1,0,0,0,
20/10/2016,OAX.,"OAX. DE JUAREZ, OAX.",0,1,1,0,0,0,
20/10/2016,COAH.,"TORREÓN, COAH.",0,0,0,1,0,0,
21/10/2016,D.F.,"CUAJIMALPA DE MOR., D.F.",16,8,24,0,0,65,
21/10/2016,MEX.,"NEXTLALPAN, MEX., MEX.",4,1,5,2,0,5,
21/10/2016,CHIS.,"TAPACHULA, CHIS.",3,1,4,0,0,0,
21/10/2016,SON.,"HERMOSILLO, SON.",1,1,2,1,0,0,
21/10/2016,MEX.,"JILOTEPEC, MEX.",2,0,2,1,0,0,
21/10/2016,MEX.,"POLOTITLAN, MEX.",1,1,2,1,0,0,
21/10/2016,MEX.,"AYAPANGO, MEX.",2,0,2,1,7,0,
21/10/2016,TAB.,"TENOSIQUE, TAB.",1,0,1,0,0,0,
21/10/2016,TAB.,"BALANCAN, TAB.",0,1,1,0,0,0,
21/10/2016,SIN.,"ESCUINAPA, SIN.",0,1,1,0,0,0,
21/10/2016,B.C.,"ENSENADA, B.C.",0,1,1,0,0,0,
21/10/2016,COAH.,"TORREÓN, COAH.",0,0,0,0,1,0,
21/10/2016,PUE.,"PUE., PUE.",0,0,0,0,0,136,
22/10/2016,HGO.,"PACHUCA DE SOTO, HGO.",2,2,4,0,0,0,
22/10/2016,MEX.,"NEXTLALPAN, MEX., MEX.",3,1,4,0,0,0,
22/10/2016,B.C.,"MEXICALI, B.C.",2,1,3,0,0,0,
22/10/2016,MEX.,"JILOTEPEC, MEX.",1,0,1,0,0,0,
22/10/2016,MEX.,"POLOTITLAN, MEX.",1,0,1,0,0,0,
22/10/2016,SON.,"HERMOSILLO, SON.",1,0,1,0,0,0,
23/10/2016,MOR.,"XOCHITEPEC, MOR.",1,0,1,1,0,0,
23/10/2016,MEX.,"MEXICALTZINGO, MEX.",1,0,1,0,0,0,
24/10/2016,D.F.,"IZTACALCO, D.F.",13,6,19,0,2,0,
24/10/2016,MEX.,"TEOTIHUACAN, MEX.",8,1,9,0,1,0,
24/10/2016,SON.,"CAJEME, SON.",6,0,6,0,0,0,
24/10/2016,MEX.,"ZINACANTEPEC, MEX.",5,0,5,0,0,0,
24/10/2016,SIN.,"ESCUINAPA, SIN.",3,1,4,0,2,0,
24/10/2016,MEX.,"XONACATLAN, MEX.",2,2,4,0,0,5,
24/10/2016,MEX.,"TEXCALTITLAN, MEX.",1,1,2,1,0,0,
24/10/2016,HGO.,"TULANCINGO DE BRAVO, HGO.",1,0,1,0,0,0,
24/10/2016,GRO.,"AJUCHITLAN DEL PROGRESO, GRO.",0,1,1,0,0,0,
24/10/2016,PUE.,"PUE., PUE.",0,0,0,1,0,53,
24/10/2016,SON.,"HERMOSILLO, SON.",0,0,0,0,0,576,
25/10/2016,D.F.,"IZTACALCO, D.F.",17,4,21,0,0,0,
25/10/2016,MEX.,"TEOTIHUACAN, MEX.",5,3,8,5,1,0,
25/10/2016,MEX.,"ZINACANTEPEC, MEX.",6,0,6,2,0,101,
25/10/2016,COAH.,"SALTILLO, COAH.",1,1,2,0,0,0,
25/10/2016,B.C.,"MEXICALI, B.C.",1,1,2,0,0,0,
25/10/2016,CHIS.,"PALENQUE, CHIS.",1,0,1,0,0,0,
25/10/2016,COAH.,"TORREÓN, COAH.",1,0,1,0,0,0,
25/10/2016,COAH.,"MATAMOROS, COAH.",1,0,1,1,0,0,
25/10/2016,VER.,"CORDOBA, VER.",1,0,1,0,0,0,
25/10/2016,B.C.,"ENSENADA, B.C.",0,1,1,0,0,0,
25/10/2016,SIN.,"ESCUINAPA, SIN.",0,1,1,0,4,0,
25/10/2016,TAB.,"CENTRO, TAB.",0,1,1,1,0,7,
25/10/2016,CHIS.,"TAPACHULA, CHIS.",0,1,1,0,0,0,
25/10/2016,MEX.,"XONACATLAN, MEX.",1,0,1,2,0,0,
25/10/2016,COAH.,"TORREÓN, COAH.",0,1,1,0,0,0,
25/10/2016,SON.,"HERMOSILLO, SON.",0,0,0,11,0,0,
26/10/2016,D.F.,"IZTACALCO, D.F.",12,9,21,0,0,0,
26/10/2016,MEX.,"TEOTIHUACAN, MEX.",2,1,3,0,0,3,
26/10/2016,TAB.,"CENTLA, TAB.",1,1,2,0,0,0,
26/10/2016,B.C.,"MEXICALI, B.C.",1,1,2,0,0,0,
26/10/2016,VER.,"CORDOBA, VER.",1,0,1,0,0,0,
26/10/2016,CHIS.,"TAPACHULA, CHIS.",0,1,1,0,0,0,
26/10/2016,SON.,"HERMOSILLO, SON.",1,0,1,0,0,0,
26/10/2016,COAH.,"TORREÓN, COAH.",0,1,1,0,0,0,
26/10/2016,COAH.,"SALTILLO, COAH.",0,0,0,0,0,200,
27/10/2016,D.F.,"IZTACALCO, D.F.",22,3,25,0,0,0,
27/10/2016,SIN.,"ESCUINAPA, SIN.",4,0,4,0,3,0,
27/10/2016,MEX.,"TEOTIHUACAN, MEX.",3,0,3,0,2,0,
27/10/2016,MOR.,"XOCHITEPEC, MOR.",2,0,2,0,0,0,
27/10/2016,GRO.,"AJUCHITLAN DEL PROGRESO, GRO.",1,0,1,0,0,0,
28/10/2016,D.F.,"IZTACALCO, D.F.",20,4,24,0,0,45,
28/10/2016,MEX.,"XONACATLAN, MEX.",3,1,4,1,0,2,
28/10/2016,VER.,"CORDOBA, VER.",3,0,3,0,0,0,
28/10/2016,MEX.,"ZINACANTEPEC, MEX.",2,1,3,0,0,0,
28/10/2016,MOR.,"XOCHITEPEC, MOR.",1,1,2,0,0,24,
28/10/2016,SON.,"HERMOSILLO, SON.",2,0,2,21,0,0,
28/10/2016,N.L.,"GARCIA, N.L.",1,0,1,0,0,500,
28/10/2016,B.C.,"TIJUANA, B.C.",0,1,1,0,0,0,
28/10/2016,B.C.,"MEXICALI, B.C.",0,1,1,0,0,0,
28/10/2016,SIN.,"ESCUINAPA, SIN.",1,0,1,0,1,0,
28/10/2016,COAH.,"SALTILLO, COAH.",0,0,0,0,2,500,
29/10/2016,MEX.,"TEOTIHUACAN, MEX.",5,3,8,1,0,0,
29/10/2016,N.L.,"GARCIA, N.L.",3,0,3,0,0,1000,
29/10/2016,SON.,"HERMOSILLO, SON.",2,0,2,10,0,43,
29/10/2016,MEX.,"XONACATLAN, MEX.",1,0,1,0,2,0,
30/10/2016,GRO.,"SAN MIGUEL TOTOLAPAN, GRO.",0,1,1,0,0,0,
31/10/2016,D.F.,"IZTACALCO, D.F.",20,4,24,0,0,0,
31/10/2016,SIN.,"GUASAVE, SIN.",10,1,11,0,8,0,
31/10/2016,MEX.,"CALIMAYA, MEX.",2,0,2,1,0,0,
31/10/2016,MEX.,"MELCHOR OCAMPO, MEX.",2,0,2,1,0,0,
31/10/2016,B.C.,"TIJUANA, B.C.",1,0,1,0,0,0,
31/10/2016,SON.,"HERMOSILLO, SON.",1,0,1,8,0,0,
31/10/2016,SON.,"CAJEME, SON.",1,0,1,1,0,0,
31/10/2016,COAH.,"SALTILLO, COAH.",0,1,1,0,0,500,
31/10/2016,MEX.,"TEXCALYACAC, MEX.",1,0,1,0,0,0,
31/10/2016,MEX.,"COCOTITLAN, MEX.",1,0,1,0,0,0,
31/10/2016,VER.,"CORDOBA, VER.",0,0,0,0,0,34,
02/11/2016,SON.,"CAJEME, SON.",4,0,4,1,1,927,
02/11/2016,B.C.,"TIJUANA, B.C.",2,1,3,0,0,0,
02/11/2016,SON.,"HERMOSILLO, SON.",2,0,2,10,0,43,
02/11/2016,N.L.,"GARCIA, N.L.",1,0,1,24,0,100,
02/11/2016,MOR.,"XOCHITEPEC, MOR.",0,0,0,0,1,0,
02/11/2016,COAH.,"RAMOS ARIZPE, COAH.",0,0,0,3,0,0,
03/11/2016,D.F.,"IZTACALCO, D.F.",20,2,22,0,3,0,
03/11/2016,SIN.,"GUASAVE, SIN.",10,6,16,0,7,0,
03/11/2016,MEX.,"CALIMAYA, MEX.",3,0,3,1,0,0,
03/11/2016,SON.,"CAJEME, SON.",2,0,2,43,0,0,
03/11/2016,MEX.,"TEXCALYACAC, MEX.",1,1,2,0,0,54,
03/11/2016,MEX.,"COCOTITLAN, MEX.",1,1,2,0,0,0,
03/11/2016,MEX.,"MELCHOR OCAMPO, MEX.",0,1,1,0,0,0,
03/11/2016,COAH.,"RAMOS ARIZPE, COAH.",1,0,1,0,0,0,
03/11/2016,GRO.,"CHILPANCINGO DE LOS BRAVO, GRO.",0,0,0,0,1,0,
03/11/2016,N.L.,"GARCIA, N.L.",0,0,0,37,0,2971,
03/11/2016,COAH.,"SALTILLO, COAH.",0,0,0,0,0,748,
04/11/2016,D.F.,"IZTACALCO, D.F.",13,6,19,0,2,0,
04/11/2016,SIN.,"GUASAVE, SIN.",10,5,15,0,8,0,
04/11/2016,MEX.,"MELCHOR OCAMPO, MEX.",1,2,3,0,1,9,
04/11/2016,MEX.,"CALIMAYA, MEX.",2,0,2,1,0,0,
04/11/2016,MOR.,"YAUTEPEC, MOR.",0,2,2,0,1,120,
04/11/2016,B.C.,"MEXICALI, B.C.",0,2,2,0,0,0,
04/11/2016,COAH.,"TORREÓN, COAH.",0,2,2,0,0,0,
04/11/2016,MOR.,"YAUTEPEC, MOR.",0,2,2,0,1,120,
04/11/2016,MEX.,"COCOTITLAN, MEX.",1,0,1,0,0,0,
04/11/2016,SON.,"HERMOSILLO, SON.",1,0,1,40,0,250,
04/11/2016,COAH.,"SALTILLO, COAH.",1,0,1,0,0,0,
04/11/2016,COAH.,"ACUÑA, COAH.",1,0,1,0,0,0,
04/11/2016,VER.,"CORDOBA, VER.",0,0,0,0,0,50,
04/11/2016,COAH.,"RAMOS ARIZPE, COAH.",0,0,0,0,0,32,
05/11/2016,B.C.,"TIJUANA, B.C.",2,2,4,0,0,0,
05/11/2016,SON.,"HERMOSILLO, SON.",2,0,2,29,0,613,
05/11/2016,MEX.,"COCOTITLAN, MEX.",2,0,2,0,0,0,
05/11/2016,MEX.,"MELCHOR OCAMPO, MEX.",0,1,1,1,0,23,
06/11/2016,MEX.,"JOQUICINGO, MEX.",4,2,6,0,0,0,
07/11/2016,D.F.,"LA MAGDALENA CONTRERAS, D.F.",10,6,16,0,2,1289,
07/11/2016,MEX.,"NEZAHUALCOYOTL, MEX.",13,3,16,7,60,144,
07/11/2016,SIN.,"GUASAVE, SIN.",10,3,13,0,8,0,
07/11/2016,GRO.,"CHILPANCINGO DE LOS BRAVO, GRO.",6,1,7,0,0,0,
07/11/2016,MEX.,"LUVIANOS, MEX.",1,1,2,1,0,16,
07/11/2016,CHIS.,"PALENQUE, CHIS.",0,1,1,0,0,0,
07/11/2016,SON.,"NOGALES, SON.",0,1,1,0,0,0,
07/11/2016,SON.,"SANTA ANA, SON.",0,1,1,0,0,0,
07/11/2016,SON.,"ALTAR, SON.",1,0,1,1,0,0,
07/11/2016,SON.,"SAN LUIS RIO COLORADO, SON.",1,0,1,0,0,0,
07/11/2016,SON.,"CABORCA, SON.",0,1,1,1,0,0,
07/11/2016,SON.,"PITIQUITO, SON.",1,0,1,0,0,0,
07/11/2016,SON.,"PUERTO PEÑASCO, SON.",1,0,1,0,0,0,
07/11/2016,SON.,"GENERAL PLUTARCO ELIAS CALLES, SON.",0,1,1,1,0,0,
07/11/2016,SON.,"SAHUARIPA, SON.",1,0,1,0,0,0,
07/11/2016,SON.,"BENITO JUAREZ, SON.",0,1,1,0,0,0,
07/11/2016,SON.,"ALAMOS, SON.",0,1,1,0,0,0,
07/11/2016,MOR.,"YAUTEPEC, MOR.",0,1,1,1,0,0,
07/11/2016,MEX.,"PAPALOTLA, MEX.",1,0,1,0,0,0,
07/11/2016,MEX.,"TEMAMATLA, MEX.",0,0,0,0,0,0,
08/11/2016,D.F.,"LA MAGDALENA CONTRERAS, D.F.",11,8,19,0,1,3532,
08/11/2016,SIN.,"GUASAVE, SIN.",12,6,18,0,6,0,
08/11/2016,MEX.,"NEZAHUALCOYOTL, MEX.",9,1,10,4,1,66,
08/11/2016,SON.,"HERMOSILLO, SON.",5,0,5,0,0,0,
08/11/2016,MEX.,"TEMAMATLA, MEX.",5,0,5,0,0,0,
08/11/2016,MOR.,"YAUTEPEC, MOR.",2,2,4,3,0,0,
08/11/2016,SON.,"NOGALES, SON.",0,3,3,3,0,168,
08/11/2016,SON.,"GENERAL PLUTARCO ELIAS CALLES, SON.",1,2,3,9,0,0,
08/11/2016,MEX.,"TEJUPILCO, MEX.",1,1,2,1,0,0,
08/11/2016,SON.,"EMPALME, SON.",1,1,2,0,0,0,
08/11/2016,B.C.,"TIJUANA, B.C.",0,2,2,0,0,0,
08/11/2016,SIN.,"ANGOSTURA, SIN.",2,0,2,0,0,0,
08/11/2016,SON.,"NAVOJOA, SON.",1,0,1,0,0,0,
08/11/2016,SON.,"CABORCA, SON.",1,0,1,0,0,240,
08/11/2016,SON.,"AGUA PRIETA, SON.",1,0,1,0,0,0,
08/11/2016,B.C.,"ENSENADA, B.C.",0,1,1,0,0,0,
08/11/2016,MEX.,"PAPALOTLA, MEX.",0,1,1,0,0,0,
08/11/2016,COAH.,"SALTILLO, COAH.",0,0,0,0,0,200,
08/11/2016,COAH.,"RAMOS ARIZPE, COAH.",0,0,0,0,0,19,
09/11/2016,D.F.,"LA MAGDALENA CONTRERAS, D.F.",15,7,22,0,0,0,
09/11/2016,SIN.,"GUASAVE, SIN.",10,6,16,0,8,0,
09/11/2016,MEX.,"NEZAHUALCOYOTL, MEX.",5,7,12,0,0,0,
09/11/2016,MEX.,"TEJUPILCO, MEX.",7,4,11,0,5,0,
09/11/2016,SON.,"HERMOSILLO, SON.",3,0,3,0,0,0,
09/11/2016,SON.,"NAVOJOA, SON.",3,0,3,0,0,0,
09/11/2016,COAH.,"ACUÑA, COAH.",0,3,3,0,0,0,
09/11/2016,SON.,"SAN LUIS RIO COLORADO, SON.",2,1,3,0,0,0,
09/11/2016,SON.,"HUATABAMPO, SON.",2,0,2,2,0,0,
09/11/2016,SON.,"ALAMOS, SON.",2,0,2,5,0,0,
09/11/2016,MEX.,"LUVIANOS, MEX.",1,1,2,1,0,0,
09/11/2016,MEX.,"LUVIANOS, MEX.",2,0,2,0,3,0,
09/11/2016,SON.,"HERMOSILLO, SON.",1,0,1,1,0,0,
09/11/2016,SON.,"BENITO JUAREZ, SON.",1,0,1,0,0,0,
09/11/2016,SON.,"ETCHOJOA, SON.",1,0,1,1,0,0,
09/11/2016,VER.,"COATEPEC, VER.",0,1,1,0,0,0,
09/11/2016,CHIS.,"PALENQUE, CHIS.",1,0,1,0,0,0,
09/11/2016,SON.,"AGUA PRIETA, SON.",1,0,1,2,0,9,
09/11/2016,MOR.,"YAUTEPEC, MOR.",1,0,1,0,0,0,
09/11/2016,MEX.,"PAPALOTLA, MEX.",1,0,1,0,0,0,
09/11/2016,COAH.,"RAMOS ARIZPE, COAH.",0,0,0,0,0,32,
09/11/2016,SON.,"NOGALES, SON.",0,0,0,0,0,50,
10/11/2016,D.F.,"LA MAGDALENA CONTRERAS, D.F.",14,4,18,0,12,50,
10/11/2016,MEX.,"NEZAHUALCOYOTL, MEX.",12,3,15,31,1,49,
10/11/2016,SIN.,"GUASAVE, SIN.",8,6,14,0,8,0,
10/11/2016,SON.,"HERMOSILLO, SON.",4,0,4,1,0,20,
10/11/2016,COAH.,"TORREÓN, COAH.",2,1,3,0,0,0,
10/11/2016,SON.,"HUATABAMPO, SON.",3,0,3,0,0,0,
10/11/2016,SON.,"SAN LUIS RIO COLORADO, SON.",1,2,3,0,0,0,
10/11/2016,SON.,"CABORCA, SON.",0,2,2,0,0,0,
10/11/2016,MEX.,"TEMAMATLA, MEX.",1,1,2,0,0,0,
10/11/2016,N.L.,"GARCIA, N.L.",0,1,1,0,0,0,
10/11/2016,OAX.,"OAX. DE JUAREZ, OAX.",1,0,1,0,0,0,
10/11/2016,VER.,"COATEPEC, VER.",0,1,1,0,0,10,
10/11/2016,SON.,"NAVOJOA, SON.",0,1,1,3,0,77,
10/11/2016,SON.,"CANANEA, SON.",0,1,1,0,0,0,
10/11/2016,SON.,"GENERAL PLUTARCO ELIAS CALLES, SON.",1,0,1,1,0,0,
10/11/2016,SON.,"BENITO JUAREZ, SON.",0,0,0,0,0,600,
11/11/2016,D.F.,"LA MAGDALENA CONTRERAS, D.F.",19,5,24,0,0,0,
11/11/2016,MEX.,"NEZAHUALCOYOTL, MEX.",8,3,11,0,0,86,
11/11/2016,SON.,"NOGALES, SON.",2,2,4,4,0,0,
11/11/2016,SON.,"SAN LUIS RIO COLORADO, SON.",1,2,3,23,0,148,
11/11/2016,SON.,"HERMOSILLO, SON.",1,2,3,0,0,0,
11/11/2016,SON.,"CAJEME, SON.",3,0,3,0,0,0,
11/11/2016,MEX.,"LUVIANOS, MEX.",3,0,3,2,0,0,
11/11/2016,VER.,"COATEPEC, VER.",2,0,2,0,1,0,
11/11/2016,MEX.,"TEJUPILCO, MEX.",2,0,2,1,0,92,
11/11/2016,CHIS.,"PALENQUE, CHIS.",1,0,1,0,0,0,
11/11/2016,COAH.,"RAMOS ARIZPE, COAH.",0,1,1,0,0,0,
11/11/2016,SON.,"CANANEA, SON.",0,1,1,0,0,0,
11/11/2016,SON.,"BENITO JUAREZ, SON.",1,0,1,0,0,0,
11/11/2016,OAX.,"OAX. DE JUAREZ, OAX.",0,1,1,0,0,0,
12/11/2016,MEX.,"NEZAHUALCOYOTL, MEX.",9,2,11,0,0,35,
12/11/2016,SON.,"NOGALES, SON.",5,0,5,5,0,124,
12/11/2016,SON.,"HERMOSILLO, SON.",3,2,5,0,0,0,
12/11/2016,MEX.,"LUVIANOS, MEX.",5,0,5,2,0,0,
12/11/2016,MEX.,"TEJUPILCO, MEX.",4,0,4,3,0,0,
12/11/2016,COAH.,"ACUÑA, COAH.",0,2,2,0,0,0,
12/11/2016,MEX.,"TEMAMATLA, MEX.",2,0,2,1,0,0,
12/11/2016,MEX.,"PAPALOTLA, MEX.",2,0,2,0,0,0,
12/11/2016,SON.,"CANANEA, SON.",1,0,1,1,0,26,
12/11/2016,SON.,"CABORCA, SON.",0,1,1,0,0,0,
12/11/2016,SON.,"BENITO JUAREZ, SON.",1,0,1,0,0,0,
12/11/2016,OAX.,"OAX. DE JUAREZ, OAX.",0,1,1,0,0,0,
12/11/2016,B.C.,"MEXICALI, B.C.",0,1,1,0,0,0,
13/11/2016,VER.,"TANTOYUCA, VER.",1,0,1,0,0,0,
14/11/2016,D.F.,"LA MAGDALENA CONTRERAS, D.F.",21,7,28,0,4,0,
14/11/2016,MEX.,"TECAMAC, MEX.",5,1,6,0,0,0,
14/11/2016,SON.,"SAN LUIS RIO COLORADO, SON.",1,2,3,0,0,0,
14/11/2016,OAX.,"OAX. DE JUAREZ, OAX.",0,2,2,0,0,0,
14/11/2016,SON.,"NAVOJOA, SON.",2,0,2,0,0,0,
14/11/2016,SON.,"CANANEA, SON.",1,1,2,1,0,0,
14/11/2016,MEX.,"JALTENCO, MEX.",0,2,2,0,0,0,
14/11/2016,SON.,"HERMOSILLO, SON.",0,1,1,14,0,0,
14/11/2016,SON.,"HUATABAMPO, SON.",1,0,1,2,0,0,
14/11/2016,SON.,"ETCHOJOA, SON.",1,0,1,0,0,0,
14/11/2016,SON.,"ALAMOS, SON.",0,0,0,1,0,0,
14/11/2016,SON.,"NOGALES, SON.",0,0,0,4,0,51,
14/11/2016,MOR.,"YAUTEPEC, MOR.",0,0,0,0,42,0,
15/11/2016,D.F.,"LA MAGDALENA CONTRERAS, D.F.",19,4,23,0,10,0,
15/11/2016,MEX.,"TECAMAC, MEX.",8,3,11,2,2,247,
15/11/2016,SON.,"CAJEME, SON.",4,0,4,0,0,50,
15/11/2016,B.C.,"MEXICALI, B.C.",1,2,3,0,0,0,
15/11/2016,SON.,"SAN LUIS RIO COLORADO, SON.",0,3,3,0,0,0,
15/11/2016,SON.,"NOGALES, SON.",2,0,2,2,0,110,
15/11/2016,SON.,"CABORCA, SON.",1,1,2,2,0,0,
15/11/2016,B.C.,"TIJUANA, B.C.",0,1,1,0,0,0,
15/11/2016,MOR.,"YAUTEPEC, MOR.",0,1,1,0,14,0,
15/11/2016,VER.,"CORDOBA, VER.",1,0,1,0,0,29,
15/11/2016,MEX.,"JALTENCO, MEX.",1,0,1,0,0,0,
15/11/2016,SON.,"CANANEA, SON.",1,0,1,0,0,25,
15/11/2016,SON.,"HERMOSILLO, SON.",0,1,1,0,0,200,
15/11/2016,SON.,"AGUA PRIETA, SON.",0,0,0,0,0,34,
16/11/2016,MEX.,"TECAMAC, MEX.",8,2,10,0,0,0,
16/11/2016,SON.,"HERMOSILLO, SON.",2,1,3,0,0,0,
16/11/2016,MEX.,"DONATO GUERRA, MEX.",1,0,1,1,0,0,
16/11/2016,B.C.,"TIJUANA, B.C.",0,1,1,0,0,0,
16/11/2016,SON.,"NOGALES, SON.",0,1,1,1,0,27,
16/11/2016,SON.,"CANANEA, SON.",0,1,1,0,0,0,
16/11/2016,SON.,"SAN LUIS RIO COLORADO, SON.",1,0,1,0,0,0,
16/11/2016,SON.,"PITIQUITO, SON.",1,0,1,0,0,0,
16/11/2016,VER.,"CORDOBA, VER.",1,0,1,0,0,35,
16/11/2016,SON.,"AGUA PRIETA, SON.",0,0,0,1,0,0,
16/11/2016,SON.,"NAVOJOA, SON.",0,0,0,1,0,0,
16/11/2016,MEX.,"JALTENCO, MEX.",0,0,0,0,7,0,
17/11/2016,D.F.,"LA MAGDALENA CONTRERAS, D.F.",18,10,28,0,0,50,
17/11/2016,MEX.,"TECAMAC, MEX.",9,3,12,13,0,0,
17/11/2016,MOR.,"YAUTEPEC, MOR.",2,2,4,0,0,0,
17/11/2016,MEX.,"MALINALCO, MEX.",2,1,3,1,0,0,
17/11/2016,B.C.,"MEXICALI, B.C.",0,2,2,0,0,0,
17/11/2016,SON.,"BENITO JUAREZ, SON.",2,0,2,0,0,0,
17/11/2016,SON.,"CABORCA, SON.",0,2,2,0,0,0,
17/11/2016,COAH.,"TORREÓN, COAH.",1,0,1,0,0,39,
17/11/2016,MEX.,"MALINALCO, MEX.",0,1,1,0,0,0,
17/11/2016,MEX.,"DONATO GUERRA, MEX.",1,0,1,0,0,0,
17/11/2016,SON.,"NOGALES, SON.",1,0,1,0,0,81,
17/11/2016,SON.,"AGUA PRIETA, SON.",1,0,1,1,0,0,
18/11/2016,SON.,"HERMOSILLO, SON.",5,0,5,0,0,0,
18/11/2016,MEX.,"TECAMAC, MEX.",5,0,5,0,0,0,
18/11/2016,MOR.,"YAUTEPEC, MOR.",2,2,4,0,3,251,
18/11/2016,VER.,"CORDOBA, VER.",2,1,3,0,0,117,
18/11/2016,SON.,"NOGALES, SON.",1,1,2,10,0,40,
18/11/2016,TAB.,"CENTRO, TAB.",1,0,1,2,0,20,
18/11/2016,SON.,"HERMOSILLO, SON.",1,0,1,0,0,0,
18/11/2016,MEX.,"DONATO GUERRA, MEX.",1,0,1,0,0,0,
18/11/2016,MEX.,"JALTENCO, MEX.",1,0,1,0,0,0,
18/11/2016,MEX.,"LA PAZ, MEX.",1,0,1,0,0,0,
18/11/2016,SON.,"NAVOJOA, SON.",0,0,0,0,0,40,
19/11/2016,MEX.,"DONATO GUERRA, MEX.",4,0,4,2,0,0,
19/11/2016,SON.,"NOGALES, SON.",2,0,2,0,0,0,
19/11/2016,MEX.,"MALINALCO, MEX.",1,0,1,0,0,0,
19/11/2016,MOR.,"YAUTEPEC, MOR.",0,0,0,0,0,0,
20/11/2016,MEX.,"TECAMAC, MEX.",7,5,12,5,0,0,
20/11/2016,MEX.,"LA PAZ, MEX.",1,1,2,1,0,0,
20/11/2016,MEX.,"LA PAZ, MEX.",1,0,1,2,1,0,
20/11/2016,B.C.,"TIJUANA, B.C.",0,0,0,0,1,0,
21/11/2016,B.C.,"TIJUANA, B.C.",0,1,1,0,0,0,
21/11/2016,SON.,"CAJEME, SON.",1,0,1,0,0,0,
21/11/2016,SON.,"HUATABAMPO, SON.",1,0,1,0,0,0,
21/11/2016,SON.,"HERMOSILLO, SON.",0,0,0,0,0,100,
21/11/2016,SON.,"ETCHOJOA, SON.",0,0,0,1,0,120,
22/11/2016,D.F.,"COYOACAN, D.F.",16,5,21,0,0,0,
22/11/2016,MEX.,"NOPALTEPEC, MEX.",0,5,5,5,8,173,
22/11/2016,MEX.,"RAYON, MEX.",4,0,4,5,0,0,
22/11/2016,MOR.,"YAUTEPEC, MOR.",2,2,4,2,0,193,
22/11/2016,COAH.,"TORREÓN, COAH.",2,1,3,1,0,0,
22/11/2016,MEX.,"XALATLACO, MEX.",2,0,2,0,0,4,
22/11/2016,SON.,"NOGALES, SON.",1,0,1,2,0,0,
22/11/2016,COAH.,"TORREÓN, COAH.",1,0,1,0,0,0,
23/11/2016,D.F.,"COYOACAN, D.F.",16,5,21,0,6,0,
23/11/2016,B.C.,"TIJUANA, B.C.",2,4,6,0,0,0,
23/11/2016,B.C.,"ENSENADA, B.C.",3,1,4,0,0,0,
23/11/2016,MICH.,"PATZCUARO, MICH.",2,2,4,0,0,0,
23/11/2016,SON.,"HUATABAMPO, SON.",1,1,2,0,0,0,
23/11/2016,MEX.,"RAYON, MEX.",2,0,2,0,0,0,
23/11/2016,SON.,"HERMOSILLO, SON.",1,0,1,5,0,50,
23/11/2016,SON.,"NOGALES, SON.",1,0,1,0,0,6,
23/11/2016,SON.,"PITIQUITO, SON.",1,0,1,1,0,0,
23/11/2016,MEX.,"NOPALTEPEC, MEX.",1,0,1,0,0,0,
23/11/2016,MEX.,"JUCHITEPEC, MEX.",1,0,1,0,0,0,
23/11/2016,MEX.,"XALATLACO, MEX.",0,1,1,0,0,0,
23/11/2016,MEX.,"RAYON, MEX.",1,0,1,0,0,0,
23/11/2016,MEX.,"XALATLACO, MEX.",0,1,1,0,0,0,
23/11/2016,CHIS.,"PALENQUE, CHIS.",0,0,0,0,0,250,
23/11/2016,SON.,"MAGDALENA, SON.",0,0,0,0,0,36,
24/11/2016,D.F.,"COYOACAN, D.F.",15,4,19,0,4,0,
24/11/2016,SON.,"CAJEME, SON.",4,4,8,0,0,0,
24/11/2016,MEX.,"NOPALTEPEC, MEX.",2,1,3,0,0,0,
24/11/2016,COAH.,"TORREÓN, COAH.",2,0,2,0,0,0,
24/11/2016,SON.,"SAN LUIS RIO COLORADO, SON.",0,2,2,1,0,18,
24/11/2016,SON.,"MAGDALENA, SON.",1,0,1,2,0,60,
24/11/2016,SON.,"CANANEA, SON.",0,1,1,0,0,31,
24/11/2016,SON.,"PUERTO PEÑASCO, SON.",1,0,1,0,0,0,
24/11/2016,TAB.,"JONUTA, TAB.",1,0,1,0,0,0,
24/11/2016,B.C.,"TIJUANA, B.C.",0,1,1,0,0,0,
24/11/2016,MEX.,"JUCHITEPEC, MEX.",1,0,1,0,8,0,
24/11/2016,COAH.,"SALTILLO, COAH.",0,0,0,0,0,248,
25/11/2016,MEX.,"NOPALTEPEC, MEX.",2,0,2,0,0,0,
25/11/2016,MICH.,"PATZCUARO, MICH.",1,0,1,0,0,0,
25/11/2016,SON.,"EMPALME, SON.",1,0,1,0,0,0,
25/11/2016,MOR.,"YAUTEPEC, MOR.",0,1,1,0,0,515,
25/11/2016,SON.,"NOGALES, SON.",0,0,0,0,0,0,
25/11/2016,SON.,"AGUA PRIETA, SON.",0,0,0,0,0,50,
25/11/2016,SON.,"PUERTO PEÑASCO, SON.",0,0,0,0,0,25,
25/11/2016,COAH.,"SALTILLO, COAH.",0,0,0,4,0,223,
26/11/2016,MEX.,"JOCOTITLAN, MEX.",1,5,6,6,0,0,
26/11/2016,MEX.,"RAYON, MEX.",0,4,4,0,0,103,
26/11/2016,SON.,"ETCHOJOA, SON.",1,1,2,0,0,0,
26/11/2016,MEX.,"JUCHITEPEC, MEX.",1,1,2,0,0,0,
26/11/2016,MEX.,"RAYON, MEX.",0,2,2,0,0,0,
26/11/2016,MEX.,"XALATLACO, MEX.",1,0,1,1,0,0,
26/11/2016,MICH.,"PATZCUARO, MICH.",0,1,1,0,0,0,
26/11/2016,N.L.,"SAN NICOLAS DE LOS GARZA, N.L.",1,0,1,0,0,200,
26/11/2016,SON.,"HERMOSILLO, SON.",0,0,0,23,0,55,
27/11/2016,MEX.,"JOCOTITLAN, MEX.",0,1,1,0,0,0,
27/11/2016,B.C.,"TIJUANA, B.C.",0,0,0,0,1,0,
28/11/2016,SON.,"SAN LUIS RIO COLORADO, SON.",2,2,4,1,0,55,
28/11/2016,MEX.,"ACAMBAY, MEX.",2,1,3,0,0,0,
28/11/2016,SON.,"CAJEME, SON.",1,2,3,2,0,0,
28/11/2016,SON.,"NOGALES, SON.",2,0,2,1,0,20,
28/11/2016,SON.,"CABORCA, SON.",1,1,2,0,0,0,
28/11/2016,CHIS.,"PALENQUE, CHIS.",1,0,1,0,0,0,
28/11/2016,MOR.,"YAUTEPEC, MOR.",0,1,1,0,0,51,
28/11/2016,COAH.,"SAN PEDRO, COAH.",1,0,1,0,0,0,
28/11/2016,D.F.,"ALVARO OBREGON, D.F.",0,1,1,0,0,0,
28/11/2016,SON.,"HERMOSILLO, SON.",1,0,1,3,0,46,
28/11/2016,SON.,"ALAMOS, SON.",1,0,1,0,0,0,
28/11/2016,TAB.,"HUIMANGUILLO, TAB.",1,0,1,0,2,0,
28/11/2016,SON.,"PITIQUITO, SON.",0,1,1,0,0,0,
28/11/2016,SON.,"PUERTO PEÑASCO, SON.",1,0,1,1,0,9,
28/11/2016,SON.,"GENERAL PLUTARCO ELIAS CALLES, SON.",0,1,1,1,0,9,
28/11/2016,N.L.,"GARCIA, N.L.",1,0,1,0,0,150,
28/11/2016,MEX.,"AXAPUSCO, MEX.",0,1,1,0,0,0,
29/11/2016,B.C.,"TIJUANA, B.C.",2,5,7,0,0,0,
29/11/2016,D.F.,"ALVARO OBREGON, D.F.",3,2,5,0,2,68,
29/11/2016,SON.,"PUERTO PEÑASCO, SON.",0,3,3,0,0,9,
29/11/2016,SON.,"HERMOSILLO, SON.",2,0,2,32,0,165,
29/11/2016,SON.,"CAJEME, SON.",0,2,2,0,0,0,
29/11/2016,N.L.,"SAN NICOLAS DE LOS GARZA, N.L.",2,0,2,3,0,50,
29/11/2016,SON.,"SAN LUIS RIO COLORADO, SON.",2,0,2,4,0,75,
29/11/2016,MEX.,"ACAMBAY, MEX.",2,0,2,0,1,0,
29/11/2016,SON.,"HUATABAMPO, SON.",0,1,1,0,0,0,
29/11/2016,SON.,"NAVOJOA, SON.",1,0,1,6,0,0,
29/11/2016,GRO.,"COYUCA DE BENITEZ, GRO.",1,0,1,0,0,0,
29/11/2016,MICH.,"LA PIEDAD, MICH.",0,1,1,0,0,0,
29/11/2016,MEX.,"TEMASCALAPA, MEX.",0,1,1,1,0,0,
29/11/2016,MEX.,"AXAPUSCO, MEX.",0,1,1,0,0,0,
29/11/2016,SON.,"ETCHOJOA, SON.",0,0,0,4,0,0,
29/11/2016,SON.,"CANANEA, SON.",0,0,0,5,0,543,
30/11/2016,SON.,"BENITO JUAREZ, SON.",0,8,8,0,0,0,
30/11/2016,TAB.,"CENTRO, TAB.",6,0,6,3,1,535,
30/11/2016,SON.,"HERMOSILLO, SON.",4,0,4,19,0,0,
30/11/2016,SON.,"NOGALES, SON.",0,2,2,1,0,0,
30/11/2016,YUC.,"KANTUNIL, YUC.",0,2,2,0,0,0,
30/11/2016,COAH.,"SALTILLO, COAH.",2,0,2,0,0,0,
30/11/2016,MEX.,"ACAMBAY, MEX.",1,0,1,0,0,0,
30/11/2016,SON.,"NOGALES, SON.",0,1,1,0,0,14,
30/11/2016,SON.,"CARBO, SON.",0,1,1,14,0,0,
30/11/2016,SON.,"SAN MIGUEL DE HORCASITAS, SON.",0,1,1,6,0,0,
30/11/2016,SON.,"EMPALME, SON.",1,0,1,0,0,0,
30/11/2016,SON.,"HERMOSILLO, SON.",1,0,1,0,0,0,
30/11/2016,SON.,"NAVOJOA, SON.",0,1,1,3,0,0,
30/11/2016,SON.,"ALAMOS, SON.",1,0,1,1,0,0,
01/12/2016,COAH.,"SALTILLO, COAH.",22,11,33,131,13,1460,
01/12/2016,MEX.,"TEMASCALAPA, MEX.",3,1,4,0,3,0,
01/12/2016,B.C.,"TIJUANA, B.C.",3,1,4,0,0,0,
01/12/2016,S.L.P.,"SAN LUIS POTOSI, S.L.P.",3,0,3,0,0,0,
01/12/2016,MEX.,"ACAMBAY, MEX.",2,1,3,1,0,54,
01/12/2016,N.L.,"SAN PEDRO GARZA GARCIA, N.L.",3,0,3,4,0,408,
01/12/2016,D.F.,"AZCAPOTZALCO, D.F.",2,0,2,0,0,96,
01/12/2016,MEX.,"COATEPEC HARINAS, MEX.",1,1,2,0,0,0,
01/12/2016,MEX.,"AXAPUSCO, MEX.",1,0,1,0,1,0,
01/12/2016,S.L.P.,"CIUDAD VALLES, S.L.P.",1,0,1,0,0,0,
01/12/2016,MOR.,"YAUTEPEC, MOR.",0,0,0,0,12,0,
01/12/2016,MICH.,"LA PIEDAD, MICH.",0,0,0,0,0,525,
02/12/2016,S.L.P.,"SAN LUIS POTOSI, S.L.P.",7,0,7,2,0,50,
02/12/2016,MEX.,"ACAMBAY, MEX.",5,0,5,4,0,0,
02/12/2016,MOR.,"YAUTEPEC, MOR.",3,1,4,0,0,0,
02/12/2016,B.C.,"TIJUANA, B.C.",0,4,4,0,0,0,
02/12/2016,MEX.,"AXAPUSCO, MEX.",1,0,1,1,0,0,
02/12/2016,B.C.,"ENSENADA, B.C.",0,1,1,0,0,0,
02/12/2016,S.L.P.,"CIUDAD VALLES, S.L.P.",1,0,1,0,0,0,
02/12/2016,COAH.,"SALTILLO, COAH.",1,0,1,0,0,0,
02/12/2016,MEX.,"COATEPEC HARINAS, MEX.",1,0,1,1,0,0,
02/12/2016,MICH.,"LA PIEDAD, MICH.",0,0,0,0,0,500,
03/12/2016,S.L.P.,"SAN LUIS POTOSI, S.L.P.",8,0,8,3,0,0,
03/12/2016,MEX.,"AXAPUSCO, MEX.",2,1,3,0,0,0,
03/12/2016,MEX.,"ACAMBAY, MEX.",1,1,2,1,12,0,
03/12/2016,MEX.,"TEMASCALAPA, MEX.",2,0,2,0,0,0,
03/12/2016,COAH.,"FRANCISCO I. MADERO, COAH.",1,0,1,0,0,0,
03/12/2016,B.C.,"TIJUANA, B.C.",0,1,1,0,0,0,
03/12/2016,MICH.,"LA PIEDAD, MICH.",0,0,0,0,0,1000,
04/12/2016,S.L.P.,"SAN LUIS POTOSI, S.L.P.",2,0,2,0,0,0,
04/12/2016,S.L.P.,"CIUDAD VALLES, S.L.P.",1,0,1,0,0,0,
05/12/2016,S.L.P.,"SAN LUIS POTOSI, S.L.P.",4,3,7,0,1,0,
05/12/2016,D.F.,"AZCAPOTZALCO, D.F.",3,3,6,0,1,83,
05/12/2016,B.C.,"TIJUANA, B.C.",1,4,5,0,0,0,
05/12/2016,COAH.,"TORREÓN, COAH.",2,0,2,0,0,0,
05/12/2016,S.L.P.,"CIUDAD VALLES, S.L.P.",2,0,2,1,0,0,
05/12/2016,COAH.,"SALTILLO, COAH.",1,0,1,0,3,0,
05/12/2016,D.F.,"AZCAPOTZALCO, D.F.",0,0,0,0,5,50,
06/12/2016,S.L.P.,"SAN LUIS POTOSI, S.L.P.",4,0,4,0,4,0,
06/12/2016,N.L.,"SAN PEDRO GARZA GARCIA, N.L.",3,0,3,16,0,1600,
06/12/2016,S.L.P.,"CIUDAD VALLES, S.L.P.",2,0,2,1,0,99,
07/12/2016,S.L.P.,"SAN LUIS POTOSI, S.L.P.",6,1,7,6,1,649,
07/12/2016,B.C.,"TIJUANA, B.C.",0,5,5,0,0,0,
07/12/2016,S.L.P.,"CIUDAD VALLES, S.L.P.",1,1,2,1,0,19,
07/12/2016,GTO.,"IRAPUATO, GTO.",1,1,2,0,0,0,
07/12/2016,D.F.,"IZTAPALAPA, D.F.",1,0,1,0,1,34,
07/12/2016,COL.,"COL., COL.",0,0,0,6,0,335,
08/12/2016,D.F.,"VENUSTIANO CARRANZA, D.F.",3,2,5,0,0,76,
08/12/2016,B.C.,"MEXICALI, B.C.",1,2,3,0,0,0,
08/12/2016,S.L.P.,"SAN LUIS POTOSI, S.L.P.",3,0,3,0,1,83,
08/12/2016,N.L.,"APODACA, N.L.",0,2,2,0,0,0,
08/12/2016,COAH.,"SALTILLO, COAH.",1,0,1,0,0,0,
08/12/2016,COAH.,"TORREÓN, COAH.",1,0,1,0,0,0,
08/12/2016,S.L.P.,"CIUDAD VALLES, S.L.P.",0,1,1,0,0,130,
08/12/2016,COAH.,"TORREÓN, COAH.",1,0,1,0,0,0,
08/12/2016,N.L.,"SAN PEDRO GARZA GARCIA, N.L.",0,0,0,10,0,1000,
09/12/2016,GTO.,"LEON, GTO.",9,9,18,0,0,0,
09/12/2016,S.L.P.,"SAN LUIS POTOSI, S.L.P.",17,1,18,0,0,0,
09/12/2016,GTO.,"IRAPUATO, GTO.",2,4,6,0,0,0,
09/12/2016,COAH.,"SALTILLO, COAH.",1,0,1,0,0,0,
09/12/2016,S.L.P.,"CIUDAD VALLES, S.L.P.",1,0,1,0,0,0,
09/12/2016,D.F.,"VENUSTIANO CARRANZA, D.F.",0,0,0,0,1,0,
10/12/2016,TAMPS.,"MATAMOROS, TAMPS.",4,4,8,3,0,85,
10/12/2016,GTO.,"IRAPUATO, GTO.",7,0,7,0,0,0,
10/12/2016,B.C.,"MEXICALI, B.C.",0,3,3,0,0,0,
10/12/2016,S.L.P.,"CIUDAD VALLES, S.L.P.",2,1,3,1,0,60,
10/12/2016,TAMPS.,"ALTAMIRA, TAMPS.",2,0,2,2,0,210,
10/12/2016,S.L.P.,"SAN LUIS POTOSI, S.L.P.",2,0,2,1,0,0,
11/12/2016,GTO.,"IRAPUATO, GTO.",5,3,8,0,0,0,
11/12/2016,GTO.,"IRAPUATO, GTO.",0,7,7,0,0,0,
12/12/2016,GTO.,"LEON, GTO.",8,4,12,0,7,0,
12/12/2016,S.L.P.,"CIUDAD VALLES, S.L.P.",4,1,5,0,0,6,
12/12/2016,HGO.,"PACHUCA DE SOTO, HGO.",0,1,1,0,0,500,
12/12/2016,HGO.,"IXMIQUILPAN, HGO.",1,0,1,0,0,0,
12/12/2016,TAMPS.,"ALTAMIRA, TAMPS.",1,0,1,6,0,180,
12/12/2016,N.L.,"APODACA, N.L.",0,0,0,0,0,100,
13/12/2016,GTO.,"LEON, GTO.",11,10,21,0,0,0,
13/12/2016,B.C.,"TIJUANA, B.C.",1,5,6,0,0,0,
13/12/2016,COAH.,"MATAMOROS, COAH.",0,1,1,3,0,0,
13/12/2016,B.C.,"MEXICALI, B.C.",1,0,1,0,0,0,
13/12/2016,D.F.,"VENUSTIANO CARRANZA, D.F.",1,0,1,0,0,0,
13/12/2016,TAB.,"CENTRO, TAB.",1,0,1,6,0,0,
13/12/2016,N.L.,"APODACA, N.L.",0,0,0,0,0,225,
14/12/2016,GTO.,"LEON, GTO.",16,2,18,0,0,0,
14/12/2016,D.F.,"MIGUEL HGO., D.F.",2,1,3,0,0,0,
14/12/2016,COAH.,"FRANCISCO I. MADERO, COAH.",1,0,1,0,0,0,
14/12/2016,N.L.,"GRAL. ESCOBEDO, N.L.",1,0,1,0,0,0,
15/12/2016,GTO.,"LEON, GTO.",12,7,19,0,1,0,
15/12/2016,D.F.,"MIGUEL HGO., D.F.",0,1,1,0,0,0,
15/12/2016,N.L.,"APODACA, N.L.",1,0,1,0,0,0,
15/12/2016,N.L.,"APODACA, N.L.",1,0,1,0,0,0,
16/12/2016,GTO.,"LEON, GTO.",9,8,17,1,1,0,
16/12/2016,HGO.,"IXMIQUILPAN, HGO.",2,0,2,0,0,500,
16/12/2016,S.L.P.,"SAN LUIS POTOSI, S.L.P.",1,0,1,0,0,0,
16/12/2016,N.L.,"APODACA, N.L.",0,1,1,0,0,0,
16/12/2016,HGO.,"CUAUTEPEC DE HINOJOSA, HGO.",1,0,1,18,0,0,
16/12/2016,HGO.,"PACULA, HGO.",0,0,0,0,0,1308,
17/12/2016,B.C.,"TIJUANA, B.C.",0,5,5,0,1,0,
17/12/2016,TAB.,"CENTRO, TAB.",1,0,1,0,0,0,
17/12/2016,HGO.,"IXMIQUILPAN, HGO.",0,0,0,0,0,300,
18/12/2016,HGO.,"CUAUTEPEC DE HINOJOSA, HGO.",1,0,1,0,0,0,
18/12/2016,HGO.,"IXMIQUILPAN, HGO.",1,0,1,0,0,0,
19/12/2016,GTO.,"LEON, GTO.",11,6,17,0,0,0,
19/12/2016,N.L.,"GRAL. ESCOBEDO, N.L.",3,0,3,0,0,0,
19/12/2016,CHIH.,"HGO. DEL PARRAL, CHIH.",2,0,2,0,0,0,
20/12/2016,GTO.,"LEON, GTO.",11,8,19,0,0,0,
20/12/2016,D.F.,"CUAUHTEMOC, D.F.",3,0,3,0,0,0,
20/12/2016,CHIH.,"HGO. DEL PARRAL, CHIH.",0,0,0,1,0,0,
21/12/2016,GTO.,"LEON, GTO.",5,2,7,0,0,0,
21/12/2016,B.C.,"TIJUANA, B.C.",5,1,6,0,0,0,
21/12/2016,B.C.,"TIJUANA, B.C.",0,5,5,0,0,0,
21/12/2016,TAMPS.,"TAMPICO, TAMPS.",5,0,5,11,0,475,
21/12/2016,D.F.,"CUAUHTEMOC, D.F.",1,0,1,0,0,80,
21/12/2016,TAB.,"TENOSIQUE, TAB.",1,0,1,0,0,0,
21/12/2016,VER.,"TANTOYUCA, VER.",1,0,1,0,0,0,
22/12/2016,GTO.,"LEON, GTO.",4,5,9,0,0,0,
22/12/2016,B.C.,"TIJUANA, B.C.",2,1,3,0,0,0,
22/12/2016,B.C.,"TIJUANA, B.C.",1,0,1,0,0,0,
22/12/2016,B.C.,"TIJUANA, B.C.",0,1,1,0,0,0,
23/12/2016,D.F.,"CUAUHTEMOC, D.F.",7,0,7,0,0,397,
23/12/2016,GTO.,"LEON, GTO.",4,2,6,0,0,0,
23/12/2016,CHIS.,"PALENQUE, CHIS.",0,1,1,0,0,0,
23/12/2016,TAB.,"TENOSIQUE, TAB.",1,0,1,0,1,0,
23/12/2016,B.C.,"TIJUANA, B.C.",0,1,1,0,0,0,
23/12/2016,B.C.,"MEXICALI, B.C.",1,0,1,0,0,0,
27/12/2016,CHIS.,"PALENQUE, CHIS.",0,1,1,0,0,0,
29/12/2016,B.C.,"TIJUANA, B.C.",9,14,23,0,5,0,
31/12/2016,B.C.,"TIJUANA, B.C.",2,1,3,0,0,0,
01/01/2017,VER.,"TEMPOAL, VER.",1,0,1,0,0,0,
03/01/2017,B.C.,"TIJUANA, B.C.",0,12,12,0,0,0,
04/01/2017,B.C.,"TIJUANA, B.C.",1,0,1,0,3,0,
05/01/2017,DGO.,"GOMEZ PALACIO, DGO.",5,4,9,0,0,0,
06/01/2017,DGO.,"GOMEZ PALACIO, DGO.",6,0,6,0,0,0,
08/01/2017,B.C.,"TIJUANA, B.C.",5,6,11,0,0,0,
08/01/2017,VER.,"TEMPOAL, VER.",1,0,1,0,0,0,
10/01/2017,D.F.,"CUAUHTEMOC, D.F.",5,9,14,0,0,0,
10/01/2017,B.C.,"TIJUANA, B.C.",1,6,7,0,0,0,
10/01/2017,B.C.,"MEXICALI, B.C.",1,0,1,0,0,0,
10/01/2017,B.C.,"ENSENADA, B.C.",0,0,0,0,1,0,
11/01/2017,D.F.,"CUAUHTEMOC, D.F.",1,3,4,0,0,0,
11/01/2017,DGO.,"GOMEZ PALACIO, DGO.",2,1,3,0,0,0,
11/01/2017,B.C.,"MEXICALI, B.C.",1,0,1,0,0,0,
12/01/2017,YUC.,"SUDZAL, YUC.",1,0,1,0,0,0,
12/01/2017,D.F.,"CUAUHTEMOC, D.F.",1,0,1,0,0,0,
12/01/2017,B.C.,"MEXICALI, B.C.",0,1,1,0,0,0,
13/01/2017,D.F.,"CUAUHTEMOC, D.F.",3,0,3,0,0,72,
13/01/2017,B.C.,"MEXICALI, B.C.",0,2,2,0,0,0,
14/01/2017,B.C.,"TIJUANA, B.C.",2,6,8,0,0,0,
14/01/2017,B.C.,"ENSENADA, B.C.",0,2,2,0,0,0,
14/01/2017,TAMPS.,"MATAMOROS, TAMPS.",1,0,1,0,0,0,
17/01/2017,DGO.,"GOMEZ PALACIO, DGO.",6,0,6,0,0,0,
17/01/2017,B.C.,"MEXICALI, B.C.",0,1,1,0,0,0,
17/01/2017,D.F.,"CUAUHTEMOC, D.F.",0,0,0,0,0,1002,
18/01/2017,D.F.,"CUAUHTEMOC, D.F.",2,2,4,0,0,86,
19/01/2017,D.F.,"COYOACAN, D.F.",1,1,2,0,0,0,
19/01/2017,B.C.,"TIJUANA, B.C.",1,0,1,0,0,0,
20/01/2017,D.F.,"CUAUHTEMOC, D.F.",7,2,9,0,3,5,
20/01/2017,DGO.,"SANTIAGO PAPASQUIARO, DGO.",2,0,2,2,0,0,
20/01/2017,PUE.,"PUE., PUE.",0,1,1,0,0,0,
21/01/2017,DGO.,"DGO., DGO.",3,2,5,2,0,0,
21/01/2017,DGO.,"PUEBLO NUEVO, DGO.",1,1,2,0,0,0,
21/01/2017,DGO.,"SANTIAGO PAPASQUIARO, DGO.",1,0,1,1,0,0,
21/01/2017,DGO.,"GOMEZ PALACIO, DGO.",1,0,1,0,0,0,
22/01/2017,DGO.,"SANTIAGO PAPASQUIARO, DGO.",6,3,9,2,0,0,
23/01/2017,DGO.,"SANTIAGO PAPASQUIARO, DGO.",1,3,4,0,0,0,
23/01/2017,ZAC.,"TLALTENANGO DE SANCHEZ ROMAN, ZAC.",1,1,2,1,0,3,
23/01/2017,ZAC.,"JEREZ, ZAC.",2,0,2,0,0,0,
23/01/2017,DGO.,"GOMEZ PALACIO, DGO.",1,0,1,0,0,0,
23/01/2017,B.C.,"ENSENADA, B.C.",1,0,1,0,0,0,
23/01/2017,D.F.,"COYOACAN, D.F.",0,0,0,0,1,0,
24/01/2017,MICH.,"MORELIA, MICH.",9,1,10,5,0,0,
24/01/2017,DGO.,"DGO., DGO.",2,3,5,0,0,11,
24/01/2017,D.F.,"COYOACAN, D.F.",1,0,1,0,0,14,
24/01/2017,COAH.,"MÚZQUIZ, COAH.",0,0,0,0,0,25,
24/01/2017,COAH.,"MÚZQUIZ, COAH.",0,0,0,0,0,25,
24/01/2017,MICH.,"ZAMORA, MICH.",0,0,0,0,0,2000,
25/01/2017,B.C.,"TIJUANA, B.C.",5,0,5,0,0,0,
25/01/2017,B.C.,"TIJUANA, B.C.",5,0,5,0,0,0,
25/01/2017,DGO.,"GOMEZ PALACIO, DGO.",2,1,3,0,0,0,
25/01/2017,D.F.,"COYOACAN, D.F.",2,0,2,0,0,0,
25/01/2017,TAMPS.,"TAMPICO, TAMPS.",1,0,1,1,0,26,
25/01/2017,CAMP.,"ESCÁRCEGA, CAMP.",1,0,1,0,0,0,
25/01/2017,ZAC.,"TLALTENANGO DE SANCHEZ ROMAN, ZAC.",1,0,1,0,0,0,
25/01/2017,ZAC.,"JEREZ, ZAC.",1,0,1,0,0,6,
25/01/2017,ZAC.,"TLALTENANGO DE SANCHEZ ROMAN, ZAC.",1,0,1,0,0,0,
26/01/2017,D.F.,"COYOACAN, D.F.",6,1,7,0,0,18,
26/01/2017,DGO.,"DGO., DGO.",4,1,5,1,0,50,
26/01/2017,ZAC.,"TLALTENANGO DE SANCHEZ ROMAN, ZAC.",1,0,1,0,0,0,
26/01/2017,B.C.,"ENSENADA, B.C.",1,0,1,0,0,0,
26/01/2017,CHIS.,"JUÁREZ, CHIS.",0,1,1,0,0,0,
26/01/2017,COAH.,"SALTILLO, COAH.",1,0,1,0,7,60,
26/01/2017,COAH.,"MONCLOVA, COAH.",1,0,1,0,0,31,
26/01/2017,COAH.,"TORREÓN, COAH.",1,0,1,0,0,0,
26/01/2017,COAH.,"MÚZQUIZ, COAH.",1,0,1,1,0,12,
26/01/2017,COAH.,"TORREÓN, COAH.",1,0,1,0,0,0,
26/01/2017,B.C.,"ENSENADA, B.C.",1,0,1,0,0,0,
27/01/2017,D.F.,"COYOACAN, D.F.",2,0,2,0,0,8,
27/01/2017,ZAC.,"JEREZ, ZAC.",2,0,2,0,0,0,
27/01/2017,DGO.,"DGO., DGO.",1,0,1,30,0,0,
27/01/2017,ZAC.,"TLALTENANGO DE SANCHEZ ROMAN, ZAC.",0,1,1,0,0,0,
27/01/2017,YUC.,"SINANCHE, YUC.",1,0,1,0,0,0,
27/01/2017,ZAC.,"TLALTENANGO DE SANCHEZ ROMAN, ZAC.",0,1,1,0,0,0,
28/01/2017,DGO.,"DGO., DGO.",2,0,2,0,0,0,
28/01/2017,ZAC.,"JEREZ, ZAC.",2,0,2,0,0,0,
28/01/2017,TAMPS.,"MATAMOROS, TAMPS.",1,1,2,0,0,40,
28/01/2017,COAH.,"TORREÓN, COAH.",0,1,1,0,0,0,
29/01/2017,TAMPS.,"MATAMOROS, TAMPS.",3,4,7,0,0,294,
29/01/2017,DGO.,"PUEBLO NUEVO, DGO.",1,0,1,0,0,0,
29/01/2017,MICH.,"MORELIA, MICH.",0,1,1,0,3,329,
29/01/2017,TAMPS.,"TAMPICO, TAMPS.",1,0,1,0,0,39,
29/01/2017,CAMP.,"ESCÁRCEGA, CAMP.",1,0,1,0,0,0,
29/01/2017,TAMPS.,"NUEVO LAREDO, TAMPS.",0,0,0,0,0,9,
30/01/2017,D.F.,"COYOACAN, D.F.",1,2,3,0,1,18,
30/01/2017,MICH.,"MORELIA, MICH.",1,2,3,0,6,3280,
30/01/2017,DGO.,"SANTIAGO PAPASQUIARO, DGO.",1,1,2,4,0,0,
30/01/2017,COAH.,"MÚZQUIZ, COAH.",0,1,1,0,0,0,
30/01/2017,SIN.,"MAZATLAN, SIN.",1,0,1,0,0,0,
30/01/2017,B.C.,"TIJUANA, B.C.",0,0,0,0,1,0,
30/01/2017,B.C.,"ENSENADA, B.C.",0,0,0,0,1,0,
31/01/2017,D.F.,"COYOACAN, D.F.",6,0,6,0,0,334,
31/01/2017,GRO.,"COAHUAYUTLA DE JOSE MARIA IZAZAGA, GRO.",1,3,4,0,0,6,
31/01/2017,COAH.,"TORREÓN, COAH.",2,1,3,0,0,52,
31/01/2017,DGO.,"DGO., DGO.",2,1,3,0,8,4,
31/01/2017,COAH.,"SALTILLO, COAH.",1,0,1,6,0,225,
31/01/2017,B.C.,"ENSENADA, B.C.",1,0,1,0,0,0,
31/01/2017,TAMPS.,"NUEVO LAREDO, TAMPS.",1,0,1,0,0,0,
31/01/2017,CHIH.,"GUADALUPE, CHIH.",0,1,1,0,0,0,
01/02/2017,D.F.,"COYOACAN, D.F.",5,1,6,0,0,154,
01/02/2017,SIN.,"MAZATLAN, SIN.",4,2,6,0,20,0,
01/02/2017,GRO.,"COAHUAYUTLA DE JOSE MARIA IZAZAGA, GRO.",1,3,4,0,0,6,
01/02/2017,TAMPS.,"TAMPICO, TAMPS.",2,1,3,0,0,317,
01/02/2017,DGO.,"SANTIAGO PAPASQUIARO, DGO.",1,0,1,1,0,0,
01/02/2017,CHIH.,"GUADALUPE, CHIH.",0,1,1,0,0,0,
01/02/2017,COAH.,"FRANCISCO I. MADERO, COAH.",1,0,1,0,0,0,
01/02/2017,COAH.,"PIEDRAS NEGRAS, COAH.",0,1,1,0,0,0,
02/02/2017,DGO.,"DGO., DGO.",6,0,6,2,0,0,
02/02/2017,GRO.,"COAHUAYUTLA DE JOSE MARIA IZAZAGA, GRO.",0,2,2,0,0,0,
02/02/2017,D.F.,"COYOACAN, D.F.",2,0,2,0,0,0,
02/02/2017,COAH.,"MONCLOVA, COAH.",2,0,2,0,0,0,
02/02/2017,DGO.,"GOMEZ PALACIO, DGO.",1,0,1,0,0,0,
02/02/2017,COAH.,"SALTILLO, COAH.",1,0,1,0,0,408,
03/02/2017,OAX.,"PINOTEPA DE DON LUIS, OAX.",3,2,5,1,0,0,
03/02/2017,OAX.,"PINOTEPA DE DON LUIS, OAX.",3,2,5,1,0,0,
03/02/2017,DGO.,"DGO., DGO.",3,0,3,0,1,155,
03/02/2017,MICH.,"LAZARO CARDENAS, MICH.",1,1,2,0,0,0,
03/02/2017,D.F.,"COYOACAN, D.F.",1,0,1,0,0,0,
03/02/2017,GRO.,"COAHUAYUTLA DE JOSE MARIA IZAZAGA, GRO.",0,1,1,0,0,0,
04/02/2017,TAMPS.,"MATAMOROS, TAMPS.",2,1,3,8,0,260,
04/02/2017,DGO.,"PUEBLO NUEVO, DGO.",2,0,2,1,0,26,
04/02/2017,COAH.,"MATAMOROS, COAH.",1,0,1,0,0,0,
04/02/2017,COAH.,"MATAMOROS, COAH.",1,0,1,0,0,0,
05/02/2017,TAMPS.,"MATAMOROS, TAMPS.",3,1,4,0,0,30,
05/02/2017,TAMPS.,"ALTAMIRA, TAMPS.",0,0,0,0,0,9,
06/02/2017,DGO.,"DGO., DGO.",2,1,3,3,0,0,
06/02/2017,SIN.,"MAZATLAN, SIN.",1,0,1,0,0,0,
07/02/2017,MICH.,"LAZARO CARDENAS, MICH.",3,2,5,1,0,0,
07/02/2017,SIN.,"MAZATLAN, SIN.",2,2,4,0,4,0,
07/02/2017,COAH.,"TORREÓN, COAH.",1,0,1,0,0,0,
07/02/2017,COAH.,"SALTILLO, COAH.",0,0,0,0,0,46,
08/02/2017,SIN.,"MAZATLAN, SIN.",4,0,4,0,8,0,
08/02/2017,MICH.,"LAZARO CARDENAS, MICH.",3,1,4,1,0,0,
08/02/2017,SIN.,"MAZATLAN, SIN.",3,0,3,0,5,0,
08/02/2017,DGO.,"DGO., DGO.",3,0,3,1,0,0,
08/02/2017,COAH.,"FRANCISCO I. MADERO, COAH.",2,0,2,0,0,0,
08/02/2017,DGO.,"GOMEZ PALACIO, DGO.",2,0,2,0,0,0,
08/02/2017,COAH.,"FRANCISCO I. MADERO, COAH.",2,0,2,0,0,0,
08/02/2017,COAH.,"TORREÓN, COAH.",1,0,1,0,0,0,
08/02/2017,COAH.,"MATAMOROS, COAH.",1,0,1,0,0,0,
08/02/2017,COAH.,"SALTILLO, COAH.",1,0,1,0,0,12,
08/02/2017,COAH.,"PIEDRAS NEGRAS, COAH.",1,0,1,0,0,0,
08/02/2017,VER.,"TUXPAM, VER.",1,0,1,0,0,0,
08/02/2017,CHIS.,"PALENQUE, CHIS.",1,0,1,0,0,0,
08/02/2017,COAH.,"TORREÓN, COAH.",1,0,1,0,0,0,
08/02/2017,COAH.,"MATAMOROS, COAH.",1,0,1,0,0,0,
08/02/2017,PUE.,"PUE., PUE.",0,0,0,0,0,8,
09/02/2017,D.F.,"TLAHUAC, D.F.",19,2,21,0,0,120,
09/02/2017,COAH.,"PIEDRAS NEGRAS, COAH.",1,4,5,0,0,0,
09/02/2017,DGO.,"DGO., DGO.",2,0,2,0,1,0,
09/02/2017,CHIH.,"ALDAMA, CHIH.",1,1,2,0,0,0,
09/02/2017,GRO.,"ATOYAC DE ALVAREZ, GRO.",1,0,1,0,3,0,
09/02/2017,CHIS.,"JUÁREZ, CHIS.",0,1,1,0,0,0,
09/02/2017,COAH.,"SALTILLO, COAH.",0,0,0,7,0,71,
09/02/2017,COAH.,"RAMOS ARIZPE, COAH.",0,0,0,3,4,200,
10/02/2017,SIN.,"MAZATLAN, SIN.",3,0,3,0,10,0,
10/02/2017,SIN.,"CULIACAN, SIN.",1,1,2,0,4,0,
10/02/2017,PUE.,"ATLIXCO, PUE.",1,0,1,0,0,0,
10/02/2017,COAH.,"FRANCISCO I. MADERO, COAH.",1,0,1,0,0,0,
10/02/2017,MICH.,"LAZARO CARDENAS, MICH.",1,0,1,0,0,0,
10/02/2017,B.C.S.,"LOS CABOS, B.C.S.",1,0,1,0,0,0,
10/02/2017,COAH.,"FRANCISCO I. MADERO, COAH.",1,0,1,0,0,0,
10/02/2017,COAH.,"MONCLOVA, COAH.",0,1,1,0,0,0,
10/02/2017,GRO.,"ATOYAC DE ALVAREZ, GRO.",0,0,0,0,2,0,
11/02/2017,TAMPS.,"MATAMOROS, TAMPS.",1,1,2,2,0,220,
11/02/2017,COAH.,"MONCLOVA, COAH.",0,2,2,0,0,0,
11/02/2017,B.C.,"MEXICALI, B.C.",1,0,1,0,0,0,
11/02/2017,B.C.S.,"LOS CABOS, B.C.S.",1,0,1,0,0,0,
12/02/2017,MICH.,"LAZARO CARDENAS, MICH.",2,0,2,0,0,0,
12/02/2017,B.C.,"MEXICALI, B.C.",0,1,1,0,0,0,
13/02/2017,D.F.,"TLAHUAC, D.F.",9,1,10,0,0,6,
13/02/2017,SIN.,"MAZATLAN, SIN.",2,1,3,0,4,0,
13/02/2017,B.C.,"MEXICALI, B.C.",0,2,2,0,0,0,
13/02/2017,MICH.,"LAZARO CARDENAS, MICH.",1,0,1,0,0,0,
13/02/2017,GRO.,"COAHUAYUTLA DE JOSE MARIA IZAZAGA, GRO.",0,1,1,0,0,0,
13/02/2017,GRO.,"ACAPULCO DE JUAREZ, GRO.",1,0,1,0,8,37,
13/02/2017,DGO.,"DGO., DGO.",1,0,1,8,0,109,
13/02/2017,MICH.,"TACAMBARO, MICH.",0,1,1,0,0,883,
14/02/2017,B.C.,"TIJUANA, B.C.",2,6,8,0,0,0,
14/02/2017,B.C.,"ENSENADA, B.C.",0,2,2,0,0,0,
14/02/2017,DGO.,"GOMEZ PALACIO, DGO.",2,0,2,0,0,0,
14/02/2017,COAH.,"TORREÓN, COAH.",0,1,1,0,0,0,
14/02/2017,GRO.,"COAHUAYUTLA DE JOSE MARIA IZAZAGA, GRO.",1,0,1,0,0,0,
14/02/2017,GRO.,"ACAPULCO DE JUAREZ, GRO.",0,1,1,0,1,325,
14/02/2017,VER.,"COATZACOALCOS, VER.",1,0,1,0,0,4,
14/02/2017,TAMPS.,"NUEVO LAREDO, TAMPS.",1,0,1,2,0,53,
14/02/2017,SIN.,"CULIACAN, SIN.",0,1,1,0,4,0,
14/02/2017,COAH.,"TORREÓN, COAH.",0,1,1,0,0,0,
14/02/2017,COAH.,"SALTILLO, COAH.",1,0,1,2,0,140,
14/02/2017,D.F.,"TLAHUAC, D.F.",1,0,1,0,0,162,
14/02/2017,CHIH.,"GUADALUPE, CHIH.",0,1,1,0,0,0,
14/02/2017,MICH.,"LAZARO CARDENAS, MICH.",1,0,1,0,0,62,
14/02/2017,TAMPS.,"TAMPICO, TAMPS.",0,0,0,0,0,23,
14/02/2017,SIN.,"MAZATLAN, SIN.",0,0,0,0,4,0,
15/02/2017,GRO.,"ACAPULCO DE JUAREZ, GRO.",1,2,3,0,6,0,
15/02/2017,CHIH.,"GUADALUPE, CHIH.",2,0,2,4,0,295,
15/02/2017,COAH.,"TORREÓN, COAH.",2,0,2,0,0,0,
15/02/2017,DGO.,"DGO., DGO.",1,1,2,0,10,43,
15/02/2017,D.F.,"TLAHUAC, D.F.",0,1,1,0,0,0,
15/02/2017,COAH.,"PIEDRAS NEGRAS, COAH.",1,0,1,0,0,0,
15/02/2017,CHIH.,"NUEVO CASAS GRANDES, CHIH.",0,0,0,0,0,63,
15/02/2017,SIN.,"CULIACAN, SIN.",0,0,0,0,4,0,
15/02/2017,SIN.,"MAZATLAN, SIN.",0,0,0,0,2,0,
16/02/2017,CHIH.,"NUEVO CASAS GRANDES, CHIH.",3,0,3,1,0,239,
16/02/2017,MICH.,"TACAMBARO, MICH.",1,2,3,0,0,73,
16/02/2017,SIN.,"CULIACAN, SIN.",1,1,2,0,13,0,
16/02/2017,SIN.,"MAZATLAN, SIN.",1,1,2,0,3,0,
16/02/2017,B.C.,"MEXICALI, B.C.",1,0,1,0,0,0,
16/02/2017,COAH.,"MONCLOVA, COAH.",1,0,1,1,0,0,
16/02/2017,DGO.,"DGO., DGO.",1,0,1,0,0,0,
16/02/2017,VER.,"COATZACOALCOS, VER.",1,0,1,0,0,0,
16/02/2017,GRO.,"COAHUAYUTLA DE JOSE MARIA IZAZAGA, GRO.",0,1,1,0,0,0,
16/02/2017,TAMPS.,"NUEVO LAREDO, TAMPS.",0,0,0,1,0,440,
17/02/2017,TAMPS.,"MATAMOROS, TAMPS.",1,4,5,1,0,406,
17/02/2017,D.F.,"TLAHUAC, D.F.",2,1,3,0,0,71,
17/02/2017,CHIH.,"GUADALUPE, CHIH.",1,1,2,0,0,70,
17/02/2017,GRO.,"COAHUAYUTLA DE JOSE MARIA IZAZAGA, GRO.",1,1,2,0,0,0,
17/02/2017,MICH.,"LAZARO CARDENAS, MICH.",1,0,1,2,0,0,
17/02/2017,B.C.,"MEXICALI, B.C.",0,1,1,0,0,0,
17/02/2017,CHIH.,"NAMIQUIPA, CHIH.",0,0,0,0,0,25,
17/02/2017,TAMPS.,"NUEVO LAREDO, TAMPS.",0,0,0,9,0,398,
17/02/2017,SIN.,"CULIACAN, SIN.",0,0,0,0,14,0,
18/02/2017,D.F.,"TLAHUAC, D.F.",3,1,4,0,0,119,
18/02/2017,COAH.,"FRANCISCO I. MADERO, COAH.",1,1,2,0,0,0,
18/02/2017,COAH.,"SAN PEDRO, COAH.",0,1,1,0,0,0,
18/02/2017,COAH.,"SALTILLO, COAH.",1,0,1,0,0,0,
18/02/2017,TAB.,"CENTRO, TAB.",1,0,1,0,0,0,
18/02/2017,MICH.,"LAZARO CARDENAS, MICH.",0,0,0,0,0,79,
19/02/2017,B.C.,"TIJUANA, B.C.",1,0,1,0,0,0,
20/02/2017,VER.,"MOLOACAN, VER.",3,1,4,0,0,0,
20/02/2017,COAH.,"MATAMOROS, COAH.",3,1,4,0,0,0,
20/02/2017,COAH.,"MATAMOROS, COAH.",3,1,4,0,0,0,
20/02/2017,GRO.,"COYUCA DE BENITEZ, GRO.",1,1,2,0,0,0,
20/02/2017,ZAC.,"MOMAX, ZAC.",1,0,1,0,0,0,
20/02/2017,GRO.,"COYUCA DE BENITEZ, GRO.",1,0,1,0,0,0,
20/02/2017,D.F.,"IZTACALCO, D.F.",1,0,1,0,0,0,
20/02/2017,GRO.,"LA UNION DE ISIDORO MONTES DE OCA, GRO.",0,1,1,0,0,0,
20/02/2017,ZAC.,"TEPECHITLAN, ZAC.",1,0,1,0,0,0,
20/02/2017,ZAC.,"MOMAX, ZAC.",1,0,1,0,0,0,
20/02/2017,DGO.,"GOMEZ PALACIO, DGO.",1,0,1,0,0,0,
20/02/2017,Q. ROO,"COZUMEL, Q. ROO",0,0,0,0,0,118,
21/02/2017,TAMPS.,"NUEVO LAREDO, TAMPS.",2,4,6,0,0,0,
21/02/2017,COAH.,"PIEDRAS NEGRAS, COAH.",4,1,5,0,0,84,
21/02/2017,SIN.,"MAZATLAN, SIN.",4,0,4,0,0,0,
21/02/2017,SIN.,"CULIACAN, SIN.",1,1,2,0,17,0,
21/02/2017,VER.,"POZA RICA DE HGO., VER.",1,1,2,0,0,0,
21/02/2017,CHIH.,"NUEVO CASAS GRANDES, CHIH.",1,0,1,1,1,18,
21/02/2017,MICH.,"LAZARO CARDENAS, MICH.",1,0,1,0,0,0,
21/02/2017,Q. ROO,"COZUMEL, Q. ROO",0,0,0,0,0,2,
21/02/2017,TAMPS.,"TAMPICO, TAMPS.",0,0,0,1,0,296,
22/02/2017,COAH.,"TORREÓN, COAH.",0,2,2,0,0,0,
22/02/2017,COAH.,"TORREÓN, COAH.",0,1,1,0,0,0,
22/02/2017,SIN.,"CULIACAN, SIN.",1,0,1,1,0,0,
22/02/2017,SIN.,"MAZATLAN, SIN.",1,0,1,0,0,0,
22/02/2017,YUC.,"MOTUL, YUC.",1,0,1,0,0,0,
22/02/2017,VER.,"SAN RAFAEL, VER.",1,0,1,0,0,0,
22/02/2017,VER.,"POZA RICA DE HGO., VER.",0,1,1,0,0,164,
22/02/2017,YUC.,"MOTUL, YUC.",1,0,1,0,0,0,
22/02/2017,D.F.,"ALVARO OBREGON, D.F.",0,1,1,0,0,0,
22/02/2017,Q. ROO,"COZUMEL, Q. ROO",0,0,0,0,0,72,
23/02/2017,D.F.,"IZTAPALAPA, D.F.",5,0,5,0,0,0,
23/02/2017,TAMPS.,"NUEVO LAREDO, TAMPS.",4,0,4,8,0,157,
23/02/2017,VER.,"SAN ANDRES TUXTLA, VER.",1,2,3,0,0,0,
23/02/2017,CHIH.,"NUEVO CASAS GRANDES, CHIH.",1,1,2,0,0,130,
23/02/2017,D.F.,"ALVARO OBREGON, D.F.",1,0,1,0,0,0,
23/02/2017,B.C.,"ENSENADA, B.C.",1,0,1,0,0,0,
23/02/2017,CHIH.,"GUADALUPE, CHIH.",0,1,1,0,0,11,
23/02/2017,MICH.,"LAZARO CARDENAS, MICH.",1,0,1,0,0,0,
23/02/2017,COAH.,"TORREÓN, COAH.",0,0,0,9,0,0,
23/02/2017,VER.,"POZA RICA DE HGO., VER.",0,0,0,0,0,46,
23/02/2017,GRO.,"ACAPULCO DE JUAREZ, GRO.",0,0,0,0,5,0,
23/02/2017,Q. ROO,"COZUMEL, Q. ROO",0,0,0,0,0,7,
23/02/2017,Q. ROO,"COZUMEL, Q. ROO",0,0,0,0,0,148,
24/02/2017,SIN.,"CULIACAN, SIN.",3,0,3,0,0,0,
24/02/2017,SIN.,"MAZATLAN, SIN.",2,1,3,0,0,0,
24/02/2017,VER.,"POZA RICA DE HGO., VER.",2,0,2,0,0,47,
24/02/2017,GRO.,"LA UNION DE ISIDORO MONTES DE OCA, GRO.",1,1,2,0,0,0,
24/02/2017,CHIH.,"GUACHOCHI, CHIH.",0,1,1,0,0,0,
24/02/2017,D.F.,"IZTAPALAPA, D.F.",1,0,1,0,0,0,
24/02/2017,DGO.,"GOMEZ PALACIO, DGO.",0,1,1,0,0,0,
24/02/2017,COAH.,"SALTILLO, COAH.",1,0,1,0,0,0,
24/02/2017,JAL.,"PUERTO VALLARTA, JAL.",0,1,1,0,0,0,
24/02/2017,COAH.,"TORREÓN, COAH.",0,0,0,9,0,0,
25/02/2017,COAH.,"PIEDRAS NEGRAS, COAH.",0,5,5,20,0,0,
25/02/2017,TAMPS.,"MATAMOROS, TAMPS.",2,0,2,3,0,1146,
27/02/2017,PUE.,"PUE., PUE.",6,3,9,4,0,467,
27/02/2017,D.F.,"IZTAPALAPA, D.F.",1,1,2,0,0,0,
27/02/2017,VER.,"POZA RICA DE HGO., VER.",1,1,2,0,0,118,
27/02/2017,ZAC.,"JALPA, ZAC.",1,0,1,0,0,71,
27/02/2017,VER.,"COATZACOALCOS, VER.",1,0,1,0,0,0,
28/02/2017,ZAC.,"CAÑITAS DE FELIPE PESCADOR, ZAC.",3,0,3,1,0,0,
28/02/2017,TAMPS.,"NUEVO LAREDO, TAMPS.",2,1,3,0,0,10,
28/02/2017,OAX.,"MIAHUATLAN DE PORFIRIO DIAZ, OAX.",0,2,2,0,0,0,
28/02/2017,COAH.,"SALTILLO, COAH.",2,0,2,0,0,0,
28/02/2017,COAH.,"PIEDRAS NEGRAS, COAH.",1,1,2,1,0,150,
28/02/2017,COAH.,"MATAMOROS, COAH.",1,0,1,0,0,0,
28/02/2017,CHIH.,"NUEVO CASAS GRANDES, CHIH.",0,0,0,0,0,33,
28/02/2017,OAX.,"MIAHUATLAN DE PORFIRIO DIAZ, OAX.",0,0,0,12,0,13,
01/03/2017,PUE.,"PUE., PUE.",6,0,6,0,0,0,
01/03/2017,TAMPS.,"NUEVO LAREDO, TAMPS.",5,0,5,1,0,204,
01/03/2017,COAH.,"TORREÓN, COAH.",2,1,3,0,0,0,
01/03/2017,COAH.,"TORREÓN, COAH.",2,1,3,0,0,0,
01/03/2017,PUE.,"PUE., PUE.",0,1,1,0,0,0,
02/03/2017,D.F.,"IZTAPALAPA, D.F.",1,0,1,0,0,0,
02/03/2017,VER.,"COSOLEACAQUE, VER.",0,0,0,0,0,6,
02/03/2017,CHIH.,"NUEVO CASAS GRANDES, CHIH.",0,0,0,0,0,28,
02/03/2017,CHIH.,"NUEVO CASAS GRANDES, CHIH.",0,0,0,0,0,28,
03/03/2017,TAMPS.,"MATAMOROS, TAMPS.",9,8,17,12,0,1148,
03/03/2017,TAMPS.,"NUEVO LAREDO, TAMPS.",3,2,5,2,0,26,
03/03/2017,PUE.,"IZUCAR DE MATAMOROS, PUE.",3,0,3,0,0,0,
03/03/2017,TAB.,"NACAJUCA, TAB.",1,0,1,0,0,5,
03/03/2017,OAX.,"SAN JUAN BAUTISTA TUXTEPEC, OAX.",1,0,1,0,0,0,
03/03/2017,VER.,"FORTIN, VER.",1,0,1,0,0,34,
03/03/2017,TAMPS.,"NUEVO LAREDO, TAMPS.",1,0,1,1,0,56,
03/03/2017,CHIH.,"HGO. DEL PARRAL, CHIH.",1,0,1,0,0,0,
03/03/2017,TAMPS.,"ALTAMIRA, TAMPS.",0,0,0,2,0,66,
03/03/2017,VER.,"FORTIN, VER.",0,0,0,0,0,12,
04/03/2017,TAMPS.,"MATAMOROS, TAMPS.",2,4,6,5,0,234,
04/03/2017,COAH.,"PIEDRAS NEGRAS, COAH.",1,0,1,0,0,105,
06/03/2017,TAMPS.,"NUEVO LAREDO, TAMPS.",1,2,3,1,0,406,
06/03/2017,HGO.,"TULANCINGO DE BRAVO, HGO.",1,0,1,0,0,0,
06/03/2017,OAX.,"MIAHUATLAN DE PORFIRIO DIAZ, OAX.",0,0,0,0,0,80,
07/03/2017,CHIH.,"HGO. DEL PARRAL, CHIH.",9,1,10,4,0,224,
07/03/2017,MEX.,"TLALNEPANTLA DE BAZ, MEX.",3,3,6,1,0,47,
07/03/2017,D.F.,"IZTAPALAPA, D.F.",1,1,2,0,0,0,
07/03/2017,ZAC.,"GENERAL FRANCISCO R. MURGUIA, ZAC.",0,2,2,0,0,20,
07/03/2017,VER.,"COSOLEACAQUE, VER.",2,0,2,0,0,51,
07/03/2017,MEX.,"CHALCO, MEX.",1,1,2,0,0,14,
07/03/2017,COAH.,"SALTILLO, COAH.",0,2,2,0,1,0,
07/03/2017,COAH.,"TORREÓN, COAH.",1,0,1,0,0,0,
07/03/2017,COAH.,"MATAMOROS, COAH.",1,0,1,1,0,16,
07/03/2017,COAH.,"MÚZQUIZ, COAH.",1,0,1,1,0,4,
07/03/2017,CHIH.,"NUEVO CASAS GRANDES, CHIH.",0,0,0,0,0,245,
07/03/2017,MEX.,"TOLUCA, MEX.",0,0,0,0,0,132,
07/03/2017,COAH.,"MATAMOROS, COAH.",0,0,0,5,0,52,
07/03/2017,TAMPS.,"NUEVO LAREDO, TAMPS.",0,0,0,0,0,120,
07/03/2017,TAMPS.,"TAMPICO, TAMPS.",0,0,0,0,0,44,
08/03/2017,MEX.,"TOLUCA, MEX.",4,1,5,0,0,0,
08/03/2017,D.F.,"IZTAPALAPA, D.F.",4,0,4,0,2,0,
08/03/2017,MEX.,"TLALNEPANTLA DE BAZ, MEX.",3,1,4,1,0,51,
08/03/2017,MEX.,"SAN FELIPE DEL PROGRESO, MEX.",3,1,4,0,0,0,
08/03/2017,MEX.,"VALLE DE CHALCO SOLIDARIDAD, MEX.",3,0,3,0,0,0,
08/03/2017,VER.,"COSOLEACAQUE, VER.",1,1,2,0,0,84,
08/03/2017,HGO.,"TULANCINGO DE BRAVO, HGO.",0,1,1,0,0,0,
08/03/2017,GRO.,"PUNGARABATO, GRO.",1,0,1,0,0,0,
08/03/2017,MICH.,"LAZARO CARDENAS, MICH.",1,0,1,0,0,0,
08/03/2017,COAH.,"MATAMOROS, COAH.",0,0,0,5,0,52,
09/03/2017,TAMPS.,"NUEVO LAREDO, TAMPS.",3,2,5,0,0,127,
09/03/2017,MEX.,"VALLE DE CHALCO SOLIDARIDAD, MEX.",3,0,3,0,0,0,
09/03/2017,TAMPS.,"NUEVO LAREDO, TAMPS.",2,0,2,1,0,370,
09/03/2017,D.F.,"IZTAPALAPA, D.F.",1,0,1,0,0,0,
09/03/2017,COAH.,"PIEDRAS NEGRAS, COAH.",1,0,1,1,0,0,
09/03/2017,VER.,"COSOLEACAQUE, VER.",1,0,1,0,0,302,
09/03/2017,OAX.,"OAX. DE JUAREZ, OAX.",1,0,1,0,0,0,
09/03/2017,OAX.,"MIAHUATLAN DE PORFIRIO DIAZ, OAX.",0,1,1,0,0,5,
09/03/2017,D.F.,"IZTACALCO, D.F.",1,0,1,0,0,0,
09/03/2017,TAMPS.,"EL MANTE, TAMPS.",1,0,1,0,0,0,
09/03/2017,CHIH.,"NUEVO CASAS GRANDES, CHIH.",0,0,0,0,0,490,
09/03/2017,MICH.,"ZITACUARO, MICH.",0,0,0,0,0,2542,
10/03/2017,CHIH.,"HGO. DEL PARRAL, CHIH.",12,5,17,11,0,1130,
10/03/2017,MEX.,"TOLUCA, MEX.",4,3,7,1,1,44,
10/03/2017,N.L.,"MONTERREY, N.L.",2,2,4,0,0,46,
10/03/2017,MEX.,"TLALNEPANTLA DE BAZ, MEX.",3,1,4,1,0,15,
10/03/2017,OAX.,"MIAHUATLAN DE PORFIRIO DIAZ, OAX.",0,3,3,0,0,0,
10/03/2017,D.F.,"IZTAPALAPA, D.F.",1,1,2,0,0,0,
10/03/2017,MEX.,"CHALCO, MEX.",2,0,2,0,0,0,
10/03/2017,COAH.,"FRANCISCO I. MADERO, COAH.",1,0,1,0,0,0,
10/03/2017,MEX.,"SAN FELIPE DEL PROGRESO, MEX.",1,0,1,0,0,0,
10/03/2017,VER.,"COSOLEACAQUE, VER.",1,0,1,0,0,604,
10/03/2017,HGO.,"ZIMAPAN, HGO.",0,0,0,0,0,210,
10/03/2017,OAX.,"PINOTEPA DE DON LUIS, OAX.",0,0,0,4,0,17,
10/03/2017,COAH.,"ACUÑA, COAH.",0,0,0,4,0,62,
11/03/2017,MEX.,"TLALNEPANTLA DE BAZ, MEX.",3,4,7,1,0,0,
11/03/2017,MEX.,"TOLUCA, MEX.",3,2,5,2,0,343,
11/03/2017,CHIH.,"HGO. DEL PARRAL, CHIH.",3,2,5,9,0,1662,
11/03/2017,N.L.,"MONTERREY, N.L.",1,3,4,0,0,0,
11/03/2017,TAMPS.,"MATAMOROS, TAMPS.",2,1,3,5,0,50,
11/03/2017,COAH.,"SALTILLO, COAH.",1,1,2,0,0,0,
11/03/2017,MEX.,"VALLE DE CHALCO SOLIDARIDAD, MEX.",1,1,2,0,0,0,
11/03/2017,PUE.,"PUE., PUE.",1,0,1,0,0,0,
11/03/2017,COAH.,"FRANCISCO I. MADERO, COAH.",1,0,1,0,0,0,
11/03/2017,JAL.,"CIHUATLAN, JAL.",1,0,1,0,0,0,
11/03/2017,QRO.,"QUERETARO, QRO.",0,1,1,0,0,0,
11/03/2017,VER.,"COSOLEACAQUE, VER.",0,0,0,0,0,349,
11/03/2017,OAX.,"PINOTEPA DE DON LUIS, OAX.",0,0,0,2,0,0,
11/03/2017,COAH.,"SAN PEDRO, COAH.",0,0,0,1,0,3491,
12/03/2017,MEX.,"TOLUCA, MEX.",3,0,3,2,0,12,
12/03/2017,MEX.,"TLALNEPANTLA DE BAZ, MEX.",0,3,3,0,0,0,
12/03/2017,QRO.,"QUERETARO, QRO.",3,0,3,0,0,0,
12/03/2017,MEX.,"SAN FELIPE DEL PROGRESO, MEX.",1,0,1,0,0,0,
12/03/2017,N.L.,"MONTERREY, N.L.",0,0,0,0,0,360,
13/03/2017,DGO.,"DGO., DGO.",3,2,5,3,1,0,
13/03/2017,TAMPS.,"NUEVO LAREDO, TAMPS.",1,2,3,2,0,427,
13/03/2017,QRO.,"QUERETARO, QRO.",1,1,2,0,0,103,
13/03/2017,CHIH.,"HGO. DEL PARRAL, CHIH.",2,0,2,0,0,0,
13/03/2017,N.L.,"MONTERREY, N.L.",0,2,2,0,0,0,
13/03/2017,VER.,"COSOLEACAQUE, VER.",1,0,1,0,0,77,
13/03/2017,MICH.,"TACAMBARO, MICH.",1,0,1,1,0,7,
13/03/2017,OAX.,"CIUDAD IXTEPEC, OAX.",1,0,1,0,0,0,
13/03/2017,HGO.,"ZIMAPAN, HGO.",0,0,0,0,0,600,
13/03/2017,TAMPS.,"SAN FERNANDO, TAMPS.",0,0,0,2,0,20,
13/03/2017,D.F.,"IZTACALCO, D.F.",0,0,0,0,1,0,
14/03/2017,QRO.,"QUERETARO, QRO.",1,8,9,0,1,0,
14/03/2017,VER.,"VER., VER.",7,1,8,0,0,0,
14/03/2017,MEX.,"ECATEPEC DE MOR., MEX.",5,2,7,0,1,64,
14/03/2017,DGO.,"CANATLAN, DGO.",2,3,5,0,0,0,
14/03/2017,QRO.,"SAN JUAN DEL RIO, QRO.",4,1,5,0,0,0,
14/03/2017,MEX.,"TEMOAYA, MEX.",0,4,4,0,0,0,
14/03/2017,MEX.,"IXTLAHUACA, MEX.",2,0,2,1,0,0,
14/03/2017,HGO.,"TULANCINGO DE BRAVO, HGO.",1,0,1,0,1,0,
14/03/2017,MEX.,"VALLE DE CHALCO SOLIDARIDAD, MEX.",1,0,1,0,0,0,
14/03/2017,VER.,"COSOLEACAQUE, VER.",1,0,1,2,0,68,
14/03/2017,MICH.,"TACAMBARO, MICH.",1,0,1,0,0,390,
14/03/2017,COAH.,"ACUÑA, COAH.",0,1,1,0,0,0,
14/03/2017,OAX.,"CIUDAD IXTEPEC, OAX.",1,0,1,0,0,0,
14/03/2017,CHIH.,"HGO. DEL PARRAL, CHIH.",1,0,1,0,0,24,
14/03/2017,D.F.,"IZTAPALAPA, D.F.",0,0,0,0,3,0,
14/03/2017,VER.,"CORDOBA, VER.",0,0,0,0,0,41,
14/03/2017,N.L.,"MONTERREY, N.L.",0,0,0,0,0,38,
14/03/2017,N.L.,"SALINAS VICTORIA, N.L.",0,0,0,1,0,67,
14/03/2017,MEX.,"IXTLAHUACA, MEX.",0,0,0,0,2,1407,
14/03/2017,MEX.,"TEMOAYA, MEX.",0,0,0,0,0,90,
14/03/2017,MEX.,"VALLE DE CHALCO SOLIDARIDAD, MEX.",0,0,0,0,0,83,
15/03/2017,TAMPS.,"NUEVO LAREDO, TAMPS.",6,3,9,0,0,244,
15/03/2017,QRO.,"QUERETARO, QRO.",0,5,5,0,0,0,
15/03/2017,QRO.,"SAN JUAN DEL RIO, QRO.",2,2,4,38,0,0,
15/03/2017,DGO.,"DGO., DGO.",1,1,2,1,0,0,
15/03/2017,VER.,"COSOLEACAQUE, VER.",1,1,2,0,0,318,
15/03/2017,OAX.,"PINOTEPA DE DON LUIS, OAX.",1,0,1,4,0,0,
15/03/2017,CHIH.,"HGO. DEL PARRAL, CHIH.",1,0,1,1,0,145,
15/03/2017,TAMPS.,"TAMPICO, TAMPS.",1,0,1,1,0,68,
15/03/2017,D.F.,"IZTAPALAPA, D.F.",1,0,1,0,0,6500,
15/03/2017,HGO.,"ZIMAPAN, HGO.",1,0,1,0,0,0,
15/03/2017,COAH.,"TORREÓN, COAH.",1,0,1,0,0,0,
15/03/2017,MEX.,"ECATEPEC DE MOR., MEX.",0,0,0,0,0,161,
16/03/2017,TAMPS.,"NUEVO LAREDO, TAMPS.",7,7,14,1,0,626,
16/03/2017,VER.,"VER., VER.",7,3,10,0,0,0,
16/03/2017,QRO.,"QUERETARO, QRO.",3,4,7,0,0,0,
16/03/2017,DGO.,"CANATLAN, DGO.",2,1,3,0,0,0,
16/03/2017,D.F.,"IZTAPALAPA, D.F.",1,2,3,0,0,0,
16/03/2017,CHIH.,"HGO. DEL PARRAL, CHIH.",2,1,3,0,0,19,
16/03/2017,DGO.,"GOMEZ PALACIO, DGO.",2,0,2,0,0,0,
16/03/2017,OAX.,"SAN JUAN BAUTISTA TUXTEPEC, OAX.",0,1,1,0,0,0,
16/03/2017,OAX.,"CIUDAD IXTEPEC, OAX.",1,0,1,0,0,0,
16/03/2017,COAH.,"TORREÓN, COAH.",1,0,1,0,0,0,
16/03/2017,COAH.,"TORREÓN, COAH.",1,0,1,0,0,0,
16/03/2017,N.L.,"MONTERREY, N.L.",0,1,1,3,0,60,
16/03/2017,N.L.,"SALINAS VICTORIA, N.L.",0,1,1,3,0,300,
16/03/2017,GRO.,"PUNGARABATO, GRO.",0,1,1,0,0,0,
16/03/2017,COAH.,"TORREÓN, COAH.",1,0,1,0,0,0,
16/03/2017,COAH.,"MONCLOVA, COAH.",1,0,1,0,0,0,
16/03/2017,QRO.,"SAN JUAN DEL RIO, QRO.",1,0,1,0,0,0,
16/03/2017,TAMPS.,"NUEVO LAREDO, TAMPS.",0,0,0,0,0,12,
16/03/2017,OAX.,"MIAHUATLAN DE PORFIRIO DIAZ, OAX.",0,0,0,6,0,420,
16/03/2017,CHIH.,"GUADALUPE, CHIH.",0,0,0,2,0,0,
16/03/2017,COAH.,"SALTILLO, COAH.",0,0,0,1,0,16,
17/03/2017,MEX.,"ECATEPEC DE MOR., MEX.",9,1,10,0,0,421,
17/03/2017,MEX.,"ECATEPEC DE MOR., MEX.",6,3,9,0,3,89,
17/03/2017,QRO.,"QUERETARO, QRO.",1,3,4,0,0,0,
17/03/2017,DGO.,"DGO., DGO.",1,2,3,0,0,0,
17/03/2017,D.F.,"IZTAPALAPA, D.F.",3,0,3,0,0,49,
17/03/2017,D.F.,"IZTAPALAPA, D.F.",3,0,3,49,0,0,
17/03/2017,VER.,"COSOLEACAQUE, VER.",2,0,2,0,0,216,
17/03/2017,OAX.,"CIUDAD IXTEPEC, OAX.",2,0,2,1,10,0,
17/03/2017,OAX.,"SAN JUAN BAUTISTA TUXTEPEC, OAX.",0,1,1,0,0,0,
17/03/2017,COAH.,"SAN PEDRO, COAH.",1,0,1,1,0,0,
17/03/2017,COAH.,"PIEDRAS NEGRAS, COAH.",0,1,1,1,0,0,
17/03/2017,COAH.,"ACUÑA, COAH.",0,1,1,0,0,6,
17/03/2017,VER.,"POZA RICA DE HGO., VER.",0,1,1,0,0,0,
17/03/2017,QRO.,"SAN JUAN DEL RIO, QRO.",1,0,1,0,0,0,
17/03/2017,MEX.,"VALLE DE CHALCO SOLIDARIDAD, MEX.",1,0,1,0,0,123,
17/03/2017,TAMPS.,"NUEVO LAREDO, TAMPS.",0,1,1,0,0,429,
17/03/2017,TAMPS.,"MATAMOROS, TAMPS.",1,0,1,0,0,171,
17/03/2017,MEX.,"VALLE DE CHALCO SOLIDARIDAD, MEX.",1,0,1,1,0,692,
17/03/2017,MEX.,"IXTLAHUACA, MEX.",1,0,1,0,0,53,
17/03/2017,HGO.,"ZIMAPAN, HGO.",0,0,0,0,0,406,
17/03/2017,TAMPS.,"SAN FERNANDO, TAMPS.",0,0,0,0,0,65,
17/03/2017,MEX.,"TEMOAYA, MEX.",0,0,0,0,0,6,
17/03/2017,N.L.,"MONTERREY, N.L.",0,0,0,2,0,0,
18/03/2017,QRO.,"QUERETARO, QRO.",3,7,10,0,0,0,
18/03/2017,MEX.,"TEMOAYA, MEX.",3,5,8,0,0,1,
18/03/2017,TAMPS.,"MATAMOROS, TAMPS.",2,0,2,1,0,27,
18/03/2017,QRO.,"SAN JUAN DEL RIO, QRO.",0,1,1,0,0,0,
18/03/2017,HGO.,"ZIMAPAN, HGO.",1,0,1,0,0,0,
18/03/2017,COAH.,"NAVA, COAH.",0,1,1,1,0,53,
18/03/2017,TAMPS.,"SAN FERNANDO, TAMPS.",0,0,0,0,0,14,
19/03/2017,QRO.,"QUERETARO, QRO.",2,7,9,0,0,0,
19/03/2017,MEX.,"ECATEPEC DE MOR., MEX.",6,2,8,0,5,44,
19/03/2017,MEX.,"IXTLAHUACA, MEX.",1,2,3,0,0,0,
19/03/2017,MEX.,"VALLE DE CHALCO SOLIDARIDAD, MEX.",2,0,2,1,0,145,
19/03/2017,MEX.,"TEMOAYA, MEX.",1,1,2,0,0,8,
20/03/2017,COAH.,"TORREÓN, COAH.",0,0,0,3,0,0,
20/03/2017,COAH.,"SAN PEDRO, COAH.",0,0,0,3,0,0,
21/03/2017,MEX.,"TECAMAC, MEX.",7,3,10,0,0,3,
21/03/2017,MEX.,"NAUCALPAN DE JUAREZ, MEX.",3,4,7,0,0,79,
21/03/2017,MEX.,"TECAMAC, MEX.",1,3,4,0,0,0,
21/03/2017,ZAC.,"ZAC., ZAC.",3,0,3,1,0,0,
21/03/2017,TAMPS.,"NUEVO LAREDO, TAMPS.",1,1,2,0,0,19,
21/03/2017,MEX.,"SAN JOSE DEL RINCON, MEX.",0,1,1,0,0,0,
21/03/2017,N.L.,"SALINAS VICTORIA, N.L.",0,1,1,0,0,0,
21/03/2017,OAX.,"PINOTEPA DE DON LUIS, OAX.",0,1,1,0,3,0,
21/03/2017,TAMPS.,"TAMPICO, TAMPS.",0,0,0,0,0,53,
22/03/2017,MEX.,"NAUCALPAN DE JUAREZ, MEX.",8,2,10,4,0,5676,
22/03/2017,ZAC.,"NORIA DE ANGELES, ZAC.",3,5,8,0,0,0,
22/03/2017,N.L.,"SALINAS VICTORIA, N.L.",2,0,2,0,0,0,
22/03/2017,QRO.,"QUERETARO, QRO.",1,1,2,0,0,0,
22/03/2017,D.F.,"TLALPAN, D.F.",0,1,1,0,3,0,
22/03/2017,MEX.,"SAN JOSE DEL RINCON, MEX.",0,1,1,0,0,0,
22/03/2017,B.C.S.,"LA PAZ, B.C.S.",0,1,1,0,0,0,
22/03/2017,D.F.,"ALVARO OBREGON, D.F.",0,0,0,0,0,48,
22/03/2017,CHIH.,"GUADALUPE, CHIH.",0,0,0,2,0,56,
22/03/2017,VER.,"COSOLEACAQUE, VER.",0,0,0,0,0,111,
23/03/2017,ZAC.,"SOMBRERETE, ZAC.",1,6,7,0,0,0,
23/03/2017,MEX.,"NAUCALPAN DE JUAREZ, MEX.",5,0,5,0,0,446,
23/03/2017,MEX.,"TECAMAC, MEX.",5,0,5,0,0,0,
23/03/2017,ZAC.,"ZAC., ZAC.",2,1,3,0,0,583,
23/03/2017,N.L.,"MONTERREY, N.L.",1,1,2,1,0,0,
23/03/2017,COAH.,"SAN PEDRO, COAH.",2,0,2,2,0,0,
23/03/2017,CHIH.,"NUEVO CASAS GRANDES, CHIH.",0,2,2,0,0,480,
23/03/2017,TAMPS.,"NUEVO LAREDO, TAMPS.",2,0,2,4,0,70,
23/03/2017,MEX.,"SAN JOSE DEL RINCON, MEX.",1,0,1,0,0,0,
23/03/2017,MEX.,"SULTEPEC, MEX.",1,0,1,0,0,0,
23/03/2017,TAMPS.,"NUEVO LAREDO, TAMPS.",1,0,1,0,0,274,
23/03/2017,COAH.,"MATAMOROS, COAH.",1,0,1,0,0,0,
23/03/2017,COAH.,"FRANCISCO I. MADERO, COAH.",1,0,1,0,0,0,
23/03/2017,GRO.,"SAN MIGUEL TOTOLAPAN, GRO.",0,1,1,0,0,0,
23/03/2017,COAH.,"TORREÓN, COAH.",0,1,1,0,0,0,
23/03/2017,OAX.,"SAN JUAN BAUTISTA TUXTEPEC, OAX.",0,1,1,0,0,0,
23/03/2017,N.L.,"MONTERREY, N.L.",0,1,1,0,0,350,
23/03/2017,MICH.,"APATZINGAN, MICH.",1,0,1,0,0,0,
23/03/2017,COAH.,"SALTILLO, COAH.",0,0,0,0,1,0,
23/03/2017,CHIH.,"GUADALUPE, CHIH.",0,0,0,0,0,47,
24/03/2017,MEX.,"NAUCALPAN DE JUAREZ, MEX.",6,4,10,4,0,1452,
24/03/2017,MEX.,"TECAMAC, MEX.",8,1,9,0,0,787,
24/03/2017,QRO.,"QUERETARO, QRO.",1,6,7,0,0,0,
24/03/2017,ZAC.,"ZAC., ZAC.",5,1,6,0,0,396,
24/03/2017,TAMPS.,"MATAMOROS, TAMPS.",3,2,5,9,0,242,
24/03/2017,D.F.,"TLALPAN, D.F.",1,0,1,0,3,0,
24/03/2017,VER.,"MARTINEZ DE LA TORRE, VER.",1,0,1,0,0,6,
24/03/2017,VER.,"COSOLEACAQUE, VER.",1,0,1,0,0,90,
24/03/2017,TAMPS.,"NUEVO LAREDO, TAMPS.",1,0,1,0,0,0,
24/03/2017,OAX.,"ASUNCION IXTALTEPEC, OAX.",0,0,0,0,10,0,
25/03/2017,QRO.,"QUERETARO, QRO.",4,2,6,0,0,0,
25/03/2017,MEX.,"TECAMAC, MEX.",6,0,6,2,0,175,
25/03/2017,TAMPS.,"MATAMOROS, TAMPS.",1,3,4,0,0,22,
25/03/2017,MEX.,"SULTEPEC, MEX.",0,2,2,0,0,0,
25/03/2017,ZAC.,"ZAC., ZAC.",1,0,1,0,0,470,
26/03/2017,QRO.,"QUERETARO, QRO.",2,6,8,0,0,0,
26/03/2017,MEX.,"SULTEPEC, MEX.",2,0,2,0,0,0,
26/03/2017,MEX.,"NAUCALPAN DE JUAREZ, MEX.",1,0,1,0,0,1448,
26/03/2017,JAL.,"TOMATLAN, JAL.",1,0,1,0,0,0,
27/03/2017,QRO.,"QUERETARO, QRO.",7,1,8,0,0,0,
27/03/2017,COAH.,"TORREÓN, COAH.",2,0,2,0,0,0,
27/03/2017,OAX.,"MIAHUATLAN DE PORFIRIO DIAZ, OAX.",1,1,2,0,0,100,
27/03/2017,COAH.,"TORREÓN, COAH.",2,0,2,0,0,0,
27/03/2017,COAH.,"MATAMOROS, COAH.",1,0,1,0,0,0,
27/03/2017,GRO.,"COYUCA DE BENITEZ, GRO.",1,0,1,0,0,0,
27/03/2017,OAX.,"PINOTEPA DE DON LUIS, OAX.",1,0,1,0,0,0,
27/03/2017,N.L.,"MONTERREY, N.L.",0,1,1,7,0,228,
27/03/2017,COAH.,"PIEDRAS NEGRAS, COAH.",0,0,0,0,0,250,
28/03/2017,D.F.,"IZTAPALAPA, D.F.",2,2,4,211,0,0,
28/03/2017,N.L.,"MONTERREY, N.L.",1,0,1,20,0,500,
28/03/2017,N.L.,"CIENEGA DE FLORES, N.L.",1,0,1,0,0,170,
28/03/2017,TAMPS.,"NUEVO LAREDO, TAMPS.",0,1,1,5,0,140,
28/03/2017,MICH.,"APATZINGAN, MICH.",1,0,1,0,0,0,
28/03/2017,COAH.,"TORREÓN, COAH.",1,0,1,0,0,0,
28/03/2017,OAX.,"ASUNCION IXTALTEPEC, OAX.",1,0,1,0,0,0,
28/03/2017,VER.,"SANTIAGO TUXTLA, VER.",0,0,0,0,0,221,
28/03/2017,TAMPS.,"NUEVO LAREDO, TAMPS.",0,0,0,0,0,10,
28/03/2017,Q. ROO,"SOLIDARIDAD, Q. ROO",0,0,0,0,0,20,
29/03/2017,QRO.,"QUERETARO, QRO.",5,1,6,0,0,0,
29/03/2017,MICH.,"LAZARO CARDENAS, MICH.",3,1,4,0,0,0,
29/03/2017,GRO.,"COYUCA DE BENITEZ, GRO.",2,0,2,0,0,0,
29/03/2017,OAX.,"MIAHUATLAN DE PORFIRIO DIAZ, OAX.",0,2,2,0,0,0,
29/03/2017,N.L.,"CIENEGA DE FLORES, N.L.",2,0,2,0,0,70,
29/03/2017,COAH.,"TORREÓN, COAH.",1,0,1,0,0,0,
29/03/2017,COAH.,"SAN PEDRO, COAH.",1,0,1,0,0,0,
29/03/2017,VER.,"COSOLEACAQUE, VER.",0,0,0,0,0,107,
30/03/2017,QRO.,"QUERETARO, QRO.",2,7,9,0,0,0,
30/03/2017,TAMPS.,"NUEVO LAREDO, TAMPS.",2,0,2,0,0,12,
30/03/2017,MICH.,"APATZINGAN, MICH.",0,0,0,0,0,142,
31/03/2017,N.L.,"MONTERREY, N.L.",7,0,7,83,0,0,
31/03/2017,COAH.,"TORREÓN, COAH.",3,1,4,0,0,0,
31/03/2017,OAX.,"MIAHUATLAN DE PORFIRIO DIAZ, OAX.",0,3,3,8,0,0,
31/03/2017,D.F.,"TLALPAN, D.F.",2,1,3,0,0,0,
31/03/2017,COAH.,"PIEDRAS NEGRAS, COAH.",0,2,2,0,0,0,
31/03/2017,TAMPS.,"NUEVO LAREDO, TAMPS.",2,0,2,0,0,0,
31/03/2017,VER.,"COSOLEACAQUE, VER.",0,1,1,0,0,128,
31/03/2017,COAH.,"PIEDRAS NEGRAS, COAH.",0,1,1,0,0,0,
31/03/2017,COAH.,"ACUÑA, COAH.",0,1,1,0,0,0,
31/03/2017,COAH.,"MÚZQUIZ, COAH.",1,0,1,0,0,0,
31/03/2017,ZAC.,"TAB., ZAC.",1,0,1,0,0,0,
31/03/2017,GRO.,"COYUCA DE BENITEZ, GRO.",1,0,1,0,0,0,
31/03/2017,TAMPS.,"NUEVO LAREDO, TAMPS.",0,0,0,1,0,31,
31/03/2017,COAH.,"MATAMOROS, COAH.",0,0,0,5,0,0,
31/03/2017,Q. ROO,"SOLIDARIDAD, Q. ROO",0,0,0,0,0,40,
01/04/2017,TAMPS.,"MATAMOROS, TAMPS.",1,4,5,2,0,632,
01/04/2017,COAH.,"SALTILLO, COAH.",0,0,0,0,3,0,
02/04/2017,QRO.,"QUERETARO, QRO.",2,1,3,0,0,0,
03/04/2017,QRO.,"QUERETARO, QRO.",0,5,5,0,0,0,
03/04/2017,N.L.,"CIENEGA DE FLORES, N.L.",0,2,2,0,0,0,
03/04/2017,CHIH.,"HGO. DEL PARRAL, CHIH.",1,0,1,0,0,0,
03/04/2017,VER.,"GUTIERREZ ZAMORA, VER.",0,1,1,0,0,0,
03/04/2017,COAH.,"MÚZQUIZ, COAH.",1,0,1,0,0,0,
03/04/2017,TAMPS.,"NUEVO LAREDO, TAMPS.",1,0,1,0,0,42,
03/04/2017,COAH.,"SALTILLO, COAH.",0,0,0,0,2,189,
04/04/2017,D.F.,"TLALPAN, D.F.",3,2,5,0,1,117,
04/04/2017,QRO.,"QUERETARO, QRO.",4,0,4,0,0,0,
04/04/2017,OAX.,"MIAHUATLAN DE PORFIRIO DIAZ, OAX.",0,2,2,0,0,100,
04/04/2017,MICH.,"LAZARO CARDENAS, MICH.",2,0,2,2,0,307,
04/04/2017,DGO.,"DGO., DGO.",1,0,1,2,0,0,
04/04/2017,VER.,"TLAPACOYAN, VER.",1,0,1,0,0,0,
04/04/2017,OAX.,"PINOTEPA DE DON LUIS, OAX.",0,1,1,0,0,0,
04/04/2017,N.L.,"MONTERREY, N.L.",0,0,0,5,0,0,
04/04/2017,N.L.,"CIENEGA DE FLORES, N.L.",0,0,0,8,0,0,
04/04/2017,CHIH.,"JANOS, CHIH.",0,0,0,0,0,622,
04/04/2017,TAMPS.,"MIGUEL ALEMAN, TAMPS.",0,0,0,1,0,78,
04/04/2017,TAMPS.,"NUEVO LAREDO, TAMPS.",0,0,0,0,0,20,
05/04/2017,DGO.,"DGO., DGO.",0,1,1,3,0,0,
05/04/2017,CHIS.,"TAPACHULA, CHIS.",0,1,1,0,0,0,
05/04/2017,D.F.,"TLALPAN, D.F.",1,0,1,0,0,0,
05/04/2017,COAH.,"PIEDRAS NEGRAS, COAH.",1,0,1,0,4,146,
05/04/2017,D.F.,"TLALPAN, D.F.",1,0,1,0,0,0,
05/04/2017,MICH.,"APATZINGAN, MICH.",0,1,1,0,0,0,
05/04/2017,MICH.,"VISTA HERMOSA, MICH.",1,0,1,0,0,0,
06/04/2017,D.F.,"TLALPAN, D.F.",4,1,5,0,3,9,
06/04/2017,MICH.,"VISTA HERMOSA, MICH.",1,2,3,0,0,7,
06/04/2017,MICH.,"VISTA HERMOSA, MICH.",1,2,3,0,0,7,
06/04/2017,OAX.,"MIAHUATLAN DE PORFIRIO DIAZ, OAX.",0,2,2,0,0,0,
06/04/2017,DGO.,"CUENCAME, DGO.",2,0,2,1,0,0,
06/04/2017,MICH.,"APATZINGAN, MICH.",0,1,1,0,0,0,
06/04/2017,MICH.,"LAZARO CARDENAS, MICH.",1,0,1,0,0,0,
06/04/2017,VER.,"TLAPACOYAN, VER.",1,0,1,0,0,0,
06/04/2017,TAMPS.,"MIGUEL ALEMAN, TAMPS.",1,0,1,2,0,50,
06/04/2017,CHIH.,"JANOS, CHIH.",0,0,0,0,0,198,
06/04/2017,MICH.,"SALVADOR ESCALANTE, MICH.",0,0,0,0,0,192,
07/04/2017,DGO.,"DGO., DGO.",3,1,4,2,0,0,
07/04/2017,N.L.,"MONTERREY, N.L.",0,3,3,5,0,70,
07/04/2017,TAMPS.,"NUEVO LAREDO, TAMPS.",3,0,3,0,0,244,
07/04/2017,MICH.,"VISTA HERMOSA, MICH.",0,3,3,0,0,0,
07/04/2017,MICH.,"SALVADOR ESCALANTE, MICH.",0,2,2,0,0,0,
07/04/2017,VER.,"TLAPACOYAN, VER.",1,0,1,0,0,0,
07/04/2017,VER.,"LAS VIGAS DE RAMIREZ, VER.",0,1,1,0,0,0,
08/04/2017,TAMPS.,"MATAMOROS, TAMPS.",4,1,5,15,0,855,
08/04/2017,DGO.,"DGO., DGO.",4,0,4,3,0,0,
08/04/2017,TAMPS.,"MIGUEL ALEMAN, TAMPS.",0,1,1,0,0,0,
08/04/2017,TAMPS.,"MIGUEL ALEMAN, TAMPS.",1,0,1,0,0,0,
08/04/2017,TAB.,"PARAISO, TAB.",1,0,1,0,0,0,
09/04/2017,DGO.,"DGO., DGO.",1,1,2,0,0,0,
10/04/2017,DGO.,"DGO., DGO.",3,2,5,2,0,0,
10/04/2017,DGO.,"DGO., DGO.",3,2,5,2,0,0,
10/04/2017,N.L.,"JUAREZ, N.L.",1,0,1,0,0,0,
10/04/2017,VER.,"TLAPACOYAN, VER.",1,0,1,0,0,0,
10/04/2017,TAMPS.,"NUEVO LAREDO, TAMPS.",1,0,1,0,0,0,
10/04/2017,MICH.,"LAZARO CARDENAS, MICH.",1,0,1,1,1,0,
10/04/2017,D.F.,"TLALPAN, D.F.",1,0,1,0,0,0,
10/04/2017,D.F.,"COYOACAN, D.F.",1,0,1,0,0,0,
10/04/2017,CHIS.,"PALENQUE, CHIS.",0,0,0,0,0,191,
10/04/2017,SIN.,"ELOTA, SIN.",0,0,0,0,13,0,
10/04/2017,OAX.,"PINOTEPA DE DON LUIS, OAX.",0,0,0,3,0,0,
11/04/2017,DGO.,"DGO., DGO.",1,1,2,0,0,0,
11/04/2017,OAX.,"SAN JUAN BAUTISTA TUXTEPEC, OAX.",1,0,1,0,0,143,
11/04/2017,SIN.,"ELOTA, SIN.",1,0,1,0,0,0,
11/04/2017,D.F.,"COYOACAN, D.F.",0,0,0,0,1,0,
11/04/2017,N.L.,"JUAREZ, N.L.",0,0,0,5,0,125,
11/04/2017,D.F.,"TLALPAN, D.F.",0,0,0,0,1,0,
12/04/2017,D.F.,"TLALPAN, D.F.",3,0,3,0,0,28,
12/04/2017,SIN.,"NAVOLATO, SIN.",1,0,1,0,15,0,
12/04/2017,SIN.,"MAZATLAN, SIN.",1,0,1,0,6,0,
12/04/2017,TAMPS.,"NUEVO LAREDO, TAMPS.",0,1,1,0,0,30,
12/04/2017,VER.,"SANTIAGO TUXTLA, VER.",0,1,1,0,0,0,
13/04/2017,D.F.,"TLALPAN, D.F.",2,0,2,0,2,0,
13/04/2017,DGO.,"DGO., DGO.",0,1,1,0,0,0,
13/04/2017,DGO.,"DGO., DGO.",0,1,1,0,0,0,
14/04/2017,D.F.,"COYOACAN, D.F.",2,0,2,0,0,0,
14/04/2017,DGO.,"DGO., DGO.",1,0,1,0,0,0,
14/04/2017,TAB.,"CARDENAS, TAB.",1,0,1,0,0,0,
14/04/2017,DGO.,"DGO., DGO.",1,0,1,0,0,0,
15/04/2017,DGO.,"DGO., DGO.",2,0,2,0,0,0,
15/04/2017,TAMPS.,"MATAMOROS, TAMPS.",2,0,2,1,0,8,
15/04/2017,D.F.,"IZTAPALAPA, D.F.",1,0,1,0,0,6500,
17/04/2017,SIN.,"MAZATLAN, SIN.",5,1,6,0,0,0,
17/04/2017,S.L.P.,"SAN LUIS POTOSI, S.L.P.",3,0,3,34,0,0,
17/04/2017,CHIH.,"HGO. DEL PARRAL, CHIH.",1,1,2,0,0,0,
17/04/2017,DGO.,"DGO., DGO.",1,0,1,0,0,0,
17/04/2017,N.L.,"MONTERREY, N.L.",0,0,0,2,0,0,
17/04/2017,SIN.,"NAVOLATO, SIN.",0,0,0,0,9,0,
17/04/2017,TAMPS.,"NUEVO LAREDO, TAMPS.",0,0,0,5,0,125,
18/04/2017,SIN.,"MAZATLAN, SIN.",4,1,5,0,6,0,
18/04/2017,S.L.P.,"SAN LUIS POTOSI, S.L.P.",3,1,4,0,0,104,
18/04/2017,TAB.,"CARDENAS, TAB.",0,1,1,0,0,0,
18/04/2017,SIN.,"ELOTA, SIN.",0,0,0,0,2,0,
19/04/2017,S.L.P.,"SAN LUIS POTOSI, S.L.P.",6,0,6,0,0,150,
19/04/2017,SIN.,"MAZATLAN, SIN.",3,0,3,0,6,0,
19/04/2017,DGO.,"DGO., DGO.",1,1,2,1,0,0,
19/04/2017,DGO.,"DGO., DGO.",1,1,2,1,0,0,
19/04/2017,CHIH.,"HGO. DEL PARRAL, CHIH.",1,0,1,0,0,0,
20/04/2017,SIN.,"MAZATLAN, SIN.",3,0,3,0,0,0,
20/04/2017,DGO.,"DGO., DGO.",1,1,2,0,0,0,
20/04/2017,VER.,"PANUCO, VER.",2,0,2,0,0,0,
20/04/2017,DGO.,"DGO., DGO.",1,1,2,0,0,0,
20/04/2017,N.L.,"MONTERREY, N.L.",0,1,1,0,0,0,
21/04/2017,TAMPS.,"MATAMOROS, TAMPS.",9,3,12,4,0,260,
21/04/2017,S.L.P.,"SAN LUIS POTOSI, S.L.P.",7,3,10,0,1,39,
21/04/2017,QRO.,"QUERETARO, QRO.",1,5,6,0,0,0,
21/04/2017,D.F.,"TLALPAN, D.F.",3,3,6,0,3,46,
21/04/2017,SIN.,"NAVOLATO, SIN.",0,2,2,0,16,0,
21/04/2017,SIN.,"MAZATLAN, SIN.",1,1,2,0,0,0,
21/04/2017,DGO.,"CUENCAME, DGO.",2,0,2,0,0,0,
21/04/2017,OAX.,"MATIAS ROMERO AVENDAÑO, OAX.",1,0,1,0,0,0,
21/04/2017,N.L.,"GRAL. ZUAZUA, N.L.",0,0,0,0,0,67,
21/04/2017,OAX.,"MIAHUATLAN DE PORFIRIO DIAZ, OAX.",0,0,0,2,0,6,
22/04/2017,S.L.P.,"SAN LUIS POTOSI, S.L.P.",3,0,3,0,1,33,
22/04/2017,DGO.,"CUENCAME, DGO.",2,0,2,0,0,0,
22/04/2017,TAMPS.,"MATAMOROS, TAMPS.",0,2,2,0,0,0,
22/04/2017,CHIH.,"HGO. DEL PARRAL, CHIH.",1,0,1,0,0,0,
22/04/2017,N.L.,"GUADALUPE, N.L.",0,0,0,0,0,95,
23/04/2017,D.F.,"TLALPAN, D.F.",2,1,3,0,2,13,
23/04/2017,S.L.P.,"SAN LUIS POTOSI, S.L.P.",1,0,1,0,0,1,
23/04/2017,DGO.,"DGO., DGO.",1,0,1,0,0,0,
24/04/2017,S.L.P.,"SAN LUIS POTOSI, S.L.P.",6,1,7,3,3,91,
24/04/2017,D.F.,"XOCHIMILCO, D.F.",5,1,6,0,0,9097,
24/04/2017,JAL.,"TONALA, JAL.",2,4,6,0,0,0,
24/04/2017,SIN.,"MAZATLAN, SIN.",3,2,5,0,0,0,
24/04/2017,JAL.,"TLAQUEPAQUE, JAL.",2,1,3,0,0,0,
24/04/2017,MICH.,"LAZARO CARDENAS, MICH.",0,3,3,0,0,0,
24/04/2017,DGO.,"DGO., DGO.",1,1,2,0,4,0,
24/04/2017,JAL.,"ZAPOPAN, JAL.",2,0,2,0,0,40,
24/04/2017,GRO.,"COYUCA DE BENITEZ, GRO.",1,0,1,0,0,0,
24/04/2017,JAL.,"GUADALAJARA, JAL.",1,0,1,0,0,0,
24/04/2017,JAL.,"TLAJOMULCO DE ZUÑIGA, JAL.",0,1,1,0,0,0,
24/04/2017,N.L.,"MONTERREY, N.L.",1,0,1,0,0,0,
24/04/2017,SIN.,"NAVOLATO, SIN.",0,0,0,0,6,0,
25/04/2017,S.L.P.,"SAN LUIS POTOSI, S.L.P.",4,1,5,1,0,105,
25/04/2017,JAL.,"GUADALAJARA, JAL.",2,3,5,0,0,0,
25/04/2017,DGO.,"DGO., DGO.",3,1,4,0,0,0,
25/04/2017,JAL.,"ZAPOPAN, JAL.",2,2,4,0,2,52,
25/04/2017,MICH.,"LAZARO CARDENAS, MICH.",3,0,3,0,0,290,
25/04/2017,JAL.,"TLAJOMULCO DE ZUÑIGA, JAL.",1,2,3,0,0,0,
25/04/2017,JAL.,"TLAQUEPAQUE, JAL.",2,0,2,0,0,0,
25/04/2017,D.F.,"XOCHIMILCO, D.F.",1,0,1,0,0,0,
25/04/2017,SIN.,"NAVOLATO, SIN.",1,0,1,0,1,0,
25/04/2017,SIN.,"MAZATLAN, SIN.",1,0,1,0,0,0,
25/04/2017,JAL.,"TONALA, JAL.",1,0,1,0,0,0,
25/04/2017,TAMPS.,"TAMPICO, TAMPS.",1,0,1,9,0,112,
25/04/2017,N.L.,"GUADALUPE, N.L.",0,0,0,1,0,67,
26/04/2017,S.L.P.,"SAN LUIS POTOSI, S.L.P.",8,0,8,9,7,0,
26/04/2017,JAL.,"GUADALAJARA, JAL.",8,0,8,0,0,0,
26/04/2017,JAL.,"ZAPOPAN, JAL.",5,0,5,0,0,55,
26/04/2017,SIN.,"MAZATLAN, SIN.",1,1,2,0,7,0,
26/04/2017,N.L.,"GUADALUPE, N.L.",1,0,1,0,0,147,
26/04/2017,SIN.,"ELOTA, SIN.",1,0,1,0,4,0,
26/04/2017,JAL.,"TONALA, JAL.",1,0,1,0,0,0,
26/04/2017,JAL.,"TLAJOMULCO DE ZUÑIGA, JAL.",0,1,1,0,0,0,
26/04/2017,CHIS.,"OCOSINGO, CHIS.",0,0,0,0,0,25,
26/04/2017,MICH.,"LAZARO CARDENAS, MICH.",0,0,0,3,0,610,
27/04/2017,SIN.,"SIN., SIN.",4,4,8,0,0,0,
27/04/2017,JAL.,"GUADALAJARA, JAL.",2,4,6,0,0,0,
27/04/2017,JAL.,"TLAQUEPAQUE, JAL.",5,1,6,0,0,0,
27/04/2017,JAL.,"ZAPOPAN, JAL.",3,0,3,0,0,0,
27/04/2017,N.L.,"GUADALUPE, N.L.",3,0,3,1,0,700,
27/04/2017,SIN.,"ELOTA, SIN.",3,0,3,0,8,0,
27/04/2017,JAL.,"TONALA, JAL.",1,1,2,0,0,0,
27/04/2017,D.F.,"XOCHIMILCO, D.F.",2,0,2,0,0,44,
27/04/2017,MICH.,"PANINDICUARO, MICH.",1,0,1,0,0,200,
27/04/2017,JAL.,"TLAJOMULCO DE ZUÑIGA, JAL.",0,1,1,0,0,0,
27/04/2017,N.L.,"MONTERREY, N.L.",1,0,1,1,0,23,
27/04/2017,D.F.,"CUAUHTEMOC, D.F.",1,0,1,0,0,0,
27/04/2017,DGO.,"DGO., DGO.",1,0,1,5,0,0,
27/04/2017,MICH.,"LAZARO CARDENAS, MICH.",0,0,0,0,0,360,
27/04/2017,CHIS.,"OCOSINGO, CHIS.",0,0,0,0,0,29,
28/04/2017,SIN.,"MAZATLAN, SIN.",5,2,7,0,0,0,
28/04/2017,JAL.,"GUADALAJARA, JAL.",6,0,6,0,0,0,
28/04/2017,D.F.,"XOCHIMILCO, D.F.",2,2,4,0,0,0,
28/04/2017,DGO.,"DGO., DGO.",3,0,3,0,0,0,
28/04/2017,TAMPS.,"MATAMOROS, TAMPS.",0,3,3,2,0,233,
28/04/2017,N.L.,"MONTERREY, N.L.",2,0,2,2,0,300,
28/04/2017,JAL.,"TLAJOMULCO DE ZUÑIGA, JAL.",2,0,2,0,0,0,
28/04/2017,MICH.,"PANINDICUARO, MICH.",0,2,2,0,0,0,
28/04/2017,CHIS.,"OCOSINGO, CHIS.",0,1,1,0,0,0,
28/04/2017,MICH.,"LAZARO CARDENAS, MICH.",1,0,1,0,0,0,
28/04/2017,SIN.,"ELOTA, SIN.",1,0,1,0,7,0,
28/04/2017,JAL.,"ZAPOPAN, JAL.",1,0,1,0,0,0,
28/04/2017,JAL.,"TONALA, JAL.",1,0,1,0,0,0,
28/04/2017,JAL.,"TLAQUEPAQUE, JAL.",1,0,1,0,0,219,
28/04/2017,N.L.,"GUADALUPE, N.L.",0,0,0,1,0,86,
29/04/2017,JAL.,"GUADALAJARA, JAL.",2,3,5,0,0,0,
29/04/2017,JAL.,"ZAPOPAN, JAL.",2,2,4,0,0,0,
29/04/2017,TAMPS.,"MATAMOROS, TAMPS.",2,0,2,0,0,113,
29/04/2017,VER.,"PANUCO, VER.",2,0,2,0,0,0,
29/04/2017,JAL.,"TONALA, JAL.",0,1,1,0,0,0,
29/04/2017,JAL.,"TLAJOMULCO DE ZUÑIGA, JAL.",0,1,1,0,0,0,
29/04/2017,JAL.,"TLAQUEPAQUE, JAL.",1,0,1,0,0,0,
29/04/2017,MICH.,"LAZARO CARDENAS, MICH.",0,0,0,0,0,690,
30/04/2017,JAL.,"TONALA, JAL.",0,4,4,0,0,0,
30/04/2017,JAL.,"TLAJOMULCO DE ZUÑIGA, JAL.",2,1,3,0,0,0,
30/04/2017,JAL.,"GUADALAJARA, JAL.",2,0,2,0,0,8,
30/04/2017,JAL.,"TLAQUEPAQUE, JAL.",0,2,2,0,0,0,
30/04/2017,DGO.,"DGO., DGO.",1,0,1,0,4,0,
30/04/2017,JAL.,"ZAPOPAN, JAL.",0,0,0,0,0,50,
01/05/2017,JAL.,"TONALA, JAL.",1,3,4,0,0,0,
01/05/2017,JAL.,"TLAJOMULCO DE ZUÑIGA, JAL.",2,1,3,0,0,14,
01/05/2017,DGO.,"DGO., DGO.",2,0,2,1,0,0,
01/05/2017,JAL.,"ZAPOPAN, JAL.",0,2,2,0,0,0,
01/05/2017,JAL.,"GUADALAJARA, JAL.",1,0,1,0,0,0,
01/05/2017,JAL.,"TLAQUEPAQUE, JAL.",1,0,1,0,0,0,
02/05/2017,GTO.,"SALAMANCA, GTO.",10,0,10,0,0,0,
02/05/2017,D.F.,"XOCHIMILCO, D.F.",6,3,9,0,1,1845,
02/05/2017,JAL.,"TLAJOMULCO DE ZUÑIGA, JAL.",2,1,3,0,0,0,
02/05/2017,D.F.,"GUSTAVO A. MADERO, D.F.",3,0,3,0,0,0,
02/05/2017,DGO.,"DGO., DGO.",1,1,2,0,0,0,
02/05/2017,JAL.,"ZAPOPAN, JAL.",0,1,1,0,0,0,
02/05/2017,JAL.,"TLAQUEPAQUE, JAL.",0,1,1,0,0,0,
02/05/2017,N.L.,"MONTERREY, N.L.",1,0,1,0,0,95,
02/05/2017,SIN.,"BADIRAGUATO, SIN.",1,0,1,0,0,0,
02/05/2017,JAL.,"TONALA, JAL.",0,0,0,0,0,250,
03/05/2017,GTO.,"SALAMANCA, GTO.",10,2,12,0,0,0,
03/05/2017,N.L.,"GUADALUPE, N.L.",3,0,3,6,0,250,
03/05/2017,JAL.,"ZAPOPAN, JAL.",3,0,3,0,0,0,
03/05/2017,D.F.,"XOCHIMILCO, D.F.",2,0,2,0,2,0,
03/05/2017,JAL.,"GUADALAJARA, JAL.",2,0,2,0,0,0,
03/05/2017,JAL.,"TLAJOMULCO DE ZUÑIGA, JAL.",2,0,2,0,0,0,
03/05/2017,JAL.,"TLAQUEPAQUE, JAL.",2,0,2,1,0,138,
03/05/2017,TAMPS.,"NUEVO LAREDO, TAMPS.",0,1,1,1,0,0,
03/05/2017,JAL.,"TONALA, JAL.",0,1,1,0,0,0,
03/05/2017,SIN.,"SAN IGNACIO, SIN.",0,1,1,0,0,0,
03/05/2017,GRO.,"PUNGARABATO, GRO.",1,0,1,0,0,0,
03/05/2017,DGO.,"DGO., DGO.",1,0,1,8,2,0,
03/05/2017,N.L.,"MONTERREY, N.L.",0,0,0,0,0,100,
03/05/2017,SIN.,"BADIRAGUATO, SIN.",0,0,0,0,4,0,
04/05/2017,GTO.,"SALAMANCA, GTO.",4,1,5,0,0,0,
04/05/2017,D.F.,"XOCHIMILCO, D.F.",2,1,3,0,0,7061,
04/05/2017,PUE.,"TEHUACAN, PUE.",2,1,3,0,0,2,
04/05/2017,JAL.,"TLAQUEPAQUE, JAL.",2,0,2,0,0,0,
04/05/2017,MICH.,"APATZINGAN, MICH.",1,0,1,0,0,0,
04/05/2017,JAL.,"GUADALAJARA, JAL.",1,0,1,0,0,0,
04/05/2017,JAL.,"ZAPOPAN, JAL.",0,1,1,2,0,161,
04/05/2017,JAL.,"TONALA, JAL.",1,0,1,0,0,0,
04/05/2017,SIN.,"SAN IGNACIO, SIN.",0,1,1,0,0,0,
04/05/2017,DGO.,"DGO., DGO.",1,0,1,0,0,0,
04/05/2017,MICH.,"IXTLAN, MICH.",1,0,1,0,0,0,
04/05/2017,TAMPS.,"NUEVO LAREDO, TAMPS.",0,0,0,0,0,29,
04/05/2017,N.L.,"GUADALUPE, N.L.",0,0,0,1,0,40,
05/05/2017,GTO.,"SALAMANCA, GTO.",10,5,15,0,0,0,
05/05/2017,SIN.,"BADIRAGUATO, SIN.",2,5,7,0,4,0,
05/05/2017,D.F.,"XOCHIMILCO, D.F.",3,0,3,0,1,405,
05/05/2017,TAMPS.,"MATAMOROS, TAMPS.",1,1,2,1,0,67,
05/05/2017,DGO.,"DGO., DGO.",1,0,1,0,0,0,
05/05/2017,D.F.,"GUSTAVO A. MADERO, D.F.",1,0,1,0,0,0,
05/05/2017,MICH.,"APATZINGAN, MICH.",0,0,0,0,0,150,
06/05/2017,JAL.,"TLAQUEPAQUE, JAL.",1,1,2,0,0,0,
06/05/2017,DGO.,"DGO., DGO.",1,1,2,2,1,0,
06/05/2017,JAL.,"ZAPOPAN, JAL.",0,1,1,1,5,4,
06/05/2017,JAL.,"TONALA, JAL.",0,1,1,0,0,0,
06/05/2017,JAL.,"TLAJOMULCO DE ZUÑIGA, JAL.",1,0,1,0,0,0,
06/05/2017,TAMPS.,"MATAMOROS, TAMPS.",0,1,1,6,0,132,
07/05/2017,JAL.,"ZAPOPAN, JAL.",2,0,2,0,0,15,
07/05/2017,JAL.,"TLAQUEPAQUE, JAL.",1,1,2,0,0,100,
07/05/2017,JAL.,"GUADALAJARA, JAL.",1,0,1,0,0,0,
07/05/2017,JAL.,"TONALA, JAL.",0,1,1,0,0,0,
07/05/2017,JAL.,"TLAJOMULCO DE ZUÑIGA, JAL.",1,0,1,0,0,0,
08/05/2017,JAL.,"GUADALAJARA, JAL.",2,4,6,0,0,0,
08/05/2017,JAL.,"TLAJOMULCO DE ZUÑIGA, JAL.",1,1,2,0,0,0,
08/05/2017,SIN.,"BADIRAGUATO, SIN.",1,1,2,0,1,0,
08/05/2017,TAMPS.,"NUEVO LAREDO, TAMPS.",2,0,2,0,0,121,
08/05/2017,JAL.,"ZAPOPAN, JAL.",1,0,1,0,0,0,
08/05/2017,JAL.,"TLAQUEPAQUE, JAL.",0,1,1,3,0,115,
08/05/2017,Q. ROO,"OTHON P. BLANCO, Q. ROO",1,0,1,2,0,34,
08/05/2017,MICH.,"LAZARO CARDENAS, MICH.",1,0,1,0,0,150,
08/05/2017,PUE.,"TEHUACAN, PUE.",1,0,1,3,0,73,
08/05/2017,D.F.,"AZCAPOTZALCO, D.F.",0,1,1,0,0,148,
08/05/2017,DGO.,"DGO., DGO.",1,0,1,2,0,0,
09/05/2017,SIN.,"SAN IGNACIO, SIN.",1,2,3,0,0,0,
09/05/2017,N.L.,"HGO., N.L.",3,0,3,4,0,0,
09/05/2017,JAL.,"GUADALAJARA, JAL.",0,2,2,0,0,0,
09/05/2017,JAL.,"ZAPOPAN, JAL.",2,0,2,1,0,0,
09/05/2017,GTO.,"ROMITA, GTO.",1,1,2,0,0,0,
09/05/2017,SIN.,"BADIRAGUATO, SIN.",1,0,1,0,0,0,
09/05/2017,JAL.,"TONALA, JAL.",1,0,1,0,0,0,
09/05/2017,JAL.,"TLAJOMULCO DE ZUÑIGA, JAL.",1,0,1,0,0,0,
09/05/2017,JAL.,"TLAQUEPAQUE, JAL.",0,1,1,0,0,151,
09/05/2017,TAMPS.,"TAMPICO, TAMPS.",1,0,1,0,0,31,
09/05/2017,TAMPS.,"NUEVO LAREDO, TAMPS.",1,0,1,2,0,121,
09/05/2017,Q. ROO,"OTHON P. BLANCO, Q. ROO",0,0,0,0,3,38,
10/05/2017,COL.,"COL., COL.",3,0,3,0,0,0,
10/05/2017,JAL.,"TONALA, JAL.",0,3,3,0,0,0,
10/05/2017,Q. ROO,"OTHON P. BLANCO, Q. ROO",2,1,3,0,4,64,
10/05/2017,TAMPS.,"NUEVO LAREDO, TAMPS.",1,1,2,0,0,39,
10/05/2017,JAL.,"ZAPOPAN, JAL.",2,0,2,0,0,0,
10/05/2017,GTO.,"ROMITA, GTO.",0,2,2,0,0,0,
10/05/2017,D.F.,"AZCAPOTZALCO, D.F.",1,0,1,0,2,134,
10/05/2017,DGO.,"DGO., DGO.",0,1,1,0,0,0,
10/05/2017,JAL.,"TLAJOMULCO DE ZUÑIGA, JAL.",1,0,1,0,0,0,
10/05/2017,JAL.,"TLAQUEPAQUE, JAL.",0,1,1,0,0,0,
10/05/2017,N.L.,"HGO., N.L.",0,0,0,5,1,0,
11/05/2017,GTO.,"ROMITA, GTO.",6,3,9,0,0,0,
11/05/2017,JAL.,"TONALA, JAL.",1,3,4,3,0,0,
11/05/2017,GTO.,"SALAMANCA, GTO.",3,1,4,0,0,0,
11/05/2017,D.F.,"AZCAPOTZALCO, D.F.",0,1,1,0,0,0,
11/05/2017,JAL.,"TLAJOMULCO DE ZUÑIGA, JAL.",1,0,1,0,0,0,
11/05/2017,SIN.,"BADIRAGUATO, SIN.",0,0,0,0,6,0,
11/05/2017,Q. ROO,"OTHON P. BLANCO, Q. ROO",0,0,0,0,3,138,
11/05/2017,N.L.,"HGO., N.L.",0,0,0,5,0,67,
12/05/2017,TAMPS.,"MATAMOROS, TAMPS.",2,4,6,0,0,100,
12/05/2017,JAL.,"TONALA, JAL.",2,1,3,0,0,0,
12/05/2017,D.F.,"AZCAPOTZALCO, D.F.",0,3,3,0,53,0,
12/05/2017,GRO.,"ATOYAC DE ALVAREZ, GRO.",3,0,3,0,0,5,
12/05/2017,JAL.,"ZAPOPAN, JAL.",2,0,2,0,0,197,
12/05/2017,JAL.,"TLAQUEPAQUE, JAL.",0,2,2,0,0,0,
12/05/2017,GTO.,"SALAMANCA, GTO.",2,0,2,0,0,0,
12/05/2017,PUE.,"TEHUACAN, PUE.",2,0,2,2,0,10,
12/05/2017,JAL.,"TLAJOMULCO DE ZUÑIGA, JAL.",1,0,1,0,0,0,
12/05/2017,N.L.,"MONTERREY, N.L.",0,1,1,28,0,40,
12/05/2017,DGO.,"DGO., DGO.",1,0,1,0,0,0,
12/05/2017,TAMPS.,"NUEVO LAREDO, TAMPS.",0,0,0,0,0,77,
12/05/2017,SIN.,"BADIRAGUATO, SIN.",0,0,0,0,1,0,
12/05/2017,N.L.,"GARCIA, N.L.",0,0,0,1,0,30,
12/05/2017,Q. ROO,"OTHON P. BLANCO, Q. ROO",0,0,0,0,6,269,
13/05/2017,TAMPS.,"MATAMOROS, TAMPS.",0,5,5,1,0,10,
13/05/2017,DGO.,"DGO., DGO.",2,0,2,3,0,0,
13/05/2017,JAL.,"TLAQUEPAQUE, JAL.",2,0,2,0,0,32,
13/05/2017,B.C.S.,"MULEGÉ, B.C.S.",0,1,1,0,0,0,
13/05/2017,N.L.,"GARCIA, N.L.",1,0,1,1,0,0,
13/05/2017,N.L.,"HGO., N.L.",0,1,1,0,0,0,
13/05/2017,GRO.,"ATOYAC DE ALVAREZ, GRO.",1,0,1,1,0,0,
13/05/2017,JAL.,"TLAJOMULCO DE ZUÑIGA, JAL.",0,1,1,0,0,0,
13/05/2017,JAL.,"ZAPOPAN, JAL.",0,0,0,0,1,0,
14/05/2017,JAL.,"ZAPOPAN, JAL.",3,0,3,0,0,0,
14/05/2017,B.C.S.,"MULEGÉ, B.C.S.",0,1,1,0,0,0,
14/05/2017,JAL.,"GUADALAJARA, JAL.",1,0,1,0,0,0,
14/05/2017,JAL.,"TLAJOMULCO DE ZUÑIGA, JAL.",1,0,1,0,0,0,
14/05/2017,JAL.,"TLAQUEPAQUE, JAL.",1,0,1,0,0,187,
15/05/2017,DGO.,"DGO., DGO.",2,3,5,0,0,0,
15/05/2017,JAL.,"TLAQUEPAQUE, JAL.",3,0,3,0,0,0,
15/05/2017,D.F.,"AZCAPOTZALCO, D.F.",0,3,3,0,0,0,
15/05/2017,JAL.,"TONALA, JAL.",1,1,2,1,0,0,
15/05/2017,SIN.,"BADIRAGUATO, SIN.",1,1,2,0,3,0,
15/05/2017,JAL.,"GUADALAJARA, JAL.",0,1,1,0,0,0,
15/05/2017,JAL.,"ZAPOPAN, JAL.",1,0,1,0,0,0,
15/05/2017,JAL.,"TLAJOMULCO DE ZUÑIGA, JAL.",0,1,1,0,0,0,
15/05/2017,N.L.,"HGO., N.L.",0,1,1,0,0,0,
15/05/2017,B.C.S.,"MULEGÉ, B.C.S.",0,1,1,0,0,0,
15/05/2017,TAMPS.,"NUEVO LAREDO, TAMPS.",1,0,1,1,0,3234,
15/05/2017,GRO.,"ATOYAC DE ALVAREZ, GRO.",0,1,1,0,0,0,
15/05/2017,PUE.,"TEHUACAN, PUE.",0,0,0,0,0,126,
16/05/2017,JAL.,"GUADALAJARA, JAL.",1,2,3,0,0,0,
16/05/2017,GRO.,"ATOYAC DE ALVAREZ, GRO.",2,0,2,1,0,12,
16/05/2017,PUE.,"TEHUACAN, PUE.",1,1,2,0,0,183,
16/05/2017,D.F.,"AZCAPOTZALCO, D.F.",2,0,2,0,0,0,
16/05/2017,DGO.,"DGO., DGO.",0,1,1,0,0,0,
16/05/2017,B.C.S.,"MULEGÉ, B.C.S.",0,1,1,0,0,0,
16/05/2017,JAL.,"TONALA, JAL.",1,0,1,0,0,0,
16/05/2017,JAL.,"TLAJOMULCO DE ZUÑIGA, JAL.",1,0,1,0,0,0,
16/05/2017,JAL.,"TLAQUEPAQUE, JAL.",0,1,1,0,0,150,
16/05/2017,N.L.,"HGO., N.L.",0,0,0,1,1,0,
17/05/2017,D.F.,"AZCAPOTZALCO, D.F.",0,1,1,0,0,0,
17/05/2017,N.L.,"HGO., N.L.",0,1,1,1,0,100,
17/05/2017,DGO.,"DGO., DGO.",1,0,1,2,1,0,
17/05/2017,D.F.,"IZTACALCO, D.F.",0,0,0,0,0,60,
18/05/2017,D.F.,"IZTACALCO, D.F.",4,0,4,0,0,0,
18/05/2017,JAL.,"GUADALAJARA, JAL.",2,0,2,0,0,0,
18/05/2017,SIN.,"BADIRAGUATO, SIN.",1,1,2,0,0,0,
18/05/2017,N.L.,"MONTERREY, N.L.",0,2,2,0,0,0,
18/05/2017,JAL.,"ZAPOPAN, JAL.",1,0,1,2,0,41,
18/05/2017,JAL.,"TONALA, JAL.",0,1,1,0,0,0,
18/05/2017,JAL.,"TLAJOMULCO DE ZUÑIGA, JAL.",1,0,1,0,0,0,
18/05/2017,JAL.,"TLAQUEPAQUE, JAL.",1,0,1,0,0,0,
18/05/2017,DGO.,"DGO., DGO.",1,0,1,0,0,0,
18/05/2017,SIN.,"SAN IGNACIO, SIN.",1,0,1,0,0,0,
18/05/2017,D.F.,"AZCAPOTZALCO, D.F.",1,0,1,0,0,0,
18/05/2017,TAMPS.,"NUEVO LAREDO, TAMPS.",0,0,0,11,0,88,
18/05/2017,MICH.,"LAZARO CARDENAS, MICH.",0,0,0,0,0,550,
18/05/2017,N.L.,"GARCIA, N.L.",0,0,0,4,0,140,
19/05/2017,D.F.,"IZTACALCO, D.F.",9,0,9,0,1,91,
19/05/2017,TAMPS.,"MATAMOROS, TAMPS.",2,1,3,8,0,56,
19/05/2017,N.L.,"MONTERREY, N.L.",2,1,3,0,0,0,
19/05/2017,JAL.,"TLAQUEPAQUE, JAL.",2,0,2,0,0,111,
19/05/2017,SIN.,"SAN IGNACIO, SIN.",1,1,2,0,0,0,
19/05/2017,D.F.,"AZCAPOTZALCO, D.F.",2,0,2,0,0,11,
19/05/2017,TAMPS.,"NUEVO LAREDO, TAMPS.",1,0,1,0,0,50,
19/05/2017,JAL.,"GUADALAJARA, JAL.",1,0,1,0,0,0,
19/05/2017,JAL.,"TONALA, JAL.",1,0,1,0,0,0,
19/05/2017,JAL.,"TLAJOMULCO DE ZUÑIGA, JAL.",1,0,1,0,0,0,
19/05/2017,DGO.,"DGO., DGO.",1,0,1,0,0,0,
19/05/2017,N.L.,"HGO., N.L.",0,0,0,0,0,234,
19/05/2017,MICH.,"LAZARO CARDENAS, MICH.",0,0,0,0,0,550,
20/05/2017,DGO.,"DGO., DGO.",1,1,2,0,0,0,
20/05/2017,JAL.,"TLAQUEPAQUE, JAL.",1,1,2,0,0,0,
20/05/2017,TAMPS.,"MATAMOROS, TAMPS.",1,1,2,0,0,99,
20/05/2017,N.L.,"GARCIA, N.L.",0,0,0,2,0,30,
20/05/2017,MICH.,"LAZARO CARDENAS, MICH.",0,0,0,2,0,20,
20/05/2017,JAL.,"TONALA, JAL.",0,0,0,2,0,52,
21/05/2017,GRO.,"ATOYAC DE ALVAREZ, GRO.",4,0,4,4,0,0,
21/05/2017,JAL.,"TLAQUEPAQUE, JAL.",2,0,2,0,0,117,
21/05/2017,JAL.,"TLAJOMULCO DE ZUÑIGA, JAL.",1,0,1,0,0,0,
22/05/2017,D.F.,"BENITO JUAREZ, D.F.",13,1,14,0,0,8639,
22/05/2017,SIN.,"SIN., SIN.",7,0,7,0,5,0,
22/05/2017,JAL.,"TLAQUEPAQUE, JAL.",0,2,2,0,0,0,
22/05/2017,PUE.,"TEHUACAN, PUE.",2,0,2,1,0,0,
22/05/2017,SON.,"NAVOLATO, SIN.",1,1,2,0,0,42,
22/05/2017,DGO.,"DGO., DGO.",1,0,1,0,0,0,
22/05/2017,JAL.,"TONALA, JAL.",0,1,1,0,0,0,
22/05/2017,B.C.S.,"LA PAZ, B.C.S.",0,1,1,0,0,0,
22/05/2017,SIN.,"CONCORDIA, SIN.",0,1,1,0,0,0,
22/05/2017,SON.,"HUATABAMPO, SON.",0,0,0,1,0,0,
23/05/2017,AGS.,"AGS., AGS.",3,2,5,13,1,324,
23/05/2017,SIN.,"SIN., SIN.",1,2,3,0,0,0,
23/05/2017,GRO.,"COYUCA DE BENITEZ, GRO.",1,1,2,0,0,0,
23/05/2017,N.L.,"MINA, N.L.",1,1,2,0,0,0,
23/05/2017,JAL.,"GUADALAJARA, JAL.",2,0,2,0,0,0,
23/05/2017,JAL.,"ZAPOPAN, JAL.",1,1,2,0,0,0,
23/05/2017,JAL.,"TONALA, JAL.",1,1,2,0,0,0,
23/05/2017,D.F.,"BENITO JUAREZ, D.F.",1,0,1,0,0,10217,
23/05/2017,JAL.,"TLAJOMULCO DE ZUÑIGA, JAL.",1,0,1,0,0,0,
23/05/2017,DGO.,"DGO., DGO.",0,1,1,0,0,0,
23/05/2017,PUE.,"TEHUACAN, PUE.",0,0,0,0,0,7,
23/05/2017,TAMPS.,"NUEVO LAREDO, TAMPS.",0,0,0,1,0,16,
24/05/2017,SIN.,"SIN., SIN.",13,0,13,0,0,0,
24/05/2017,JAL.,"TLAJOMULCO DE ZUÑIGA, JAL.",3,0,3,0,0,0,
24/05/2017,SIN.,"CONCORDIA, SIN.",2,1,3,0,0,0,
24/05/2017,JAL.,"TONALA, JAL.",1,1,2,0,0,0,
24/05/2017,AGS.,"AGS., AGS.",1,1,2,0,0,52,
24/05/2017,D.F.,"BENITO JUAREZ, D.F.",0,1,1,0,0,0,
24/05/2017,JAL.,"GUADALAJARA, JAL.",0,1,1,0,0,0,
24/05/2017,JAL.,"TLAQUEPAQUE, JAL.",0,1,1,0,0,95,
24/05/2017,N.L.,"MONTERREY, N.L.",1,0,1,1,0,0,
24/05/2017,N.L.,"SAN NICOLAS DE LOS GARZA, N.L.",0,0,0,1,0,194,
25/05/2017,SIN.,"SIN., SIN.",4,3,7,0,0,0,
25/05/2017,DGO.,"DGO., DGO.",2,2,4,1,2,0,
25/05/2017,D.F.,"BENITO JUAREZ, D.F.",4,0,4,0,0,980,
25/05/2017,D.F.,"ALVARO OBREGON, D.F.",3,1,4,0,0,0,
25/05/2017,JAL.,"ZAPOPAN, JAL.",3,0,3,0,1,0,
25/05/2017,AGS.,"AGS., AGS.",1,1,2,0,0,0,
25/05/2017,SON.,"GUAYMAS, SON.",0,2,2,0,0,0,
25/05/2017,JAL.,"TONALA, JAL.",1,1,2,0,0,0,
25/05/2017,JAL.,"TLAQUEPAQUE, JAL.",2,0,2,0,0,169,
25/05/2017,OAX.,"SAN PEDRO TAPANATEPEC, OAX.",1,1,2,0,0,0,
25/05/2017,TAB.,"CENTRO, TAB.",1,0,1,0,0,0,
25/05/2017,SON.,"HUATABAMPO, SON.",1,0,1,0,0,0,
25/05/2017,SON.,"NAVOJOA, SON.",1,0,1,1,0,0,
25/05/2017,N.L.,"MINA, N.L.",1,0,1,2,0,0,
25/05/2017,JAL.,"GUADALAJARA, JAL.",1,0,1,0,0,0,
25/05/2017,JAL.,"TLAJOMULCO DE ZUÑIGA, JAL.",1,0,1,0,0,0,
26/05/2017,SIN.,"SIN., SIN.",7,1,8,0,1,0,
26/05/2017,PUE.,"TEHUACAN, PUE.",3,0,3,2,0,0,
26/05/2017,TAMPS.,"MATAMOROS, TAMPS.",0,2,2,3,0,21,
26/05/2017,SON.,"GUAYMAS, SON.",2,0,2,0,0,0,
26/05/2017,SIN.,"CONCORDIA, SIN.",1,1,2,0,0,0,
26/05/2017,TAMPS.,"NUEVO LAREDO, TAMPS.",0,2,2,3,0,21,
26/05/2017,SON.,"NAVOJOA, SON.",0,1,1,3,0,3,
26/05/2017,N.L.,"SAN NICOLAS DE LOS GARZA, N.L.",1,0,1,4,0,10,
26/05/2017,N.L.,"MONTERREY, N.L.",0,1,1,1,0,0,
27/05/2017,TAMPS.,"MATAMOROS, TAMPS.",3,0,3,1,0,0,
27/05/2017,SON.,"GUAYMAS, SON.",2,0,2,1,0,0,
27/05/2017,JAL.,"TLAQUEPAQUE, JAL.",2,0,2,0,0,0,
27/05/2017,MICH.,"APATZINGAN, MICH.",1,0,1,0,0,0,
27/05/2017,DGO.,"DGO., DGO.",1,0,1,3,0,0,
27/05/2017,JAL.,"ZAPOPAN, JAL.",1,0,1,0,0,0,
27/05/2017,JAL.,"TLAJOMULCO DE ZUÑIGA, JAL.",0,1,1,1,0,48,
27/05/2017,N.L.,"SAN NICOLAS DE LOS GARZA, N.L.",0,0,0,10,0,16,
28/05/2017,TAB.,"CENTRO, TAB.",2,1,3,1,0,22,
28/05/2017,DGO.,"DGO., DGO.",1,1,2,1,0,0,
28/05/2017,MICH.,"APATZINGAN, MICH.",1,0,1,0,0,0,
28/05/2017,JAL.,"GUADALAJARA, JAL.",1,0,1,0,0,50,
28/05/2017,JAL.,"TLAJOMULCO DE ZUÑIGA, JAL.",1,0,1,0,2,34,
28/05/2017,JAL.,"TLAQUEPAQUE, JAL.",0,0,0,0,0,424,
28/05/2017,JAL.,"TONALA, JAL.",0,0,0,0,0,21,
29/05/2017,D.F.,"BENITO JUAREZ, D.F.",5,1,6,0,0,435,
29/05/2017,JAL.,"ZAPOPAN, JAL.",3,0,3,0,1,0,
29/05/2017,JAL.,"TONALA, JAL.",1,1,2,0,0,0,
29/05/2017,JAL.,"GUADALAJARA, JAL.",1,0,1,0,0,0,
29/05/2017,JAL.,"TLAQUEPAQUE, JAL.",0,1,1,0,0,0,
29/05/2017,TAMPS.,"NUEVO LAREDO, TAMPS.",0,1,1,0,0,14,
29/05/2017,AGS.,"AGS., AGS.",1,0,1,0,0,0,
29/05/2017,SIN.,"CONCORDIA, SIN.",0,1,1,0,0,0,
29/05/2017,DGO.,"DGO., DGO.",1,0,1,1,0,0,
29/05/2017,JAL.,"TLAJOMULCO DE ZUÑIGA, JAL.",0,0,0,0,1,45,
29/05/2017,N.L.,"SAN NICOLAS DE LOS GARZA, N.L.",0,0,0,0,0,90,
29/05/2017,MICH.,"APATZINGAN, MICH.",0,0,0,0,1,572,
30/05/2017,AGS.,"AGS., AGS.",5,1,6,7,0,7,
30/05/2017,SIN.,"SIN., SIN.",0,5,5,0,0,0,
30/05/2017,TAMPS.,"NUEVO LAREDO, TAMPS.",3,0,3,1,0,49,
30/05/2017,D.F.,"BENITO JUAREZ, D.F.",0,2,2,0,3,54,
30/05/2017,JAL.,"GUADALAJARA, JAL.",1,1,2,0,1,0,
30/05/2017,JAL.,"TLAJOMULCO DE ZUÑIGA, JAL.",1,1,2,2,1,22,
30/05/2017,JAL.,"TONALA, JAL.",0,2,2,0,0,0,
30/05/2017,JAL.,"ZAPOPAN, JAL.",0,2,2,0,1,0,
30/05/2017,TAB.,"TENOSIQUE, TAB.",1,0,1,0,0,0,
30/05/2017,DGO.,"DGO., DGO.",1,0,1,0,0,0,
30/05/2017,N.L.,"SAN NICOLAS DE LOS GARZA, N.L.",0,0,0,0,1,101,
30/05/2017,JAL.,"TLAQUEPAQUE, JAL.",0,0,0,0,0,85,
31/05/2017,SIN.,"SIN., SIN.",9,2,11,0,2,0,
31/05/2017,D.F.,"BENITO JUAREZ, D.F.",9,0,9,0,2,1324,
31/05/2017,TAMPS.,"NUEVO LAREDO, TAMPS.",5,2,7,6,0,297,
31/05/2017,SIN.,"CONCORDIA, SIN.",2,0,2,0,2,0,
31/05/2017,JAL.,"GUADALAJARA, JAL.",2,0,2,0,0,0,
31/05/2017,JAL.,"TLAQUEPAQUE, JAL.",1,1,2,0,0,150,
31/05/2017,N.L.,"MONTERREY, N.L.",1,0,1,0,0,0,
31/05/2017,TAB.,"CENTRO, TAB.",1,0,1,0,0,0,
31/05/2017,CHIH.,"HGO. DEL PARRAL, CHIH.",1,0,1,0,0,232,
31/05/2017,CHIS.,"OCOSINGO, CHIS.",0,0,0,0,0,177,
31/05/2017,SON.,"HERMOSILLO, SON.",0,0,0,2,0,100,
01/06/2017,CHIH.,"HGO. DEL PARRAL, CHIH.",14,1,15,7,0,1206,
01/06/2017,SIN.,"CONCORDIA, SIN.",4,3,7,0,0,0,
01/06/2017,JAL.,"TLAJOMULCO DE ZUÑIGA, JAL.",3,0,3,0,0,38,
01/06/2017,DGO.,"DGO., DGO.",1,2,3,2,3,0,
01/06/2017,JAL.,"ZAPOPAN, JAL.",2,0,2,0,0,0,
01/06/2017,TAB.,"TENOSIQUE, TAB.",1,1,2,0,0,0,
01/06/2017,TLAX.,"PANOTLA, TLAX.",1,1,2,0,0,0,
01/06/2017,JAL.,"TLAQUEPAQUE, JAL.",0,1,1,0,0,120,
01/06/2017,JAL.,"TONALA, JAL.",1,0,1,0,0,0,
01/06/2017,TAB.,"CENTRO, TAB.",0,1,1,0,0,0,
01/06/2017,MICH.,"APATZINGAN, MICH.",0,1,1,0,0,0,
01/06/2017,SON.,"GUAYMAS, SON.",1,0,1,0,0,0,
01/06/2017,SIN.,"CONCORDIA, SIN.",0,0,0,0,1,0,
01/06/2017,CHIH.,"NUEVO CASAS GRANDES, CHIH.",0,0,0,0,0,127,
02/06/2017,SIN.,"SIN., SIN.",9,3,12,0,0,0,
02/06/2017,D.F.,"CUAUHTEMOC, D.F.",0,3,3,0,0,163,
02/06/2017,GRO.,"ATOYAC DE ALVAREZ, GRO.",1,1,2,1,0,0,
02/06/2017,D.F.,"BENITO JUAREZ, D.F.",0,2,2,0,0,10000,
02/06/2017,DGO.,"DGO., DGO.",0,2,2,3,0,0,
02/06/2017,TAMPS.,"NUEVO LAREDO, TAMPS.",1,0,1,0,0,0,
02/06/2017,AGS.,"AGS., AGS.",1,0,1,15,0,57,
02/06/2017,SIN.,"CONCORDIA, SIN.",0,1,1,0,0,0,
02/06/2017,JAL.,"TLAQUEPAQUE, JAL.",1,0,1,0,0,0,
02/06/2017,JAL.,"TONALA, JAL.",0,1,1,0,0,0,
02/06/2017,TLAX.,"TLAX., TLAX.",1,0,1,0,0,0,
02/06/2017,TLAX.,"HUAMANTLA, TLAX.",0,1,1,0,0,0,
02/06/2017,JAL.,"TLAJOMULCO DE ZUÑIGA, JAL.",0,0,0,0,0,92,
03/06/2017,CHIH.,"HGO. DEL PARRAL, CHIH.",6,2,8,6,0,5740,
03/06/2017,GRO.,"ATOYAC DE ALVAREZ, GRO.",1,2,3,3,0,0,
03/06/2017,TAMPS.,"MATAMOROS, TAMPS.",2,1,3,0,0,0,
03/06/2017,QRO.,"COLON, QRO.",3,0,3,0,0,0,
03/06/2017,MOR.,"CUERNAVACA, MOR.",2,0,2,0,2,335,
03/06/2017,JAL.,"TLAQUEPAQUE, JAL.",0,2,2,0,0,335,
03/06/2017,N.L.,"SAN PEDRO GARZA GARCIA, N.L.",1,0,1,0,0,100,
03/06/2017,JAL.,"TONALA, JAL.",0,1,1,0,0,0,
04/06/2017,MOR.,"CUERNAVACA, MOR.",4,0,4,0,2,134,
04/06/2017,CHIH.,"HGO. DEL PARRAL, CHIH.",3,1,4,1,0,3350,
04/06/2017,JAL.,"TLAQUEPAQUE, JAL.",0,3,3,0,0,0,
04/06/2017,GRO.,"ATOYAC DE ALVAREZ, GRO.",2,0,2,2,0,0,
04/06/2017,TAMPS.,"MATAMOROS, TAMPS.",0,2,2,0,0,0,
04/06/2017,DGO.,"DGO., DGO.",0,1,1,1,2,0,
04/06/2017,JAL.,"TLAJOMULCO DE ZUÑIGA, JAL.",1,0,1,7,0,68,
04/06/2017,JAL.,"TONALA, JAL.",0,1,1,0,0,0,
04/06/2017,JAL.,"ZAPOPAN, JAL.",1,0,1,5,0,162,
04/06/2017,QRO.,"COLON, QRO.",0,1,1,0,2,0,
05/06/2017,CHIS.,"COMITAN DE DOMÍNGUEZ, CHIS.",5,0,5,0,0,90,
05/06/2017,CHIS.,"TAPACHULA, CHIS.",4,0,4,2,0,124,
05/06/2017,JAL.,"TONALA, JAL.",1,3,4,2,0,20,
05/06/2017,TAB.,"TENOSIQUE, TAB.",0,4,4,0,0,0,
05/06/2017,N.L.,"SAN PEDRO GARZA GARCIA, N.L.",1,3,4,0,0,0,
05/06/2017,CHIS.,"TUXTLA GUTIÉRREZ, CHIS.",3,1,4,0,0,310,
05/06/2017,CHIS.,"SAN CRISTOBAL DE LAS CASAS, CHIS.",4,0,4,0,0,0,
05/06/2017,MOR.,"CUERNAVACA, MOR.",3,0,3,3,1,519,
05/06/2017,CHIS.,"VILLAFLORES, CHIS.",1,0,1,0,0,0,
05/06/2017,TAB.,"CENTRO, TAB.",1,0,1,0,0,0,
05/06/2017,D.F.,"GUSTAVO A. MADERO, D.F.",1,0,1,0,0,15,
05/06/2017,JAL.,"TLAJOMULCO DE ZUÑIGA, JAL.",0,1,1,5,0,0,
05/06/2017,DGO.,"DGO., DGO.",0,1,1,2,0,0,
05/06/2017,CHIS.,"TONALÁ, CHIS.",1,0,1,0,0,3,
05/06/2017,TAMPS.,"NUEVO LAREDO, TAMPS.",0,0,0,6,0,0,
06/06/2017,CHIS.,"TUXTLA GUTIÉRREZ, CHIS.",10,6,16,35,0,921,
06/06/2017,CHIS.,"SAN CRISTOBAL DE LAS CASAS, CHIS.",3,4,7,4,0,0,
06/06/2017,MOR.,"CUERNAVACA, MOR.",4,2,6,1,0,304,
06/06/2017,CHIS.,"VILLAFLORES, CHIS.",4,2,6,0,0,100,
06/06/2017,CHIS.,"VILLAFLORES, CHIS.",4,2,6,0,0,100,
06/06/2017,CHIS.,"CHIAPA DE CORZO, CHIS.",3,1,4,0,0,0,
06/06/2017,CHIS.,"COMITAN DE DOMÍNGUEZ, CHIS.",1,2,3,2,0,120,
06/06/2017,TAB.,"CENTRO, TAB.",2,0,2,0,0,0,
06/06/2017,DGO.,"DGO., DGO.",2,0,2,2,0,0,
06/06/2017,JAL.,"TONALA, JAL.",0,2,2,0,0,0,
06/06/2017,TAMPS.,"MIER, TAMPS.",1,1,2,0,0,0,
06/06/2017,CHIS.,"TAPACHULA, CHIS.",1,1,2,2,2,415,
06/06/2017,CHIS.,"PALENQUE, CHIS.",1,1,2,0,0,17,
06/06/2017,D.F.,"GUSTAVO A. MADERO, D.F.",1,0,1,0,0,2851,
06/06/2017,CHIS.,"TONALÁ, CHIS.",0,1,1,10,0,611,
06/06/2017,N.L.,"SANTA CATARINA, N.L.",1,0,1,0,0,0,
06/06/2017,TLAX.,"CHIAUTEMPAN, TLAX.",1,0,1,0,0,0,
06/06/2017,MICH.,"TLALPUJAHUA, MICH.",0,0,0,0,2,0,
06/06/2017,AGS.,"AGS., AGS.",0,0,0,10,0,0,
06/06/2017,JAL.,"TLAQUEPAQUE, JAL.",0,0,0,0,0,100,
06/06/2017,JAL.,"TLAJOMULCO DE ZUÑIGA, JAL.",0,0,0,3,2,29,
06/06/2017,CHIH.,"NUEVO CASAS GRANDES, CHIH.",0,0,0,0,0,12,
07/06/2017,CHIS.,"TUXTLA GUTIÉRREZ, CHIS.",12,6,18,87,0,432,
07/06/2017,CHIS.,"TAPACHULA, CHIS.",6,0,6,6,0,162,
07/06/2017,CHIS.,"VILLAFLORES, CHIS.",2,4,6,0,0,239,
07/06/2017,TAMPS.,"MIER, TAMPS.",1,5,6,0,0,0,
07/06/2017,B.C.,"TIJUANA, B.C.",4,1,5,0,0,0,
07/06/2017,MOR.,"CUERNAVACA, MOR.",0,5,5,5,1,85,
07/06/2017,TLAX.,"CHIAUTEMPAN, TLAX.",1,4,5,0,0,0,
07/06/2017,CHIS.,"COMITAN DE DOMÍNGUEZ, CHIS.",2,2,4,6,2,610,
07/06/2017,TAMPS.,"TAMPICO, TAMPS.",4,0,4,2,0,142,
07/06/2017,CHIS.,"CHIAPA DE CORZO, CHIS.",1,3,4,4,2,132,
07/06/2017,CHIS.,"SAN CRISTOBAL DE LAS CASAS, CHIS.",3,1,4,4,0,0,
07/06/2017,D.F.,"GUSTAVO A. MADERO, D.F.",3,0,3,0,0,35,
07/06/2017,QRO.,"COLON, QRO.",1,2,3,0,0,0,
07/06/2017,DGO.,"DGO., DGO.",1,1,2,1,0,0,
07/06/2017,N.L.,"SANTA CATARINA, N.L.",2,0,2,2,0,100,
07/06/2017,N.L.,"MONTERREY, N.L.",0,2,2,0,0,0,
07/06/2017,TAB.,"CENTRO, TAB.",2,0,2,1,0,0,
07/06/2017,SON.,"CAJEME, SON.",2,0,2,0,0,253,
07/06/2017,SON.,"NAVOJOA, SON.",2,0,2,0,0,0,
07/06/2017,MICH.,"TLALPUJAHUA, MICH.",0,1,1,0,6,50,
07/06/2017,JAL.,"TLAQUEPAQUE, JAL.",1,0,1,0,2,119,
07/06/2017,JAL.,"ZAPOPAN, JAL.",1,0,1,0,0,0,
07/06/2017,JAL.,"TLAJOMULCO DE ZUÑIGA, JAL.",0,1,1,0,0,0,
07/06/2017,COAH.,"SALTILLO, COAH.",1,0,1,1,0,0,
07/06/2017,TAB.,"CENTRO, TAB.",1,0,1,0,0,0,
07/06/2017,TLAX.,"CUAPIAXTLA, TLAX.",0,1,1,0,0,0,
07/06/2017,SON.,"GUAYMAS, SON.",0,1,1,0,0,0,
07/06/2017,SON.,"HUATABAMPO, SON.",1,0,1,0,0,0,
07/06/2017,JAL.,"TONALA, JAL.",0,0,0,0,0,50,
07/06/2017,CHIS.,"TONALÁ, CHIS.",0,0,0,15,0,1103,
08/06/2017,YUC.,"MERIDA, YUC.",14,0,14,6,0,111,
08/06/2017,CHIS.,"TUXTLA GUTIÉRREZ, CHIS.",6,3,9,33,0,889,
08/06/2017,CHIS.,"SAN CRISTOBAL DE LAS CASAS, CHIS.",1,8,9,0,0,0,
08/06/2017,MOR.,"CUERNAVACA, MOR.",4,2,6,2,5,445,
08/06/2017,CHIS.,"TONALÁ, CHIS.",3,2,5,30,0,629,
08/06/2017,CHIS.,"COMITAN DE DOMÍNGUEZ, CHIS.",2,2,4,24,1,1022,
08/06/2017,CHIS.,"TAPACHULA, CHIS.",2,2,4,10,0,1050,
08/06/2017,YUC.,"KANASIN, YUC.",3,0,3,0,0,0,
08/06/2017,TAB.,"CENTRO, TAB.",2,0,2,0,0,0,
08/06/2017,JAL.,"TLAJOMULCO DE ZUÑIGA, JAL.",0,2,2,0,0,0,
08/06/2017,GRO.,"ATOYAC DE ALVAREZ, GRO.",0,2,2,2,0,0,
08/06/2017,CHIS.,"CHIAPA DE CORZO, CHIS.",2,0,2,16,0,100,
08/06/2017,D.F.,"XOCHIMILCO, D.F.",0,1,1,0,0,398,
08/06/2017,N.L.,"SANTA CATARINA, N.L.",1,0,1,0,0,0,
08/06/2017,N.L.,"CARMEN, N.L.",1,0,1,9,0,0,
08/06/2017,B.C.S.,"COMONDÚ, B.C.S.",1,0,1,0,0,22,
08/06/2017,MICH.,"TLALPUJAHUA, MICH.",1,0,1,0,0,4500,
08/06/2017,JAL.,"GUADALAJARA, JAL.",1,0,1,0,0,0,
08/06/2017,CHIS.,"VILLAFLORES, CHIS.",0,1,1,0,0,0,
08/06/2017,PUE.,"ACAJETE, PUE.",1,0,1,1,0,2,
08/06/2017,SON.,"GUAYMAS, SON.",0,1,1,1,0,0,
08/06/2017,CHIS.,"PALENQUE, CHIS.",0,0,0,0,0,100,
08/06/2017,JAL.,"TLAQUEPAQUE, JAL.",0,0,0,0,0,240,
08/06/2017,SON.,"HUATABAMPO, SON.",0,0,0,1,0,0,
09/06/2017,YUC.,"MERIDA, YUC.",5,3,8,0,0,381,
09/06/2017,B.C.,"TIJUANA, B.C.",0,8,8,0,3,0,
09/06/2017,CHIS.,"VILLAFLORES, CHIS.",3,4,7,0,0,710,
09/06/2017,YUC.,"KANASIN, YUC.",6,0,6,0,0,0,
09/06/2017,D.F.,"GUSTAVO A. MADERO, D.F.",6,0,6,0,0,2,
09/06/2017,N.L.,"SANTA CATARINA, N.L.",5,0,5,0,0,140,
09/06/2017,CHIS.,"TAPACHULA, CHIS.",1,4,5,6,0,1551,
09/06/2017,MOR.,"CUERNAVACA, MOR.",2,3,5,28,1,273,
09/06/2017,QRO.,"QUERETARO, QRO.",1,4,5,0,0,0,
09/06/2017,JAL.,"GUADALAJARA, JAL.",3,1,4,2,0,0,
09/06/2017,TAMPS.,"MATAMOROS, TAMPS.",0,4,4,1,0,26,
09/06/2017,CHIS.,"COMITAN DE DOMÍNGUEZ, CHIS.",1,2,3,16,0,932,
09/06/2017,CHIS.,"PALENQUE, CHIS.",1,1,2,3,0,120,
09/06/2017,JAL.,"ZAPOPAN, JAL.",2,0,2,0,0,0,
09/06/2017,CHIS.,"TONALÁ, CHIS.",1,1,2,28,1,620,
09/06/2017,TAMPS.,"MIER, TAMPS.",2,0,2,4,0,69,
09/06/2017,SIN.,"CONCORDIA, SIN.",2,0,2,0,0,0,
09/06/2017,DGO.,"DGO., DGO.",1,1,2,0,0,0,
09/06/2017,N.L.,"MONTERREY, N.L.",0,1,1,1,0,35,
09/06/2017,CHIS.,"BENEMÉRITO DE LAS AMÉRICAS, CHIS.",1,0,1,1,0,0,
09/06/2017,JAL.,"TLAQUEPAQUE, JAL.",0,1,1,0,0,12,
09/06/2017,JAL.,"TLAJOMULCO DE ZUÑIGA, JAL.",1,0,1,0,0,0,
09/06/2017,PUE.,"ACAJETE, PUE.",1,0,1,0,0,0,
09/06/2017,GRO.,"OLINALA, GRO.",0,1,1,1,0,0,
09/06/2017,TAB.,"CENTRO, TAB.",0,1,1,0,0,0,
09/06/2017,SON.,"HUATABAMPO, SON.",1,0,1,0,0,0,
09/06/2017,N.L.,"CARMEN, N.L.",0,0,0,4,0,0,
09/06/2017,MICH.,"LAZARO CARDENAS, MICH.",0,0,0,0,0,111,
09/06/2017,MICH.,"TLALPUJAHUA, MICH.",0,0,0,0,0,5073,
10/06/2017,CHIS.,"COMITAN DE DOMÍNGUEZ, CHIS.",3,6,9,32,0,1755,
10/06/2017,CHIS.,"VILLAFLORES, CHIS.",4,0,4,11,0,811,
10/06/2017,CHIS.,"PALENQUE, CHIS.",1,3,4,5,0,831,
10/06/2017,CHIS.,"TAPACHULA, CHIS.",2,1,3,40,2,2905,
10/06/2017,JAL.,"TONALA, JAL.",0,3,3,0,0,0,
10/06/2017,JAL.,"TLAJOMULCO DE ZUÑIGA, JAL.",3,0,3,0,0,0,
10/06/2017,TAB.,"CENTRO, TAB.",2,0,2,0,0,0,
10/06/2017,CHIS.,"TONALÁ, CHIS.",1,0,1,15,0,976,
10/06/2017,JAL.,"TLAQUEPAQUE, JAL.",0,1,1,0,0,30,
10/06/2017,MOR.,"CUERNAVACA, MOR.",0,1,1,1,3,11,
10/06/2017,TAMPS.,"MATAMOROS, TAMPS.",1,0,1,1,0,57,
10/06/2017,DGO.,"DGO., DGO.",1,0,1,1,0,0,
10/06/2017,N.L.,"CARMEN, N.L.",1,0,1,8,0,50,
11/06/2017,JAL.,"ZAPOPAN, JAL.",5,0,5,0,0,121,
11/06/2017,TLAX.,"CHIAUTEMPAN, TLAX.",0,2,2,0,0,0,
11/06/2017,MOR.,"CUERNAVACA, MOR.",0,1,1,1,0,176,
11/06/2017,GRO.,"ATOYAC DE ALVAREZ, GRO.",1,0,1,1,0,54,
11/06/2017,N.L.,"CARMEN, N.L.",0,0,0,5,0,0,
11/06/2017,JAL.,"TLAQUEPAQUE, JAL.",0,0,0,0,0,140,
11/06/2017,JAL.,"TLAJOMULCO DE ZUÑIGA, JAL.",0,0,0,0,0,58,
12/06/2017,YUC.,"MERIDA, YUC.",6,4,10,0,0,30,
12/06/2017,D.F.,"GUSTAVO A. MADERO, D.F.",7,0,7,0,5,89,
12/06/2017,COAH.,"SALTILLO, COAH.",4,3,7,0,0,0,
12/06/2017,ZAC.,"VILLA DE COS, ZAC.",1,2,3,0,0,0,
12/06/2017,ZAC.,"GENERAL FRANCISCO R. MURGUIA, ZAC.",1,2,3,0,0,0,
12/06/2017,SIN.,"CHOIX, SIN.",1,1,2,0,0,0,
12/06/2017,JAL.,"TONALA, JAL.",0,2,2,0,0,0,
12/06/2017,JAL.,"TLAJOMULCO DE ZUÑIGA, JAL.",1,1,2,1,0,125,
12/06/2017,B.C.,"ENSENADA, B.C.",0,1,1,0,0,0,
12/06/2017,SIN.,"SALVADOR ALVARADO, SIN.",0,1,1,0,0,0,
12/06/2017,JAL.,"GUADALAJARA, JAL.",1,0,1,0,0,0,
12/06/2017,JAL.,"TLAQUEPAQUE, JAL.",0,1,1,3,0,0,
12/06/2017,AGS.,"ASIENTOS, AGS.",0,0,0,1,0,0,
12/06/2017,MOR.,"CUERNAVACA, MOR.",0,0,0,2,1,21,
12/06/2017,GRO.,"ATOYAC DE ALVAREZ, GRO.",0,0,0,0,0,659,
13/06/2017,MEX.,"NEZAHUALCOYOTL, MEX.",10,0,10,3,0,25,
13/06/2017,MEX.,"CUAUTITLAN IZCALLI, MEX.",7,0,7,2,1,1,
13/06/2017,SIN.,"SALVADOR ALVARADO, SIN.",1,3,4,0,0,0,
13/06/2017,ZAC.,"GENERAL FRANCISCO R. MURGUIA, ZAC.",3,1,4,3,0,0,
13/06/2017,GTO.,"PURISIMA DEL RINCON, GTO.",3,0,3,0,0,0,
13/06/2017,SIN.,"CHOIX, SIN.",2,0,2,0,0,0,
13/06/2017,DGO.,"DGO., DGO.",0,1,1,1,0,0,
13/06/2017,SIN.,"ROSARIO, SIN.",0,1,1,0,1,0,
13/06/2017,JAL.,"GUADALAJARA, JAL.",1,0,1,0,0,0,
13/06/2017,JAL.,"TONALA, JAL.",1,0,1,0,0,35,
13/06/2017,D.F.,"GUSTAVO A. MADERO, D.F.",0,1,1,0,0,1420,
13/06/2017,B.C.,"TIJUANA, B.C.",1,0,1,0,0,0,
13/06/2017,N.L.,"MONTERREY, N.L.",1,0,1,300,0,0,
13/06/2017,JAL.,"TLAQUEPAQUE, JAL.",0,0,0,0,0,200,
13/06/2017,JAL.,"ZAPOPAN, JAL.",0,0,0,0,0,652,
13/06/2017,TAMPS.,"TAMPICO, TAMPS.",0,0,0,3,0,19,
13/06/2017,N.L.,"CARMEN, N.L.",0,0,0,57,0,0,
14/06/2017,MEX.,"NEZAHUALCOYOTL, MEX.",8,2,10,2,0,281,
14/06/2017,D.F.,"GUSTAVO A. MADERO, D.F.",7,1,8,0,0,106,
14/06/2017,SIN.,"CHOIX, SIN.",2,4,6,0,0,0,
14/06/2017,JAL.,"ZAPOPAN, JAL.",3,2,5,0,0,0,
14/06/2017,SIN.,"SALVADOR ALVARADO, SIN.",2,1,3,0,6,0,
14/06/2017,COAH.,"SALTILLO, COAH.",2,1,3,0,2,27,
14/06/2017,GTO.,"PURISIMA DEL RINCON, GTO.",1,2,3,0,0,0,
14/06/2017,MEX.,"CUAUTITLAN IZCALLI, MEX.",3,0,3,1,0,0,
14/06/2017,TLAX.,"SAN PABLO DEL MONTE, TLAX.",1,2,3,0,0,0,
14/06/2017,N.L.,"SANTA CATARINA, N.L.",2,0,2,0,0,134,
14/06/2017,JAL.,"TLAQUEPAQUE, JAL.",0,2,2,0,0,0,
14/06/2017,CHIH.,"HGO. DEL PARRAL, CHIH.",1,1,2,0,0,0,
14/06/2017,AGS.,"ASIENTOS, AGS.",0,1,1,0,0,0,
14/06/2017,COAH.,"TORREÓN, COAH.",1,0,1,0,0,0,
14/06/2017,SIN.,"ROSARIO, SIN.",1,0,1,0,1,0,
14/06/2017,MICH.,"LAZARO CARDENAS, MICH.",1,0,1,1,0,0,
14/06/2017,COAH.,"PIEDRAS NEGRAS, COAH.",0,1,1,0,0,0,
14/06/2017,COAH.,"MÚZQUIZ, COAH.",1,0,1,0,0,98,
14/06/2017,COAH.,"ACUÑA, COAH.",0,1,1,0,0,0,
14/06/2017,N.L.,"MONTERREY, N.L.",1,0,1,0,0,81,
14/06/2017,B.C.,"ENSENADA, B.C.",1,0,1,0,0,0,
14/06/2017,JAL.,"GUADALAJARA, JAL.",1,0,1,1,0,20,
14/06/2017,COAH.,"MATAMOROS, COAH.",0,0,0,1,0,0,
14/06/2017,COAH.,"MONCLOVA, COAH.",0,0,0,2,0,164,
14/06/2017,SON.,"CAJEME, SON.",0,0,0,3,0,0,
15/06/2017,MEX.,"NEZAHUALCOYOTL, MEX.",8,0,8,4,6,51,
15/06/2017,MEX.,"CUAUTITLAN IZCALLI, MEX.",7,1,8,8,1,10,
15/06/2017,N.L.,"MONTERREY, N.L.",5,0,5,0,0,0,
15/06/2017,SIN.,"CHOIX, SIN.",3,1,4,0,0,0,
15/06/2017,JAL.,"ZAPOPAN, JAL.",4,0,4,0,0,0,
15/06/2017,D.F.,"GUSTAVO A. MADERO, D.F.",2,0,2,0,0,106,
15/06/2017,SIN.,"ROSARIO, SIN.",1,1,2,0,0,0,
15/06/2017,B.C.,"TIJUANA, B.C.",0,2,2,0,3,0,
15/06/2017,JAL.,"GUADALAJARA, JAL.",2,0,2,0,0,0,
15/06/2017,JAL.,"TLAJOMULCO DE ZUÑIGA, JAL.",2,0,2,0,0,0,
15/06/2017,DGO.,"DGO., DGO.",1,1,2,6,0,0,
15/06/2017,GTO.,"PURISIMA DEL RINCON, GTO.",0,1,1,0,0,0,
15/06/2017,GRO.,"LA UNION DE ISIDORO MONTES DE OCA, GRO.",1,0,1,0,0,0,
15/06/2017,COAH.,"SAN PEDRO, COAH.",1,0,1,0,0,0,
15/06/2017,COAH.,"SALTILLO, COAH.",1,0,1,0,0,194,
15/06/2017,SIN.,"SALVADOR ALVARADO, SIN.",1,0,1,0,0,0,
15/06/2017,N.L.,"SANTA CATARINA, N.L.",1,0,1,300,0,0,
15/06/2017,JAL.,"TONALA, JAL.",1,0,1,0,0,0,
15/06/2017,OAX.,"SAN DIONISIO DEL MAR, OAX.",1,0,1,0,0,0,
15/06/2017,MICH.,"LAZARO CARDENAS, MICH.",0,0,0,3,0,207,
15/06/2017,JAL.,"TLAQUEPAQUE, JAL.",0,0,0,0,0,631,
16/06/2017,MEX.,"NEZAHUALCOYOTL, MEX.",9,0,9,11,0,740,
16/06/2017,TAMPS.,"MATAMOROS, TAMPS.",2,2,4,0,0,6,
16/06/2017,JAL.,"TLAQUEPAQUE, JAL.",0,2,2,0,0,0,
16/06/2017,B.C.,"TIJUANA, B.C.",1,1,2,0,0,0,
16/06/2017,COAH.,"FRANCISCO I. MADERO, COAH.",1,1,2,0,0,0,
16/06/2017,COAH.,"PIEDRAS NEGRAS, COAH.",1,1,2,0,0,0,
16/06/2017,MEX.,"CUAUTITLAN IZCALLI, MEX.",2,0,2,1,2,7,
16/06/2017,SIN.,"CHOIX, SIN.",2,0,2,0,0,0,
16/06/2017,N.L.,"MONTERREY, N.L.",1,1,2,1,3,104,
16/06/2017,COAH.,"SAN PEDRO, COAH.",1,1,2,0,0,0,
16/06/2017,JAL.,"GUADALAJARA, JAL.",0,1,1,0,0,0,
16/06/2017,JAL.,"ZAPOPAN, JAL.",1,0,1,0,0,0,
16/06/2017,COAH.,"TORREÓN, COAH.",1,0,1,0,0,0,
16/06/2017,COAH.,"FRANCISCO I. MADERO, COAH.",1,0,1,0,0,0,
16/06/2017,COAH.,"MONCLOVA, COAH.",1,0,1,0,0,0,
16/06/2017,SIN.,"ROSARIO, SIN.",0,1,1,0,0,0,
16/06/2017,TAB.,"JALPA DE MENDEZ, TAB.",0,1,1,0,0,0,
16/06/2017,YUC.,"TIXKOKOB, YUC.",0,1,1,0,0,0,
16/06/2017,OAX.,"SAN DIONISIO DEL MAR, OAX.",0,1,1,0,0,0,
16/06/2017,MEX.,"IXTAPAN DEL ORO, MEX.",1,0,1,0,0,0,
16/06/2017,TLAX.,"SAN PABLO DEL MONTE, TLAX.",1,0,1,0,0,0,
16/06/2017,COAH.,"SALTILLO, COAH.",0,0,0,0,0,250,
16/06/2017,GRO.,"PETATLAN, GRO.",0,0,0,0,1,0,
16/06/2017,SIN.,"SALVADOR ALVARADO, SIN.",0,0,0,0,3,0,
16/06/2017,PUE.,"AMOZOC, PUE.",0,0,0,0,0,120,
17/06/2017,CHIH.,"OJINAGA, CHIH.",4,1,5,0,0,0,
17/06/2017,TAMPS.,"MATAMOROS, TAMPS.",2,1,3,2,0,203,
17/06/2017,SON.,"NAVOJOA, SON.",2,0,2,0,0,0,
17/06/2017,JAL.,"GUADALAJARA, JAL.",0,1,1,0,1,0,
17/06/2017,JAL.,"TLAQUEPAQUE, JAL.",0,1,1,0,0,0,
17/06/2017,JAL.,"TLAJOMULCO DE ZUÑIGA, JAL.",1,0,1,0,0,0,
17/06/2017,JAL.,"TONALA, JAL.",0,1,1,0,0,0,
17/06/2017,JAL.,"ZAPOPAN, JAL.",0,1,1,0,0,0,
17/06/2017,B.C.,"ENSENADA, B.C.",1,0,1,0,0,0,
17/06/2017,COAH.,"FRONTERA, COAH.",0,0,0,0,0,49,
17/06/2017,N.L.,"CARMEN, N.L.",0,0,0,5,0,0,
18/06/2017,B.C.,"ENSENADA, B.C.",0,2,2,0,0,0,
18/06/2017,MEX.,"NEZAHUALCOYOTL, MEX.",1,1,2,0,0,178,
18/06/2017,JAL.,"TLAJOMULCO DE ZUÑIGA, JAL.",1,1,2,6,1,169,
18/06/2017,JAL.,"GUADALAJARA, JAL.",1,0,1,0,0,0,
18/06/2017,JAL.,"TLAQUEPAQUE, JAL.",1,0,1,0,0,0,
18/06/2017,DGO.,"DGO., DGO.",1,0,1,0,0,0,
18/06/2017,TLAX.,"SAN PABLO DEL MONTE, TLAX.",1,0,1,0,0,0,
18/06/2017,MEX.,"CUAUTITLAN IZCALLI, MEX.",0,0,0,0,1,0,
18/06/2017,N.L.,"CARMEN, N.L.",0,0,0,0,0,35,
19/06/2017,JAL.,"ZAPOPAN, JAL.",3,0,3,0,0,295,
19/06/2017,COAH.,"SALTILLO, COAH.",3,0,3,0,0,24,
19/06/2017,B.C.,"ENSENADA, B.C.",0,2,2,0,0,0,
19/06/2017,DGO.,"DGO., DGO.",0,2,2,0,1,0,
19/06/2017,N.L.,"SANTA CATARINA, N.L.",1,1,2,0,0,0,
19/06/2017,JAL.,"GUADALAJARA, JAL.",1,0,1,0,0,22,
19/06/2017,JAL.,"TLAQUEPAQUE, JAL.",1,0,1,0,0,122,
19/06/2017,COAH.,"TORREÓN, COAH.",1,0,1,0,0,0,
19/06/2017,COAH.,"FRANCISCO I. MADERO, COAH.",1,0,1,0,0,0,
19/06/2017,COAH.,"MÚZQUIZ, COAH.",1,0,1,0,0,0,
19/06/2017,AGS.,"ASIENTOS, AGS.",1,0,1,0,0,16,
19/06/2017,D.F.,"GUSTAVO A. MADERO, D.F.",0,1,1,0,0,0,
19/06/2017,JAL.,"TLAJOMULCO DE ZUÑIGA, JAL.",0,0,0,3,0,58,
19/06/2017,SIN.,"ROSARIO, SIN.",0,0,0,0,2,0,
19/06/2017,B.C.,"TIJUANA, B.C.",0,0,0,0,1,0,
20/06/2017,SIN.,"CHOIX, SIN.",4,1,5,0,0,0,
20/06/2017,DGO.,"DGO., DGO.",3,0,3,2,0,0,
20/06/2017,JAL.,"TLAQUEPAQUE, JAL.",1,1,2,0,0,0,
20/06/2017,JAL.,"TONALA, JAL.",0,2,2,0,0,0,
20/06/2017,COAH.,"ACUÑA, COAH.",2,0,2,0,0,0,
20/06/2017,CHIH.,"NUEVO CASAS GRANDES, CHIH.",0,2,2,0,0,191,
20/06/2017,SIN.,"SALVADOR ALVARADO, SIN.",2,0,2,0,0,0,
20/06/2017,TLAX.,"TLAXCO, TLAX.",1,0,1,0,0,0,
20/06/2017,MEX.,"ISIDRO FABELA, MEX.",0,1,1,0,0,0,
20/06/2017,SON.,"HERMOSILLO, SON.",1,0,1,1,0,0,
20/06/2017,SON.,"GUAYMAS, SON.",1,0,1,0,0,0,
20/06/2017,QRO.,"PEDRO ESCOBEDO, QRO.",1,0,1,0,0,0,
20/06/2017,JAL.,"GUADALAJARA, JAL.",1,0,1,0,0,0,
20/06/2017,COAH.,"SALTILLO, COAH.",0,1,1,0,0,66,
20/06/2017,COAH.,"FRANCISCO I. MADERO, COAH.",1,0,1,0,0,0,
20/06/2017,COAH.,"PIEDRAS NEGRAS, COAH.",1,0,1,0,0,650,
20/06/2017,N.L.,"SANTA CATARINA, N.L.",1,0,1,0,0,200,
20/06/2017,N.L.,"CARMEN, N.L.",0,1,1,3,0,0,
20/06/2017,MEX.,"JIQUIPILCO, MEX.",0,0,0,0,0,352,
20/06/2017,JAL.,"TLAJOMULCO DE ZUÑIGA, JAL.",0,0,0,1,0,61,
20/06/2017,N.L.,"MONTERREY, N.L.",0,0,0,1,0,85,
21/06/2017,QRO.,"PEDRO ESCOBEDO, QRO.",6,3,9,0,0,0,
21/06/2017,TLAX.,"IXTACUIXTLA DE MARIANO MATAMOROS, TLAX.",2,3,5,0,0,0,
21/06/2017,COAH.,"TORREÓN, COAH.",1,2,3,0,0,0,
21/06/2017,MOR.,"TEPOZTLAN, MOR.",3,0,3,0,0,287,
21/06/2017,SIN.,"CHOIX, SIN.",2,1,3,0,0,0,
21/06/2017,MEX.,"JIQUIPILCO, MEX.",1,1,2,0,0,367,
21/06/2017,JAL.,"GUADALAJARA, JAL.",2,0,2,0,0,0,
21/06/2017,JAL.,"TLAQUEPAQUE, JAL.",1,1,2,0,0,0,
21/06/2017,COAH.,"SALTILLO, COAH.",2,0,2,0,0,0,
21/06/2017,SIN.,"SALVADOR ALVARADO, SIN.",2,0,2,0,0,0,
21/06/2017,DGO.,"DGO., DGO.",0,2,2,0,0,0,
21/06/2017,TLAX.,"TLAXCO, TLAX.",1,1,2,0,0,0,
21/06/2017,COAH.,"MATAMOROS, COAH.",1,0,1,0,0,0,
21/06/2017,MEX.,"ISIDRO FABELA, MEX.",0,1,1,0,0,0,
21/06/2017,COAH.,"MONCLOVA, COAH.",1,0,1,1,0,31,
21/06/2017,TAB.,"BALANCAN, TAB.",0,1,1,0,0,0,
21/06/2017,N.L.,"MONTERREY, N.L.",1,0,1,0,0,0,
21/06/2017,SIN.,"ROSARIO, SIN.",0,1,1,0,0,0,
21/06/2017,TAB.,"CUNDUACAN, TAB.",1,0,1,0,0,0,
21/06/2017,JAL.,"TLAJOMULCO DE ZUÑIGA, JAL.",0,0,0,2,0,31,
21/06/2017,JAL.,"ZAPOPAN, JAL.",0,0,0,0,0,109,
21/06/2017,N.L.,"SANTA CATARINA, N.L.",0,0,0,2,0,100,
21/06/2017,D.F.,"GUSTAVO A. MADERO, D.F.",0,0,0,0,1,65,
21/06/2017,AGS.,"ASIENTOS, AGS.",0,0,0,10,0,0,
22/06/2017,QRO.,"PEDRO ESCOBEDO, QRO.",2,2,4,0,0,0,
22/06/2017,SIN.,"CHOIX, SIN.",2,2,4,0,0,0,
22/06/2017,COAH.,"TORREÓN, COAH.",1,2,3,0,0,0,
22/06/2017,TLAX.,"TLAXCO, TLAX.",0,2,2,0,0,0,
22/06/2017,COAH.,"MONCLOVA, COAH.",2,0,2,0,0,115,
22/06/2017,MEX.,"ALMOLOYA DE JUAREZ, MEX.",1,0,1,1,0,0,
22/06/2017,MEX.,"JIQUIPILCO, MEX.",0,1,1,0,0,0,
22/06/2017,MEX.,"ISIDRO FABELA, MEX.",0,1,1,0,0,0,
22/06/2017,JAL.,"TLAQUEPAQUE, JAL.",0,1,1,0,0,120,
22/06/2017,JAL.,"ZAPOPAN, JAL.",1,0,1,0,1,0,
22/06/2017,GRO.,"PUNGARABATO, GRO.",1,0,1,0,0,0,
22/06/2017,TLAX.,"IXTACUIXTLA DE MARIANO MATAMOROS, TLAX.",0,1,1,0,0,67,
22/06/2017,COAH.,"NUEVA ROSITA, COAH.",1,0,1,0,0,0,
22/06/2017,SIN.,"ROSARIO, SIN.",0,1,1,0,0,0,
22/06/2017,B.C.,"ENSENADA, B.C.",0,0,0,0,1,0,
22/06/2017,JAL.,"TLAJOMULCO DE ZUÑIGA, JAL.",0,0,0,0,1,243,
22/06/2017,D.F.,"GUSTAVO A. MADERO, D.F.",0,0,0,0,0,1978,
22/06/2017,COAH.,"SALTILLO, COAH.",0,0,0,0,0,16,
23/06/2017,SIN.,"CHOIX, SIN.",3,3,6,0,0,0,
23/06/2017,JAL.,"TLAQUEPAQUE, JAL.",3,1,4,0,0,117,
23/06/2017,B.C.,"TIJUANA, B.C.",0,3,3,0,0,0,
23/06/2017,D.F.,"GUSTAVO A. MADERO, D.F.",3,0,3,0,0,0,
23/06/2017,YUC.,"PROGRESO, YUC.",2,1,3,0,0,0,
23/06/2017,TAMPS.,"MATAMOROS, TAMPS.",2,1,3,5,0,0,
23/06/2017,GRO.,"PUNGARABATO, GRO.",1,1,2,0,0,0,
23/06/2017,COAH.,"SALTILLO, COAH.",2,0,2,0,0,0,
23/06/2017,JAL.,"ZAPOPAN, JAL.",2,0,2,0,0,100,
23/06/2017,GRO.,"OLINALA, GRO.",0,1,1,0,0,0,
23/06/2017,B.C.,"ENSENADA, B.C.",0,1,1,0,0,0,
23/06/2017,COAH.,"MATAMOROS, COAH.",0,1,1,0,0,0,
23/06/2017,COAH.,"SAN PEDRO, COAH.",1,0,1,0,0,0,
23/06/2017,COAH.,"PIEDRAS NEGRAS, COAH.",0,1,1,0,0,104,
23/06/2017,QRO.,"PEDRO ESCOBEDO, QRO.",1,0,1,0,0,0,
23/06/2017,DGO.,"DGO., DGO.",1,0,1,0,0,0,
23/06/2017,SIN.,"ROSARIO, SIN.",1,0,1,0,0,0,
23/06/2017,ZAC.,"GENERAL FRANCISCO R. MURGUIA, ZAC.",1,0,1,0,0,0,
23/06/2017,MOR.,"TEPOZTLAN, MOR.",0,0,0,2,6,103,
24/06/2017,MOR.,"TEPOZTLAN, MOR.",3,2,5,2,0,70,
24/06/2017,B.C.,"TIJUANA, B.C.",0,3,3,0,0,0,
24/06/2017,JAL.,"ZAPOPAN, JAL.",1,2,3,0,0,1700,
24/06/2017,JAL.,"TLAJOMULCO DE ZUÑIGA, JAL.",2,0,2,1,0,46,
24/06/2017,COAH.,"MONCLOVA, COAH.",2,0,2,0,0,0,
24/06/2017,TLAX.,"IXTACUIXTLA DE MARIANO MATAMOROS, TLAX.",1,0,1,0,0,0,
24/06/2017,TLAX.,"TLAXCO, TLAX.",0,1,1,0,0,0,
24/06/2017,B.C.,"ENSENADA, B.C.",0,1,1,0,0,0,
24/06/2017,JAL.,"GUADALAJARA, JAL.",1,0,1,0,0,200,
24/06/2017,JAL.,"TLAQUEPAQUE, JAL.",1,0,1,0,0,125,
24/06/2017,TAMPS.,"MATAMOROS, TAMPS.",0,1,1,0,0,26,
24/06/2017,MEX.,"JIQUIPILCO, MEX.",0,0,0,0,4,0,
24/06/2017,COAH.,"SALTILLO, COAH.",0,0,0,2,0,439,
24/06/2017,DGO.,"DGO., DGO.",0,0,0,6,0,0,
25/06/2017,MEX.,"ISIDRO FABELA, MEX.",0,2,2,0,0,0,
25/06/2017,MEX.,"HUEYPOXTLA, MEX.",1,0,1,1,0,1,
25/06/2017,TLAX.,"TLAXCO, TLAX.",0,0,0,0,1,0,
25/06/2017,MEX.,"JIQUIPILCO, MEX.",0,0,0,0,0,147,
26/06/2017,JAL.,"ZAPOTLANEJO, JAL.",4,0,4,0,0,0,
26/06/2017,B.C.,"TIJUANA, B.C.",0,3,3,0,0,0,
26/06/2017,SIN.,"CHOIX, SIN.",2,1,3,0,0,0,
26/06/2017,COAH.,"SALTILLO, COAH.",1,1,2,0,0,0,
26/06/2017,COAH.,"MONCLOVA, COAH.",1,1,2,0,0,0,
26/06/2017,JAL.,"IXTLAHUACAN DE LOS MEMBRILLOS, JAL.",0,2,2,0,0,125,
26/06/2017,SIN.,"SALVADOR ALVARADO, SIN.",1,1,2,0,6,0,
26/06/2017,D.F.,"IZTAPALAPA, D.F.",2,0,2,0,2,0,
26/06/2017,GRO.,"COYUCA DE BENITEZ, GRO.",0,1,1,0,0,0,
26/06/2017,SON.,"HUATABAMPO, SON.",0,1,1,0,0,0,
26/06/2017,N.L.,"MONTERREY, N.L.",1,0,1,1,0,22,
26/06/2017,MOR.,"TEPOZTLAN, MOR.",1,0,1,0,0,0,
26/06/2017,JAL.,"EL SALTO, JAL.",1,0,1,0,1,0,
26/06/2017,Q. ROO,"COZUMEL, Q. ROO",0,0,0,0,0,30,
27/06/2017,MEX.,"JOCOTITLAN, MEX.",1,7,8,0,0,0,
27/06/2017,SIN.,"SALVADOR ALVARADO, SIN.",1,3,4,0,3,0,
27/06/2017,COAH.,"PIEDRAS NEGRAS, COAH.",2,0,2,2,0,5,
27/06/2017,JAL.,"IXTLAHUACAN DE LOS MEMBRILLOS, JAL.",1,1,2,0,0,0,
27/06/2017,B.C.,"TIJUANA, B.C.",1,0,1,0,0,0,
27/06/2017,B.C.,"ENSENADA, B.C.",0,1,1,0,0,0,
27/06/2017,GRO.,"OLINALA, GRO.",1,0,1,0,0,0,
27/06/2017,COAH.,"FRANCISCO I. MADERO, COAH.",1,0,1,0,0,0,
27/06/2017,COAH.,"MÚZQUIZ, COAH.",1,0,1,0,0,0,
27/06/2017,COAH.,"ACUÑA, COAH.",0,1,1,0,0,0,
27/06/2017,JAL.,"EL SALTO, JAL.",0,1,1,2,0,250,
27/06/2017,N.L.,"CADEREYTA JIMENEZ, N.L.",1,0,1,0,0,19,
27/06/2017,SIN.,"CHOIX, SIN.",1,0,1,0,0,0,
27/06/2017,MICH.,"BUENAVISTA, MICH.",1,0,1,0,0,0,
27/06/2017,Q. ROO,"COZUMEL, Q. ROO",1,0,1,0,0,404,
27/06/2017,COAH.,"SALTILLO, COAH.",0,0,0,20,0,80,
27/06/2017,MEX.,"ATLAUTLA, MEX.",0,0,0,0,9,10,
27/06/2017,D.F.,"IZTAPALAPA, D.F.",0,0,0,0,1,0,
27/06/2017,N.L.,"MONTERREY, N.L.",0,0,0,2,0,131,
27/06/2017,AGS.,"COSÍO, AGS.",0,0,0,2,0,0,
28/06/2017,COAH.,"MONCLOVA, COAH.",4,0,4,0,0,0,
28/06/2017,B.C.,"TIJUANA, B.C.",0,4,4,0,0,0,
28/06/2017,MEX.,"JOCOTITLAN, MEX.",1,1,2,0,2,0,
28/06/2017,COAH.,"SALTILLO, COAH.",2,0,2,0,0,0,
28/06/2017,MICH.,"BUENAVISTA, MICH.",1,1,2,0,0,0,
28/06/2017,TLAX.,"ZACATELCO, TLAX.",1,0,1,0,0,0,
28/06/2017,GRO.,"PUNGARABATO, GRO.",1,0,1,0,0,0,
28/06/2017,COAH.,"TORREÓN, COAH.",1,0,1,0,0,0,
28/06/2017,COAH.,"ACUÑA, COAH.",0,1,1,0,0,0,
28/06/2017,JAL.,"EL SALTO, JAL.",1,0,1,3,0,26,
28/06/2017,SIN.,"SALVADOR ALVARADO, SIN.",1,0,1,0,0,0,
28/06/2017,Q. ROO,"COZUMEL, Q. ROO",1,0,1,0,0,316,
28/06/2017,CHIH.,"GUADALUPE, CHIH.",0,0,0,2,0,71,
28/06/2017,JAL.,"IXTLAHUACAN DE LOS MEMBRILLOS, JAL.",0,0,0,0,0,120,
28/06/2017,DGO.,"DGO., DGO.",0,0,0,2,0,0,
28/06/2017,N.L.,"MONTERREY, N.L.",0,0,0,0,0,600,
29/06/2017,COAH.,"SAN PEDRO, COAH.",1,2,3,0,0,0,
29/06/2017,MICH.,"BUENAVISTA, MICH.",1,1,2,0,0,0,
29/06/2017,MEX.,"ATLAUTLA, MEX.",2,0,2,0,0,122,
29/06/2017,COAH.,"PIEDRAS NEGRAS, COAH.",1,1,2,4,0,104,
29/06/2017,SIN.,"SALVADOR ALVARADO, SIN.",2,0,2,0,0,0,
29/06/2017,JAL.,"IXTLAHUACAN DE LOS MEMBRILLOS, JAL.",0,2,2,0,0,100,
29/06/2017,JAL.,"EL SALTO, JAL.",0,2,2,0,0,0,
29/06/2017,MOR.,"TEPOZTLAN, MOR.",1,0,1,1,0,0,
29/06/2017,COAH.,"TORREÓN, COAH.",1,0,1,0,0,98,
29/06/2017,COAH.,"SALTILLO, COAH.",1,0,1,41,0,0,
29/06/2017,COAH.,"ACUÑA, COAH.",0,1,1,0,0,0,
29/06/2017,SIN.,"ROSARIO, SIN.",1,0,1,0,0,0,
29/06/2017,JAL.,"ZAPOTLANEJO, JAL.",1,0,1,0,0,0,
29/06/2017,N.L.,"MARIN, N.L.",0,0,0,1,0,43,
29/06/2017,D.F.,"IZTAPALAPA, D.F.",0,0,0,0,0,198,
29/06/2017,Q. ROO,"COZUMEL, Q. ROO",0,0,0,0,0,248,
30/06/2017,D.F.,"IZTAPALAPA, D.F.",6,3,9,0,1,130,
30/06/2017,SIN.,"CHOIX, SIN.",3,3,6,0,0,0,
30/06/2017,MOR.,"TEPOZTLAN, MOR.",2,4,6,0,0,0,
30/06/2017,SIN.,"SALVADOR ALVARADO, SIN.",2,2,4,0,0,0,
30/06/2017,COAH.,"TORREÓN, COAH.",2,1,3,0,0,0,
30/06/2017,COAH.,"SALTILLO, COAH.",3,0,3,0,0,0,
30/06/2017,JAL.,"ZAPOTLANEJO, JAL.",1,2,3,0,0,98,
30/06/2017,MICH.,"BUENAVISTA, MICH.",3,0,3,0,0,0,
30/06/2017,JAL.,"IXTLAHUACAN DE LOS MEMBRILLOS, JAL.",0,2,2,0,0,200,
30/06/2017,SIN.,"ROSARIO, SIN.",2,0,2,0,0,0,
30/06/2017,COAH.,"MONCLOVA, COAH.",1,0,1,0,0,27,
30/06/2017,COAH.,"PIEDRAS NEGRAS, COAH.",1,0,1,1,0,0,
30/06/2017,Q. ROO,"COZUMEL, Q. ROO",1,0,1,0,0,1584,
30/06/2017,YUC.,"UMAN, YUC.",0,1,1,0,0,0,
30/06/2017,AGS.,"COSÍO, AGS.",0,1,1,0,0,0,
30/06/2017,JAL.,"EL SALTO, JAL.",1,0,1,0,0,0,
30/06/2017,N.L.,"MONTERREY, N.L.",0,0,0,0,0,59,
30/06/2017,MICH.,"LAZARO CARDENAS, MICH.",0,0,0,3,0,0,
30/06/2017,CHIS.,"PALENQUE, CHIS.",0,0,0,0,0,25,
01/07/2017,TLAX.,"ZACATELCO, TLAX.",1,2,3,0,0,0,
01/07/2017,JAL.,"EL SALTO, JAL.",0,3,3,8,0,39,
01/07/2017,TAMPS.,"MATAMOROS, TAMPS.",0,3,3,0,0,0,
01/07/2017,COAH.,"SABINAS, COAH.",2,0,2,0,0,142,
01/07/2017,COAH.,"SABINAS, COAH.",2,0,2,0,0,142,
01/07/2017,MOR.,"TEPOZTLAN, MOR.",1,0,1,1,0,53,
01/07/2017,B.C.,"TIJUANA, B.C.",1,0,1,0,0,0,
01/07/2017,MEX.,"ATLAUTLA, MEX.",0,1,1,0,0,58,
02/07/2017,N.L.,"MARIN, N.L.",0,3,3,0,0,385,
02/07/2017,MEX.,"MEXICALTZINGO, MEX.",0,2,2,0,0,0,
02/07/2017,MEX.,"ACULCO, MEX.",1,1,2,0,1,19,
02/07/2017,GTO.,"MANUEL DOBLADO, GTO.",2,0,2,0,0,0,
02/07/2017,MEX.,"ATLAUTLA, MEX.",1,0,1,0,0,0,
03/07/2017,D.F.,"IZTAPALAPA, D.F.",2,1,3,0,0,47,
03/07/2017,MICH.,"BUENAVISTA, MICH.",3,0,3,0,0,0,
03/07/2017,B.C.,"TIJUANA, B.C.",1,2,3,0,0,0,
03/07/2017,TAMPS.,"REYNOSA, TAMPS.",0,3,3,0,0,0,
03/07/2017,JAL.,"IXTLAHUACAN DE LOS MEMBRILLOS, JAL.",1,1,2,0,0,0,
03/07/2017,SON.,"CAJEME, SON.",2,0,2,1,0,0,
03/07/2017,COAH.,"TORREÓN, COAH.",1,0,1,0,0,0,
03/07/2017,N.L.,"CADEREYTA JIMENEZ, N.L.",1,0,1,0,0,0,
03/07/2017,N.L.,"MONTERREY, N.L.",1,0,1,0,0,0,
03/07/2017,COAH.,"SALTILLO, COAH.",1,0,1,0,0,0,
03/07/2017,COAH.,"MONCLOVA, COAH.",1,0,1,0,1,0,
03/07/2017,COAH.,"MÚZQUIZ, COAH.",1,0,1,2,0,0,
03/07/2017,SON.,"NAVOJOA, SON.",1,0,1,0,0,0,
03/07/2017,COAH.,"MATAMOROS, COAH.",0,0,0,4,0,0,
03/07/2017,MOR.,"TEPOZTLAN, MOR.",0,0,0,47,3,0,
04/07/2017,JAL.,"ZAPOTLANEJO, JAL.",4,2,6,0,0,196,
04/07/2017,TAMPS.,"TAMPICO, TAMPS.",3,0,3,0,0,76,
04/07/2017,MEX.,"COCOTITLAN, MEX.",2,0,2,0,0,50,
04/07/2017,GRO.,"PUNGARABATO, GRO.",0,2,2,0,0,0,
04/07/2017,JAL.,"IXTLAHUACAN DE LOS MEMBRILLOS, JAL.",0,2,2,0,0,0,
04/07/2017,D.F.,"IZTAPALAPA, D.F.",2,0,2,0,0,43,
04/07/2017,MICH.,"BUENAVISTA, MICH.",0,2,2,0,0,1331,
04/07/2017,COAH.,"TORREÓN, COAH.",2,0,2,0,0,0,
04/07/2017,COAH.,"SALTILLO, COAH.",0,2,2,8,0,275,
04/07/2017,COAH.,"MONCLOVA, COAH.",2,0,2,0,0,0,
04/07/2017,OAX.,"PINOTEPA DE DON LUIS, OAX.",0,1,1,0,0,0,
04/07/2017,SON.,"HERMOSILLO, SON.",1,0,1,1,0,0,
04/07/2017,SON.,"HUATABAMPO, SON.",1,0,1,0,0,0,
04/07/2017,MEX.,"NOPALTEPEC, MEX.",1,0,1,0,1,0,
04/07/2017,GRO.,"OLINALA, GRO.",0,1,1,0,0,0,
04/07/2017,JAL.,"EL SALTO, JAL.",0,1,1,0,0,0,
04/07/2017,DGO.,"DGO., DGO.",1,0,1,1,1,0,
04/07/2017,N.L.,"MONTERREY, N.L.",0,1,1,0,0,0,
04/07/2017,COAH.,"FRANCISCO I. MADERO, COAH.",1,0,1,0,0,0,
04/07/2017,COAH.,"PIEDRAS NEGRAS, COAH.",0,1,1,0,0,0,
04/07/2017,COAH.,"MÚZQUIZ, COAH.",1,0,1,0,0,0,
04/07/2017,MOR.,"TEPOZTLAN, MOR.",0,0,0,15,3,32,
05/07/2017,B.C.,"TIJUANA, B.C.",0,7,7,0,0,0,
05/07/2017,SIN.,"EL FUERTE, SIN.",5,1,6,0,0,0,
05/07/2017,TLAX.,"NATIVITAS, TLAX.",0,3,3,0,0,0,
05/07/2017,D.F.,"IZTAPALAPA, D.F.",2,1,3,0,0,98,
05/07/2017,JAL.,"EL SALTO, JAL.",3,0,3,0,0,0,
05/07/2017,MEX.,"NOPALTEPEC, MEX.",0,2,2,0,0,0,
05/07/2017,AGS.,"PABELLÓN DE ARTEAGA, AGS.",0,2,2,0,0,0,
05/07/2017,JAL.,"IXTLAHUACAN DE LOS MEMBRILLOS, JAL.",2,0,2,0,0,0,
05/07/2017,OAX.,"PINOTEPA DE DON LUIS, OAX.",2,0,2,0,0,0,
05/07/2017,GRO.,"XOCHIHUEHUETLAN, GRO.",0,1,1,0,0,0,
05/07/2017,MEX.,"ACULCO, MEX.",1,0,1,0,0,0,
05/07/2017,TLAX.,"EL CARMEN TEQUEXQUITLA, TLAX.",1,0,1,0,0,0,
05/07/2017,TAMPS.,"REYNOSA, TAMPS.",1,0,1,0,0,117,
06/07/2017,D.F.,"IZTAPALAPA, D.F.",9,0,9,0,0,30,
06/07/2017,MICH.,"BUENAVISTA, MICH.",3,1,4,0,0,5,
06/07/2017,JAL.,"EL SALTO, JAL.",2,2,4,0,0,144,
06/07/2017,AGS.,"EL LLANO, AGS.",3,0,3,0,0,0,
06/07/2017,MEX.,"NOPALTEPEC, MEX.",2,0,2,0,0,0,
06/07/2017,COAH.,"SALTILLO, COAH.",2,0,2,0,0,469,
06/07/2017,SIN.,"EL FUERTE, SIN.",1,1,2,0,0,0,
06/07/2017,JAL.,"IXTLAHUACAN DE LOS MEMBRILLOS, JAL.",2,0,2,0,0,0,
06/07/2017,MEX.,"MEXICALTZINGO, MEX.",0,1,1,0,0,20,
06/07/2017,TAMPS.,"NUEVO LAREDO, TAMPS.",1,0,1,0,0,32,
06/07/2017,COAH.,"TORREÓN, COAH.",1,0,1,0,0,0,
06/07/2017,COAH.,"FRANCISCO I. MADERO, COAH.",1,0,1,0,0,0,
06/07/2017,COAH.,"PIEDRAS NEGRAS, COAH.",1,0,1,0,0,30,
06/07/2017,COAH.,"SABINAS, COAH.",1,0,1,3,0,0,
06/07/2017,SON.,"GUAYMAS, SON.",1,0,1,0,0,0,
06/07/2017,N.L.,"MARIN, N.L.",1,0,1,0,0,0,
06/07/2017,JAL.,"ZAPOTLANEJO, JAL.",1,0,1,0,0,0,
06/07/2017,B.C.,"TIJUANA, B.C.",0,0,0,0,3,0,
07/07/2017,D.F.,"IZTAPALAPA, D.F.",4,0,4,0,0,0,
07/07/2017,COAH.,"MONCLOVA, COAH.",3,0,3,3,0,33,
07/07/2017,COAH.,"FRANCISCO I. MADERO, COAH.",2,0,2,0,0,0,
07/07/2017,COAH.,"SALTILLO, COAH.",0,2,2,1,0,173,
07/07/2017,COAH.,"SABINAS, COAH.",2,0,2,0,0,0,
07/07/2017,B.C.,"TIJUANA, B.C.",0,2,2,0,0,0,
07/07/2017,TAMPS.,"MATAMOROS, TAMPS.",2,0,2,0,0,170,
07/07/2017,PUE.,"SAN MATIAS TLALANCALECA, PUE.",0,2,2,0,0,0,
07/07/2017,OAX.,"ASUNCION IXTALTEPEC, OAX.",0,1,1,0,0,130,
07/07/2017,MEX.,"MEXICALTZINGO, MEX.",0,1,1,0,0,0,
07/07/2017,JAL.,"ZAPOTLANEJO, JAL.",1,0,1,0,0,0,
07/07/2017,JAL.,"IXTLAHUACAN DE LOS MEMBRILLOS, JAL.",0,1,1,0,0,0,
07/07/2017,HGO.,"TULA DE ALLENDE, HGO.",1,0,1,0,0,0,
07/07/2017,MOR.,"TEPOZTLAN, MOR.",0,1,1,6,4,191,
07/07/2017,MEX.,"COCOTITLAN, MEX.",0,1,1,0,0,1,
07/07/2017,TAMPS.,"CAMARGO, TAMPS.",1,0,1,2,0,99,
07/07/2017,MEX.,"ACULCO, MEX.",0,0,0,0,15,0,
07/07/2017,AGS.,"EL LLANO, AGS.",0,0,0,2,0,7,
08/07/2017,MOR.,"TEPOZTLAN, MOR.",4,0,4,1,0,0,
08/07/2017,COAH.,"SABINAS, COAH.",2,0,2,0,0,0,
08/07/2017,TLAX.,"NATIVITAS, TLAX.",0,2,2,0,0,0,
08/07/2017,OAX.,"ASUNCION IXTALTEPEC, OAX.",2,0,2,0,0,0,
08/07/2017,TAMPS.,"MATAMOROS, TAMPS.",2,0,2,0,0,8,
08/07/2017,N.L.,"MONTERREY, N.L.",0,1,1,0,0,0,
08/07/2017,COAH.,"SALTILLO, COAH.",1,0,1,0,0,0,
08/07/2017,JAL.,"IXTLAHUACAN DE LOS MEMBRILLOS, JAL.",0,1,1,0,0,0,
08/07/2017,N.L.,"CADEREYTA JIMENEZ, N.L.",0,0,0,0,0,85,
08/07/2017,MEX.,"ACULCO, MEX.",0,0,0,0,1,835,
08/07/2017,MEX.,"NOPALTEPEC, MEX.",0,0,0,0,2,0,
09/07/2017,MEX.,"NOPALTEPEC, MEX.",2,1,3,0,0,0,
09/07/2017,JAL.,"ZAPOTLANEJO, JAL.",3,0,3,0,0,47,
09/07/2017,JAL.,"EL SALTO, JAL.",0,2,2,0,0,0,
09/07/2017,JAL.,"IXTLAHUACAN DE LOS MEMBRILLOS, JAL.",0,1,1,0,0,0,
10/07/2017,D.F.,"MILPA ALTA, D.F.",5,0,5,0,0,67,
10/07/2017,B.C.,"TIJUANA, B.C.",0,4,4,0,0,0,
10/07/2017,TLAX.,"SANTA ANA NOPALUCAN, TLAX.",0,3,3,0,0,0,
10/07/2017,COAH.,"SALTILLO, COAH.",1,1,2,0,0,0,
10/07/2017,MOR.,"TEPOZTLAN, MOR.",1,1,2,1,0,0,
10/07/2017,GRO.,"XOCHIHUEHUETLAN, GRO.",2,0,2,0,0,0,
10/07/2017,COAH.,"MONCLOVA, COAH.",1,0,1,0,0,0,
10/07/2017,COAH.,"MÚZQUIZ, COAH.",0,1,1,0,0,0,
10/07/2017,SIN.,"EL FUERTE, SIN.",0,1,1,0,0,0,
10/07/2017,N.L.,"HIGUERAS, N.L.",0,0,0,2,0,100,
11/07/2017,SIN.,"EL FUERTE, SIN.",5,1,6,0,0,0,
11/07/2017,TAMPS.,"TAMPICO, TAMPS.",1,2,3,6,0,139,
11/07/2017,COAH.,"MÚZQUIZ, COAH.",2,0,2,0,0,13,
11/07/2017,CHIH.,"HGO. DEL PARRAL, CHIH.",2,0,2,0,0,0,
11/07/2017,N.L.,"HIGUERAS, N.L.",2,0,2,0,0,0,
11/07/2017,GRO.,"LA UNION DE ISIDORO MONTES DE OCA, GRO.",2,0,2,0,0,0,
11/07/2017,COAH.,"TORREÓN, COAH.",1,0,1,0,0,0,
11/07/2017,COAH.,"MONCLOVA, COAH.",1,0,1,0,0,0,
11/07/2017,B.C.,"TIJUANA, B.C.",0,1,1,0,0,0,
11/07/2017,JAL.,"IXTLAHUACAN DE LOS MEMBRILLOS, JAL.",1,0,1,0,0,0,
11/07/2017,MEX.,"MOR., MEX.",0,1,1,0,0,81,
11/07/2017,MEX.,"OCUILAN, MEX.",0,1,1,0,0,0,
11/07/2017,TLAX.,"TLAX., TLAX.",0,1,1,0,0,0,
11/07/2017,CHIS.,"CHIAPA DE CORZO, CHIS.",1,0,1,0,0,0,
11/07/2017,OAX.,"JUCHITAN DE ZARAGOZA, OAX.",1,0,1,0,0,0,
11/07/2017,COAH.,"SALTILLO, COAH.",0,0,0,0,0,13,
11/07/2017,COAH.,"RAMOS ARIZPE, COAH.",0,0,0,0,0,132,
11/07/2017,JAL.,"EL SALTO, JAL.",0,0,0,2,0,0,
12/07/2017,CHIS.,"CHIAPA DE CORZO, CHIS.",2,1,3,0,0,120,
12/07/2017,MEX.,"ATLACOMULCO, MEX.",2,1,3,0,0,26,
12/07/2017,B.C.,"TIJUANA, B.C.",0,3,3,0,0,0,
12/07/2017,TLAX.,"TLAX., TLAX.",2,1,3,1,0,2,
12/07/2017,JAL.,"EL SALTO, JAL.",1,1,2,0,0,0,
12/07/2017,MEX.,"OZUMBA, MEX.",1,1,2,0,0,0,
12/07/2017,COAH.,"MONCLOVA, COAH.",1,0,1,0,0,0,
12/07/2017,MEX.,"MOR., MEX.",1,0,1,0,0,0,
12/07/2017,MEX.,"OCUILAN, MEX.",1,0,1,0,0,7,
12/07/2017,D.F.,"MILPA ALTA, D.F.",1,0,1,0,0,0,
12/07/2017,JAL.,"IXTLAHUACAN DE LOS MEMBRILLOS, JAL.",0,1,1,0,0,0,
12/07/2017,TLAX.,"SANTA ANA NOPALUCAN, TLAX.",0,1,1,0,0,0,
12/07/2017,HGO.,"HUASCA DE OCAMPO, HGO.",1,0,1,0,0,0,
12/07/2017,MEX.,"OTUMBA, MEX.",1,0,1,1,0,0,
12/07/2017,PUE.,"HUEJOTZINGO, PUE.",0,1,1,0,0,0,
12/07/2017,TAMPS.,"NUEVO LAREDO, TAMPS.",1,0,1,0,0,0,
12/07/2017,HGO.,"HUASCA DE OCAMPO, HGO.",1,0,1,0,0,0,
12/07/2017,MOR.,"TEPOZTLAN, MOR.",0,0,0,28,4,0,
12/07/2017,COAH.,"SALTILLO, COAH.",0,0,0,0,0,833,
12/07/2017,SIN.,"EL FUERTE, SIN.",0,0,0,0,2,0,
12/07/2017,AGS.,"TEPEZALÁ, AGS.",0,0,0,0,0,29,
12/07/2017,OAX.,"JUCHITAN DE ZARAGOZA, OAX.",0,0,0,2,0,20,
13/07/2017,SIN.,"EL FUERTE, SIN.",5,5,10,0,4,0,
13/07/2017,B.C.,"MEXICALI, B.C.",0,6,6,0,0,0,
13/07/2017,CHIS.,"CHIAPA DE CORZO, CHIS.",1,4,5,16,0,746,
13/07/2017,COAH.,"TORREÓN, COAH.",2,1,3,0,0,50,
13/07/2017,TLAX.,"TLAX., TLAX.",1,1,2,0,0,0,
13/07/2017,JAL.,"EL SALTO, JAL.",2,0,2,3,0,35,
13/07/2017,MEX.,"MOR., MEX.",2,0,2,0,0,0,
13/07/2017,MEX.,"ATLACOMULCO, MEX.",0,2,2,0,0,18,
13/07/2017,COAH.,"NUEVA ROSITA, COAH.",0,2,2,0,0,0,
13/07/2017,MOR.,"TEPOZTLAN, MOR.",2,0,2,0,0,569,
13/07/2017,SIN.,"ESCUINAPA, SIN.",1,0,1,0,5,0,
13/07/2017,D.F.,"MILPA ALTA, D.F.",1,0,1,0,0,0,
13/07/2017,COAH.,"ACUÑA, COAH.",0,1,1,0,0,0,
13/07/2017,N.L.,"CADEREYTA JIMENEZ, N.L.",1,0,1,1,0,78,
13/07/2017,N.L.,"MONTERREY, N.L.",1,0,1,0,0,76,
13/07/2017,N.L.,"CADEREYTA JIMENEZ, N.L.",1,0,1,0,0,0,
13/07/2017,JAL.,"IXTLAHUACAN DE LOS MEMBRILLOS, JAL.",0,0,0,10,0,41,
13/07/2017,COAH.,"SALTILLO, COAH.",0,0,0,0,0,238,
13/07/2017,MEX.,"OZUMBA, MEX.",0,0,0,0,0,104,
13/07/2017,MEX.,"OTUMBA, MEX.",0,0,0,0,0,3,
13/07/2017,TAB.,"TEAPA, TAB.",0,0,0,2,0,65,
13/07/2017,HGO.,"TULA DE ALLENDE, HGO.",0,0,0,0,0,400,
14/07/2017,SIN.,"EL FUERTE, SIN.",8,1,9,0,2,0,
14/07/2017,MOR.,"TEPOZTLAN, MOR.",1,1,2,9,0,589,
14/07/2017,B.C.,"ENSENADA, B.C.",1,0,1,0,0,0,
14/07/2017,B.C.,"MEXICALI, B.C.",0,1,1,0,0,0,
14/07/2017,MEX.,"OTUMBA, MEX.",0,1,1,0,10,133,
14/07/2017,TAMPS.,"MATAMOROS, TAMPS.",1,0,1,0,0,8,
14/07/2017,CHIS.,"CHIAPA DE CORZO, CHIS.",1,0,1,0,0,0,
14/07/2017,PUE.,"HUEJOTZINGO, PUE.",1,0,1,0,2,0,
14/07/2017,COAH.,"TORREÓN, COAH.",1,0,1,0,0,0,
14/07/2017,COAH.,"SABINAS, COAH.",1,0,1,0,0,0,
14/07/2017,DGO.,"DGO., DGO.",1,0,1,1,0,0,
14/07/2017,SIN.,"ESCUINAPA, SIN.",0,1,1,0,0,0,
14/07/2017,JAL.,"IXTLAHUACAN DE LOS MEMBRILLOS, JAL.",1,0,1,0,0,0,
14/07/2017,JAL.,"EL SALTO, JAL.",1,0,1,0,0,0,
14/07/2017,OAX.,"JUCHITAN DE ZARAGOZA, OAX.",1,0,1,1,0,30,
14/07/2017,TLAX.,"SANTA ANA NOPALUCAN, TLAX.",0,1,1,0,0,0,
14/07/2017,COAH.,"SALTILLO, COAH.",0,0,0,0,0,733,
14/07/2017,AGS.,"TEPEZALÁ, AGS.",0,0,0,0,0,539,
15/07/2017,TAMPS.,"MATAMOROS, TAMPS.",0,3,3,6,0,150,
15/07/2017,HGO.,"TULA DE ALLENDE, HGO.",1,1,2,0,0,0,
15/07/2017,COAH.,"SABINAS, COAH.",1,1,2,0,0,0,
15/07/2017,JAL.,"IXTLAHUACAN DE LOS MEMBRILLOS, JAL.",0,1,1,0,0,0,
15/07/2017,JAL.,"EL SALTO, JAL.",1,0,1,0,0,0,
15/07/2017,GRO.,"ATOYAC DE ALVAREZ, GRO.",1,0,1,0,0,0,
15/07/2017,SON.,"HERMOSILLO, SON.",1,0,1,1,0,0,
15/07/2017,MEX.,"ATLACOMULCO, MEX.",0,1,1,0,0,353,
15/07/2017,TLAX.,"SANTA ANA NOPALUCAN, TLAX.",0,1,1,0,0,0,
15/07/2017,MEX.,"MOR., MEX.",0,0,0,0,1,0,
16/07/2017,MEX.,"ATLACOMULCO, MEX.",3,0,3,0,0,0,
16/07/2017,MEX.,"OTUMBA, MEX.",1,0,1,0,0,47,
16/07/2017,GRO.,"ATOYAC DE ALVAREZ, GRO.",1,0,1,0,0,0,
16/07/2017,JAL.,"EL SALTO, JAL.",0,0,0,0,0,100,
17/07/2017,MOR.,"TEPOZTLAN, MOR.",3,1,4,2,0,215,
17/07/2017,COAH.,"SALTILLO, COAH.",2,0,2,0,0,548,
17/07/2017,COAH.,"SAN PEDRO, COAH.",1,0,1,1,0,0,
17/07/2017,COAH.,"TORREÓN, COAH.",1,0,1,0,0,0,
17/07/2017,COAH.,"RAMOS ARIZPE, COAH.",0,1,1,0,0,19,
17/07/2017,B.C.,"TIJUANA, B.C.",0,1,1,0,0,0,
17/07/2017,TAMPS.,"NUEVO LAREDO, TAMPS.",0,0,0,0,0,10,
17/07/2017,JAL.,"EL SALTO, JAL.",0,0,0,0,0,60,
18/07/2017,MEX.,"RAYON, MEX.",2,2,4,1,0,3,
18/07/2017,TLAX.,"TLAX., TLAX.",1,2,3,0,0,0,
18/07/2017,COAH.,"SALTILLO, COAH.",1,1,2,0,0,0,
18/07/2017,COAH.,"SABINAS, COAH.",1,1,2,0,0,0,
18/07/2017,COAH.,"RAMOS ARIZPE, COAH.",0,1,1,0,0,0,
18/07/2017,TAB.,"COMALCALCO, TAB.",1,0,1,0,0,0,
18/07/2017,JAL.,"ZAPOTLANEJO, JAL.",0,1,1,0,0,0,
18/07/2017,JAL.,"IXTLAHUACAN DE LOS MEMBRILLOS, JAL.",1,0,1,0,0,0,
18/07/2017,B.C.,"ENSENADA, B.C.",0,1,1,0,0,0,
18/07/2017,SON.,"HERMOSILLO, SON.",1,0,1,0,0,0,
18/07/2017,TLAX.,"SANTA ANA NOPALUCAN, TLAX.",1,0,1,0,0,0,
18/07/2017,MOR.,"TEPOZTLAN, MOR.",0,0,0,0,2,636,
18/07/2017,MEX.,"ATENCO, MEX.",0,0,0,0,0,20,
18/07/2017,TAMPS.,"TAMPICO, TAMPS.",0,0,0,0,0,136,
19/07/2017,MEX.,"RAYON, MEX.",1,3,4,0,0,0,
19/07/2017,B.C.,"TIJUANA, B.C.",1,2,3,0,2,0,
19/07/2017,MEX.,"TENANGO DEL AIRE, MEX.",3,0,3,0,0,65,
19/07/2017,COAH.,"TORREÓN, COAH.",2,0,2,0,1,0,
19/07/2017,TLAX.,"SANTA ANA NOPALUCAN, TLAX.",0,2,2,0,0,0,
19/07/2017,JAL.,"IXTLAHUACAN DE LOS MEMBRILLOS, JAL.",0,1,1,0,0,0,
19/07/2017,COAH.,"SALTILLO, COAH.",1,0,1,1,0,0,
19/07/2017,MEX.,"CUAUTITLAN IZCALLI, MEX.",1,0,1,0,0,0,
19/07/2017,TLAX.,"TLAX., TLAX.",0,1,1,0,0,0,
19/07/2017,SON.,"NAVOJOA, SON.",1,0,1,0,0,0,
19/07/2017,COAH.,"RAMOS ARIZPE, COAH.",0,0,0,0,0,630,
20/07/2017,B.C.,"MEXICALI, B.C.",0,4,4,0,0,0,
20/07/2017,COAH.,"NUEVA ROSITA, COAH.",1,2,3,0,0,0,
20/07/2017,MOR.,"TEPOZTLAN, MOR.",2,1,3,7,2,0,
20/07/2017,D.F.,"MIGUEL HGO., D.F.",2,0,2,0,0,0,
20/07/2017,N.L.,"MONTERREY, N.L.",2,0,2,1,0,33,
20/07/2017,B.C.,"TIJUANA, B.C.",0,2,2,0,2,0,
20/07/2017,TLAX.,"TLAX., TLAX.",0,2,2,0,0,0,
20/07/2017,COAH.,"SALTILLO, COAH.",0,1,1,0,0,96,
20/07/2017,JAL.,"IXTLAHUACAN DE LOS MEMBRILLOS, JAL.",0,1,1,0,0,0,
20/07/2017,JAL.,"EL SALTO, JAL.",0,1,1,0,0,0,
20/07/2017,TLAX.,"SANTA ANA NOPALUCAN, TLAX.",1,0,1,0,0,0,
20/07/2017,COAH.,"TORREÓN, COAH.",0,0,0,0,0,19,
20/07/2017,OAX.,"OAX. DE JUAREZ, OAX.",0,0,0,0,1,0,
20/07/2017,TAB.,"TENOSIQUE, TAB.",0,0,0,0,1,0,
20/07/2017,OAX.,"PINOTEPA DE DON LUIS, OAX.",0,0,0,1,0,0,
21/07/2017,TLAX.,"SANTA ANA NOPALUCAN, TLAX.",0,3,3,0,0,0,
21/07/2017,JAL.,"ZAPOTLANEJO, JAL.",1,1,2,0,0,0,
21/07/2017,COAH.,"SABINAS, COAH.",0,2,2,0,0,0,
21/07/2017,MOR.,"TEPOZTLAN, MOR.",2,0,2,1,0,50,
21/07/2017,B.C.,"TIJUANA, B.C.",0,2,2,0,1,0,
21/07/2017,D.F.,"MIGUEL HGO., D.F.",1,0,1,0,0,0,
21/07/2017,JAL.,"IXTLAHUACAN DE LOS MEMBRILLOS, JAL.",1,0,1,0,0,0,
21/07/2017,JAL.,"EL SALTO, JAL.",1,0,1,0,0,0,
21/07/2017,TAMPS.,"TAMPICO, TAMPS.",1,0,1,1,0,23,
21/07/2017,COAH.,"PIEDRAS NEGRAS, COAH.",1,0,1,22,0,0,
21/07/2017,MEX.,"TENANGO DEL AIRE, MEX.",1,0,1,0,0,0,
21/07/2017,MEX.,"ATENCO, MEX.",0,1,1,0,0,0,
21/07/2017,MEX.,"RAYON, MEX.",1,0,1,1,0,33,
21/07/2017,AGS.,"AGS., AGS.",0,0,0,7,0,0,
21/07/2017,OAX.,"OAX. DE JUAREZ, OAX.",0,0,0,0,1,0,
22/07/2017,COAH.,"FRANCISCO I. MADERO, COAH.",1,1,2,0,0,3,
22/07/2017,TAMPS.,"TAMPICO, TAMPS.",1,1,2,3,0,166,
22/07/2017,MEX.,"ATENCO, MEX.",2,0,2,0,0,0,
22/07/2017,MEX.,"CUAUTITLAN IZCALLI, MEX.",2,0,2,0,0,0,
22/07/2017,VER.,"JESUS CARRANZA, VER.",2,0,2,1,0,0,
22/07/2017,TLAX.,"SANTA ANA NOPALUCAN, TLAX.",0,2,2,0,0,0,
22/07/2017,N.L.,"CERRALVO, N.L.",0,1,1,0,0,0,
22/07/2017,JAL.,"IXTLAHUACAN DE LOS MEMBRILLOS, JAL.",0,1,1,0,0,0,
22/07/2017,JAL.,"EL SALTO, JAL.",0,1,1,0,0,0,
22/07/2017,B.C.,"TIJUANA, B.C.",0,1,1,0,0,0,
22/07/2017,MEX.,"TENANGO DEL AIRE, MEX.",1,0,1,0,0,0,
22/07/2017,JAL.,"TOMATLAN, JAL.",0,1,1,0,0,0,
22/07/2017,MEX.,"RAYON, MEX.",0,1,1,0,0,12,
22/07/2017,MOR.,"TEPOZTLAN, MOR.",0,0,0,21,3,0,
22/07/2017,OAX.,"OAX. DE JUAREZ, OAX.",0,0,0,0,1,0,
22/07/2017,COAH.,"SALTILLO, COAH.",0,0,0,0,0,597,
22/07/2017,MEX.,"RAYON, MEX.",0,0,0,0,0,242,
23/07/2017,MEX.,"ATENCO, MEX.",2,1,3,0,0,0,
23/07/2017,MEX.,"TENANGO DEL AIRE, MEX.",1,0,1,0,0,0,
23/07/2017,MEX.,"CUAUTITLAN IZCALLI, MEX.",1,0,1,0,0,0,
23/07/2017,JAL.,"EL SALTO, JAL.",0,1,1,0,0,0,
23/07/2017,B.C.,"TIJUANA, B.C.",1,0,1,0,0,0,
23/07/2017,B.C.,"ENSENADA, B.C.",0,1,1,0,0,0,
24/07/2017,COAH.,"MÚZQUIZ, COAH.",2,1,3,0,0,0,
24/07/2017,GRO.,"JUAN R. ESCUDERO, GRO.",1,2,3,0,0,0,
24/07/2017,JAL.,"IXTLAHUACAN DE LOS MEMBRILLOS, JAL.",2,0,2,0,0,0,
24/07/2017,TAB.,"CENTRO, TAB.",1,0,1,0,0,0,
24/07/2017,COAH.,"RAMOS ARIZPE, COAH.",1,0,1,0,0,0,
24/07/2017,COAH.,"MONCLOVA, COAH.",1,0,1,1,3,44,
24/07/2017,COAH.,"FRANCISCO I. MADERO, COAH.",1,0,1,0,0,0,
24/07/2017,JAL.,"EL SALTO, JAL.",1,0,1,0,0,0,
24/07/2017,TAMPS.,"TAMPICO, TAMPS.",0,1,1,0,0,0,
24/07/2017,SON.,"HUATABAMPO, SON.",0,1,1,0,0,0,
24/07/2017,COAH.,"SALTILLO, COAH.",0,0,0,0,0,703,
24/07/2017,OAX.,"OAX. DE JUAREZ, OAX.",0,0,0,0,1,0,
24/07/2017,SON.,"HERMOSILLO, SON.",0,0,0,8,0,0,
24/07/2017,OAX.,"PINOTEPA DE DON LUIS, OAX.",0,0,0,1,0,0,
25/07/2017,MEX.,"CHAPA DE MOTA, MEX.",1,3,4,0,0,0,
25/07/2017,AGS.,"AGS., AGS.",2,0,2,0,0,0,
25/07/2017,MEX.,"TEPETLAOXTOC, MEX.",0,1,1,0,0,0,
25/07/2017,HGO.,"ZACUALTIPAN DE ANGELES, HGO.",0,1,1,0,0,0,
25/07/2017,TAB.,"CENTRO, TAB.",1,0,1,0,0,5,
25/07/2017,N.L.,"MONTERREY, N.L.",0,1,1,0,0,17,
25/07/2017,COAH.,"RAMOS ARIZPE, COAH.",1,0,1,8,0,500,
25/07/2017,COAH.,"MONCLOVA, COAH.",1,0,1,0,0,0,
25/07/2017,COAH.,"PIEDRAS NEGRAS, COAH.",0,1,1,0,0,0,
25/07/2017,COAH.,"MÚZQUIZ, COAH.",0,1,1,0,0,57,
25/07/2017,MEX.,"ALMOLOYA DEL RIO, MEX.",1,0,1,0,0,0,
25/07/2017,MEX.,"VILLA DEL CARBON, MEX.",1,0,1,0,0,0,
25/07/2017,TAB.,"PARAISO, TAB.",1,0,1,0,0,0,
25/07/2017,DGO.,"DGO., DGO.",0,0,0,0,20,0,
25/07/2017,OAX.,"OAX. DE JUAREZ, OAX.",0,0,0,0,1,0,
25/07/2017,COAH.,"SALTILLO, COAH.",0,0,0,0,8,0,
26/07/2017,MICH.,"BUENAVISTA, MICH.",2,1,3,0,0,0,
26/07/2017,COAH.,"SALTILLO, COAH.",1,1,2,0,4,395,
26/07/2017,MEX.,"CHAPA DE MOTA, MEX.",2,0,2,0,0,0,
26/07/2017,AGS.,"AGS., AGS.",1,0,1,1,0,0,
26/07/2017,COAH.,"FRANCISCO I. MADERO, COAH.",0,1,1,0,0,0,
26/07/2017,COAH.,"MÚZQUIZ, COAH.",1,0,1,0,0,0,
26/07/2017,MEX.,"TEPETLIXPA, MEX.",1,0,1,1,0,0,
26/07/2017,D.F.,"AZCAPOTZALCO, D.F.",1,0,1,0,0,0,
26/07/2017,MEX.,"ALMOLOYA DEL RIO, MEX.",1,0,1,0,0,0,
26/07/2017,COAH.,"RAMOS ARIZPE, COAH.",0,0,0,1,0,450,
27/07/2017,ZAC.,"FRESNILLO, ZAC.",12,3,15,5,1,43,
27/07/2017,AGS.,"AGS., AGS.",4,0,4,0,0,0,
27/07/2017,COAH.,"SALTILLO, COAH.",2,0,2,0,0,100,
27/07/2017,COAH.,"ACUÑA, COAH.",0,2,2,2,0,0,
27/07/2017,MEX.,"CHAPA DE MOTA, MEX.",1,1,2,1,0,0,
27/07/2017,COAH.,"SAN PEDRO, COAH.",1,0,1,0,0,0,
27/07/2017,COAH.,"FRONTERA, COAH.",1,0,1,0,0,0,
27/07/2017,MICH.,"BUENAVISTA, MICH.",0,1,1,0,0,0,
27/07/2017,HGO.,"TIZAYUCA, HGO.",0,1,1,0,0,0,
27/07/2017,MEX.,"TEPETLIXPA, MEX.",0,1,1,0,0,1690,
27/07/2017,MEX.,"TEPETLAOXTOC, MEX.",1,0,1,0,0,0,
27/07/2017,MEX.,"ALMOLOYA DEL RIO, MEX.",1,0,1,0,0,0,
27/07/2017,SON.,"GUAYMAS, SON.",1,0,1,0,0,0,
27/07/2017,COAH.,"RAMOS ARIZPE, COAH.",0,0,0,0,4,0,
27/07/2017,ZAC.,"SANTA MARIA DE LA PAZ, ZAC.",0,0,0,0,0,166,
27/07/2017,MEX.,"VILLA DEL CARBON, MEX.",0,0,0,0,0,51,
28/07/2017,ZAC.,"GUADALUPE, ZAC.",12,6,18,2,1,0,
28/07/2017,ZAC.,"FRESNILLO, ZAC.",12,6,18,2,1,0,
28/07/2017,ZAC.,"GUADALUPE, ZAC.",12,6,18,2,1,496,
28/07/2017,MEX.,"CHAPA DE MOTA, MEX.",4,4,8,0,0,0,
28/07/2017,COAH.,"MÚZQUIZ, COAH.",0,6,6,0,0,0,
28/07/2017,MOR.,"EMILIANO ZAPATA, MOR.",5,0,5,0,1,117,
28/07/2017,AGS.,"AGS., AGS.",4,0,4,0,0,0,
28/07/2017,D.F.,"AZCAPOTZALCO, D.F.",2,1,3,0,0,0,
28/07/2017,MEX.,"VILLA DEL CARBON, MEX.",2,1,3,0,0,51,
28/07/2017,MEX.,"ALMOLOYA DEL RIO, MEX.",2,0,2,0,0,0,
28/07/2017,MEX.,"TEPETLAOXTOC, MEX.",1,1,2,0,0,5,
28/07/2017,MICH.,"BUENAVISTA, MICH.",0,1,1,0,0,0,
28/07/2017,COAH.,"SALTILLO, COAH.",0,0,0,1,0,940,
29/07/2017,ZAC.,"FRESNILLO, ZAC.",11,2,13,8,0,15,
29/07/2017,B.C.,"TIJUANA, B.C.",0,1,1,0,0,0,
29/07/2017,MEX.,"CHAPA DE MOTA, MEX.",1,0,1,0,0,0,
29/07/2017,COAH.,"PIEDRAS NEGRAS, COAH.",1,0,1,0,0,0,
29/07/2017,COAH.,"ARTEAGA, COAH.",0,0,0,0,1,0,
30/07/2017,MEX.,"CHAPA DE MOTA, MEX.",2,3,5,2,0,0,
30/07/2017,MEX.,"TEPETLAOXTOC, MEX.",4,1,5,1,0,118,
30/07/2017,TAMPS.,"MATAMOROS, TAMPS.",0,3,3,165,0,0,
30/07/2017,MEX.,"ALMOLOYA DEL RIO, MEX.",1,0,1,0,0,79,
30/07/2017,MEX.,"TEPETLAOXTOC, MEX.",1,0,1,0,0,0,
30/07/2017,ZAC.,"JEREZ, ZAC.",0,0,0,0,0,496,
30/07/2017,ZAC.,"SANTA MARIA DE LA PAZ, ZAC.",0,0,0,0,0,58,
31/07/2017,MOR.,"EMILIANO ZAPATA, MOR.",2,2,4,1,4,0,
31/07/2017,COAH.,"SALTILLO, COAH.",3,1,4,0,0,0,
31/07/2017,D.F.,"MIGUEL HGO., D.F.",2,1,3,0,0,0,
31/07/2017,AGS.,"AGS., AGS.",3,0,3,4,0,0,
31/07/2017,D.F.,"MIGUEL HGO., D.F.",2,1,3,0,0,0,
31/07/2017,CHIS.,"TUXTLA GUTIÉRREZ, CHIS.",2,0,2,0,0,107,
31/07/2017,COAH.,"TORREÓN, COAH.",1,0,1,0,0,0,
31/07/2017,COAH.,"RAMOS ARIZPE, COAH.",1,0,1,1,0,400,
31/07/2017,COAH.,"SAN PEDRO, COAH.",1,0,1,0,0,0,
01/08/2017,COAH.,"SALTILLO, COAH.",3,0,3,0,0,0,
01/08/2017,MEX.,"TLALMANALCO, MEX.",2,0,2,2,0,80,
01/08/2017,MEX.,"TEZOYUCA, MEX.",1,1,2,0,0,0,
01/08/2017,CHIS.,"TUXTLA GUTIÉRREZ, CHIS.",1,1,2,0,0,207,
01/08/2017,HGO.,"ZACUALTIPAN DE ANGELES, HGO.",0,2,2,0,0,0,
01/08/2017,MOR.,"EMILIANO ZAPATA, MOR.",0,1,1,0,0,0,
01/08/2017,COAH.,"SAN PEDRO, COAH.",1,0,1,0,0,0,
01/08/2017,COAH.,"PIEDRAS NEGRAS, COAH.",0,1,1,0,0,0,
01/08/2017,TAB.,"CENTRO, TAB.",1,0,1,1,0,0,
01/08/2017,COAH.,"MONCLOVA, COAH.",0,0,0,0,3,0,
01/08/2017,D.F.,"MIGUEL HGO., D.F.",0,0,0,0,5,86,
02/08/2017,B.C.,"TIJUANA, B.C.",0,7,7,0,0,0,
02/08/2017,MOR.,"EMILIANO ZAPATA, MOR.",3,2,5,7,4,0,
02/08/2017,CHIS.,"TAPACHULA, CHIS.",3,1,4,0,0,0,
02/08/2017,CHIS.,"TUXTLA GUTIÉRREZ, CHIS.",4,0,4,2,0,61,
02/08/2017,MEX.,"SOYANIQUILPAN DE JUAREZ, MEX.",2,1,3,0,0,0,
02/08/2017,MEX.,"SAN SIMON DE GRO., MEX.",0,2,2,0,0,0,
02/08/2017,MEX.,"TLALMANALCO, MEX.",0,2,2,0,3,0,
02/08/2017,AGS.,"AGS., AGS.",2,0,2,9,0,7,
02/08/2017,B.C.,"MEXICALI, B.C.",1,0,1,0,0,0,
02/08/2017,MEX.,"SAN SIMON DE GRO., MEX.",1,0,1,0,0,0,
02/08/2017,MEX.,"SOYANIQUILPAN DE JUAREZ, MEX.",1,0,1,0,0,50,
02/08/2017,MEX.,"TEZOYUCA, MEX.",1,0,1,0,0,0,
02/08/2017,SON.,"HERMOSILLO, SON.",0,1,1,0,0,0,
02/08/2017,MICH.,"BUENAVISTA, MICH.",1,0,1,0,0,164,
02/08/2017,COAH.,"SALTILLO, COAH.",1,0,1,0,0,945,
02/08/2017,COAH.,"MÚZQUIZ, COAH.",0,1,1,2,0,0,
02/08/2017,CHIH.,"HGO. DEL PARRAL, CHIH.",0,0,0,0,0,20,
03/08/2017,CHIS.,"TUXTLA GUTIÉRREZ, CHIS.",6,0,6,1,0,487,
03/08/2017,CHIS.,"TAPACHULA, CHIS.",2,1,3,2,0,20,
03/08/2017,AGS.,"AGS., AGS.",3,0,3,9,0,0,
03/08/2017,MEX.,"TLALMANALCO, MEX.",1,1,2,0,2,0,
03/08/2017,MOR.,"EMILIANO ZAPATA, MOR.",2,0,2,0,0,0,
03/08/2017,B.C.,"MEXICALI, B.C.",1,1,2,0,0,0,
03/08/2017,D.F.,"MIGUEL HGO., D.F.",1,0,1,0,7,0,
03/08/2017,OAX.,"PINOTEPA DE DON LUIS, OAX.",0,1,1,0,0,0,
03/08/2017,COAH.,"PIEDRAS NEGRAS, COAH.",1,0,1,0,0,140,
03/08/2017,MEX.,"TEZOYUCA, MEX.",0,1,1,0,1,0,
03/08/2017,TAB.,"PARAISO, TAB.",1,0,1,0,0,0,
03/08/2017,COAH.,"SALTILLO, COAH.",0,0,0,0,0,1315,
03/08/2017,TAMPS.,"TAMPICO, TAMPS.",0,0,0,2,0,283,
04/08/2017,CHIS.,"TUXTLA GUTIÉRREZ, CHIS.",13,1,14,0,0,566,
04/08/2017,COAH.,"SABINAS, COAH.",0,3,3,0,0,0,
04/08/2017,COAH.,"SALTILLO, COAH.",3,0,3,0,0,84,
04/08/2017,CHIS.,"TAPACHULA, CHIS.",1,2,3,0,0,145,
04/08/2017,D.F.,"MIGUEL HGO., D.F.",2,1,3,0,0,0,
04/08/2017,GRO.,"TLACOACHISTLAHUACA, GRO.",1,0,1,0,0,0,
04/08/2017,MEX.,"TEZOYUCA, MEX.",0,1,1,0,0,0,
04/08/2017,COAH.,"PIEDRAS NEGRAS, COAH.",1,0,1,0,0,0,
04/08/2017,COAH.,"SAN PEDRO, COAH.",1,0,1,0,0,0,
04/08/2017,MEX.,"SAN SIMON DE GRO., MEX.",1,0,1,0,0,0,
04/08/2017,AGS.,"AGS., AGS.",1,0,1,2,0,0,
05/08/2017,CHIS.,"TUXTLA GUTIÉRREZ, CHIS.",6,2,8,2,0,143,
05/08/2017,CHIS.,"TUXTLA GUTIÉRREZ, CHIS.",3,1,4,0,2,240,
05/08/2017,MEX.,"SOYANIQUILPAN DE JUAREZ, MEX.",1,1,2,0,0,0,
05/08/2017,B.C.,"ENSENADA, B.C.",1,0,1,0,0,0,
05/08/2017,MEX.,"SAN SIMON DE GRO., MEX.",1,0,1,0,0,0,
05/08/2017,MEX.,"TLALMANALCO, MEX.",1,0,1,1,0,0,
05/08/2017,COAH.,"SABINAS, COAH.",1,0,1,0,0,0,
05/08/2017,TAMPS.,"MATAMOROS, TAMPS.",1,0,1,0,0,0,
06/08/2017,MEX.,"TLALMANALCO, MEX.",2,1,3,1,0,429,
06/08/2017,MEX.,"TEZOYUCA, MEX.",2,0,2,0,0,3,
07/08/2017,QRO.,"EL MARQUES, QRO.",1,2,3,0,0,29,
07/08/2017,MOR.,"EMILIANO ZAPATA, MOR.",0,3,3,0,0,0,
07/08/2017,S.L.P.,"SAN LUIS POTOSI, S.L.P.",3,0,3,2,0,0,
07/08/2017,SIN.,"EL FUERTE, SIN.",2,0,2,0,3,0,
07/08/2017,DGO.,"DGO., DGO.",1,1,2,0,0,0,
07/08/2017,B.C.,"MEXICALI, B.C.",1,0,1,0,0,0,
07/08/2017,Q. ROO,"OTHON P. BLANCO, Q. ROO",0,1,1,0,0,492,
07/08/2017,S.L.P.,"CIUDAD VALLES, S.L.P.",1,0,1,0,0,0,
07/08/2017,AGS.,"AGS., AGS.",0,0,0,7,0,0,
08/08/2017,CHIS.,"TAPACHULA, CHIS.",6,4,10,2,0,165,
08/08/2017,SIN.,"EL FUERTE, SIN.",3,4,7,0,1,0,
08/08/2017,MEX.,"ATIZAPAN, MEX.",3,1,4,4,0,217,
08/08/2017,B.C.,"TIJUANA, B.C.",0,3,3,0,0,0,
08/08/2017,D.F.,"MIGUEL HGO., D.F.",1,1,2,0,0,0,
08/08/2017,MEX.,"SANTO TOMAS, MEX.",0,2,2,0,0,0,
08/08/2017,S.L.P.,"CIUDAD VALLES, S.L.P.",2,0,2,0,0,0,
08/08/2017,HGO.,"ZACUALTIPAN DE ANGELES, HGO.",1,0,1,0,0,0,
08/08/2017,MOR.,"EMILIANO ZAPATA, MOR.",1,0,1,0,0,0,
08/08/2017,CHIS.,"TAPACHULA, CHIS.",0,1,1,0,0,0,
08/08/2017,COAH.,"RAMOS ARIZPE, COAH.",1,0,1,0,0,381,
08/08/2017,COAH.,"SALTILLO, COAH.",0,1,1,0,0,0,
08/08/2017,COAH.,"SAN PEDRO, COAH.",0,1,1,0,0,0,
08/08/2017,COAH.,"SAN PEDRO, COAH.",0,1,1,0,0,0,
08/08/2017,S.L.P.,"SAN LUIS POTOSI, S.L.P.",1,0,1,0,0,0,
08/08/2017,N.L.,"MELCHOR OCAMPO, N.L.",0,1,1,3,0,170,
08/08/2017,AGS.,"AGS., AGS.",0,0,0,2,0,0,
08/08/2017,CHIS.,"TUXTLA GUTIÉRREZ, CHIS.",0,0,0,3,0,25,
08/08/2017,TAMPS.,"NUEVO LAREDO, TAMPS.",0,0,0,0,0,125,
08/08/2017,TAMPS.,"TAMPICO, TAMPS.",0,0,0,0,0,73,
09/08/2017,S.L.P.,"SAN LUIS POTOSI, S.L.P.",5,0,5,16,0,283,
09/08/2017,SIN.,"EL FUERTE, SIN.",3,1,4,0,0,0,
09/08/2017,CHIS.,"TUXTLA GUTIÉRREZ, CHIS.",1,2,3,1,0,211,
09/08/2017,N.L.,"APODACA, N.L.",1,1,2,0,0,33,
09/08/2017,D.F.,"MIGUEL HGO., D.F.",1,1,2,0,0,400,
09/08/2017,MEX.,"TONANITLA, MEX.",1,1,2,0,0,0,
09/08/2017,B.C.,"ENSENADA, B.C.",0,1,1,0,0,0,
09/08/2017,B.C.,"MEXICALI, B.C.",0,1,1,0,0,0,
09/08/2017,COAH.,"PIEDRAS NEGRAS, COAH.",1,0,1,0,0,0,
09/08/2017,SIN.,"ESCUINAPA, SIN.",0,0,0,0,4,0,
09/08/2017,TAMPS.,"NUEVO LAREDO, TAMPS.",0,0,0,0,0,33,
09/08/2017,AGS.,"AGS., AGS.",0,0,0,41,0,0,
09/08/2017,CHIS.,"TAPACHULA, CHIS.",0,0,0,0,1,48,
09/08/2017,MEX.,"AMECAMECA, MEX.",0,0,0,0,0,54,
09/08/2017,COAH.,"MÚZQUIZ, COAH.",0,0,0,1,0,0,
10/08/2017,MEX.,"ATIZAPAN, MEX.",9,2,11,0,0,95,
10/08/2017,CHIS.,"TUXTLA GUTIÉRREZ, CHIS.",8,1,9,7,0,258,
10/08/2017,SIN.,"EL FUERTE, SIN.",6,2,8,0,0,0,
10/08/2017,D.F.,"MIGUEL HGO., D.F.",5,1,6,0,0,0,
10/08/2017,CHIS.,"TAPACHULA, CHIS.",0,6,6,1,0,239,
10/08/2017,QRO.,"EL MARQUES, QRO.",2,2,4,0,0,0,
10/08/2017,COAH.,"SALTILLO, COAH.",3,0,3,1,0,0,
10/08/2017,MEX.,"TONANITLA, MEX.",1,1,2,0,0,28,
10/08/2017,MEX.,"AMECAMECA, MEX.",2,0,2,0,0,19,
10/08/2017,S.L.P.,"SAN LUIS POTOSI, S.L.P.",2,0,2,17,1,0,
10/08/2017,CHIH.,"HGO. DEL PARRAL, CHIH.",1,0,1,1,0,3,
10/08/2017,SIN.,"ESCUINAPA, SIN.",0,1,1,0,0,0,
10/08/2017,N.L.,"MONTERREY, N.L.",1,0,1,0,0,40,
10/08/2017,S.L.P.,"CIUDAD VALLES, S.L.P.",1,0,1,0,0,0,
10/08/2017,TAB.,"CENTRO, TAB.",1,0,1,0,0,0,
10/08/2017,TAMPS.,"NUEVO LAREDO, TAMPS.",0,0,0,13,0,152,
10/08/2017,MEX.,"SANTO TOMAS, MEX.",0,0,0,0,1,0,
10/08/2017,AGS.,"AGS., AGS.",0,0,0,7,0,0,
10/08/2017,Q. ROO,"OTHON P. BLANCO, Q. ROO",0,0,0,0,1,21,
10/08/2017,N.L.,"ALLENDE, N.L.",0,0,0,0,1,0,
11/08/2017,CHIS.,"TAPACHULA, CHIS.",2,21,23,2,12,59,
11/08/2017,MEX.,"ATIZAPAN, MEX.",10,1,11,3,0,96,
11/08/2017,CHIS.,"TUXTLA GUTIÉRREZ, CHIS.",3,4,7,0,0,55,
11/08/2017,TAMPS.,"MATAMOROS, TAMPS.",5,0,5,0,0,0,
11/08/2017,CHIS.,"TUXTLA GUTIÉRREZ, CHIS.",1,3,4,0,0,593,
11/08/2017,SIN.,"EL FUERTE, SIN.",3,0,3,0,0,0,
11/08/2017,D.F.,"MIGUEL HGO., D.F.",3,0,3,0,0,0,
11/08/2017,S.L.P.,"SAN LUIS POTOSI, S.L.P.",3,0,3,0,0,0,
11/08/2017,Q. ROO,"OTHON P. BLANCO, Q. ROO",1,1,2,0,0,22,
11/08/2017,AGS.,"AGS., AGS.",1,0,1,2,0,0,
11/08/2017,QRO.,"EL MARQUES, QRO.",0,1,1,0,0,0,
11/08/2017,MEX.,"TEXCALYACAC, MEX.",0,1,1,0,0,0,
11/08/2017,MEX.,"AMECAMECA, MEX.",1,0,1,0,0,0,
11/08/2017,COAH.,"FRANCISCO I. MADERO, COAH.",1,0,1,1,0,0,
11/08/2017,COAH.,"SALTILLO, COAH.",1,0,1,0,0,0,
11/08/2017,N.L.,"MONTERREY, N.L.",1,0,1,0,0,232,
11/08/2017,TAMPS.,"NUEVO LAREDO, TAMPS.",1,0,1,3,0,92,
11/08/2017,SIN.,"ESCUINAPA, SIN.",0,1,1,0,0,0,
11/08/2017,MEX.,"AMECAMECA, MEX.",1,0,1,0,0,0,
11/08/2017,MOR.,"EMILIANO ZAPATA, MOR.",0,0,0,56,5,300,
11/08/2017,COAH.,"RAMOS ARIZPE, COAH.",0,0,0,0,0,135,
11/08/2017,COAH.,"SAN PEDRO, COAH.",0,0,0,1,0,0,
12/08/2017,MEX.,"ATIZAPAN, MEX.",9,3,12,5,0,532,
12/08/2017,S.L.P.,"SAN LUIS POTOSI, S.L.P.",5,0,5,8,0,0,
12/08/2017,TAMPS.,"MATAMOROS, TAMPS.",2,0,2,1,0,23,
12/08/2017,COAH.,"NAVA, COAH.",0,1,1,0,0,0,
13/08/2017,MEX.,"ATIZAPAN, MEX.",7,0,7,1,0,86,
13/08/2017,MEX.,"TONANITLA, MEX.",5,2,7,0,0,0,
13/08/2017,QRO.,"EL MARQUES, QRO.",1,3,4,0,0,0,
13/08/2017,MEX.,"AMECAMECA, MEX.",2,1,3,0,0,6,
13/08/2017,B.C.,"MEXICALI, B.C.",1,1,2,0,0,0,
13/08/2017,MEX.,"TEXCALYACAC, MEX.",1,0,1,0,0,0,
13/08/2017,S.L.P.,"SAN LUIS POTOSI, S.L.P.",1,0,1,10,0,0,
13/08/2017,Q. ROO,"OTHON P. BLANCO, Q. ROO",0,0,0,0,0,22,
14/08/2017,D.F.,"VENUSTIANO CARRANZA, D.F.",5,0,5,0,0,7,
14/08/2017,B.C.,"MEXICALI, B.C.",2,1,3,0,0,0,
14/08/2017,GRO.,"ATOYAC DE ALVAREZ, GRO.",3,0,3,0,0,0,
14/08/2017,S.L.P.,"SAN LUIS POTOSI, S.L.P.",3,0,3,0,0,0,
14/08/2017,COAH.,"SALTILLO, COAH.",2,0,2,1,4,415,
14/08/2017,QRO.,"EL MARQUES, QRO.",0,1,1,0,5,0,
14/08/2017,CHIH.,"HGO. DEL PARRAL, CHIH.",1,0,1,1,0,3,
14/08/2017,MOR.,"EMILIANO ZAPATA, MOR.",1,0,1,1,0,19,
14/08/2017,COAH.,"MONCLOVA, COAH.",1,0,1,0,2,0,
14/08/2017,SIN.,"COSALA, SIN.",0,1,1,0,0,0,
14/08/2017,SIN.,"ANGOSTURA, SIN.",0,1,1,0,0,0,
14/08/2017,Q. ROO,"OTHON P. BLANCO, Q. ROO",1,0,1,0,7,60,
14/08/2017,TAMPS.,"NUEVO LAREDO, TAMPS.",0,0,0,0,0,26,
14/08/2017,COAH.,"RAMOS ARIZPE, COAH.",0,0,0,0,0,1048,
14/08/2017,AGS.,"AGS., AGS.",0,0,0,1,0,0,
15/08/2017,MEX.,"CHIMALHUACAN, MEX.",6,2,8,0,0,42,
15/08/2017,MEX.,"TEXCOCO, MEX.",6,1,7,0,0,214,
15/08/2017,QRO.,"EL MARQUES, QRO.",4,0,4,0,0,0,
15/08/2017,COAH.,"SALTILLO, COAH.",0,2,2,0,2,0,
15/08/2017,SIN.,"COSALA, SIN.",1,1,2,0,3,0,
15/08/2017,MEX.,"TIMILPAN, MEX.",1,0,1,1,0,0,
15/08/2017,MEX.,"CHICONCUAC, MEX.",0,1,1,0,0,166,
15/08/2017,COAH.,"MÚZQUIZ, COAH.",0,1,1,0,0,0,
15/08/2017,N.L.,"MONTERREY, N.L.",1,0,1,0,0,45,
15/08/2017,SIN.,"ANGOSTURA, SIN.",1,0,1,0,0,0,
15/08/2017,MOR.,"EMILIANO ZAPATA, MOR.",0,0,0,23,7,792,
15/08/2017,Q. ROO,"OTHON P. BLANCO, Q. ROO",0,0,0,0,0,71,
15/08/2017,CHIH.,"HGO. DEL PARRAL, CHIH.",0,0,0,1,0,3,
15/08/2017,S.L.P.,"SAN LUIS POTOSI, S.L.P.",0,0,0,28,0,0,
16/08/2017,MEX.,"CHIMALHUACAN, MEX.",9,4,13,0,1,145,
16/08/2017,MOR.,"EMILIANO ZAPATA, MOR.",4,1,5,1,0,0,
16/08/2017,S.L.P.,"SAN LUIS POTOSI, S.L.P.",4,0,4,1,0,0,
16/08/2017,S.L.P.,"SAN LUIS POTOSI, S.L.P.",4,0,4,1,0,0,
16/08/2017,D.F.,"VENUSTIANO CARRANZA, D.F.",3,1,4,0,0,67,
16/08/2017,COAH.,"SALTILLO, COAH.",2,1,3,4,0,0,
16/08/2017,MEX.,"CHICONCUAC, MEX.",0,3,3,0,0,0,
16/08/2017,S.L.P.,"CIUDAD VALLES, S.L.P.",2,0,2,0,0,0,
16/08/2017,B.C.,"TIJUANA, B.C.",0,2,2,0,0,0,
16/08/2017,N.L.,"APODACA, N.L.",2,0,2,0,0,0,
16/08/2017,S.L.P.,"CIUDAD VALLES, S.L.P.",2,0,2,0,0,0,
16/08/2017,MEX.,"TEXCOCO, MEX.",1,1,2,0,0,0,
16/08/2017,CHIS.,"TUXTLA GUTIÉRREZ, CHIS.",1,1,2,0,0,0,
16/08/2017,SIN.,"ANGOSTURA, SIN.",0,1,1,0,2,0,
16/08/2017,SIN.,"COSALA, SIN.",0,1,1,0,5,0,
17/08/2017,MEX.,"CHIMALHUACAN, MEX.",6,1,7,0,0,39,
17/08/2017,MEX.,"CHICONCUAC, MEX.",5,1,6,0,0,784,
17/08/2017,MOR.,"EMILIANO ZAPATA, MOR.",0,4,4,2,0,59,
17/08/2017,S.L.P.,"SAN LUIS POTOSI, S.L.P.",3,0,3,3,0,46,
17/08/2017,MEX.,"CHICONCUAC, MEX.",2,1,3,0,0,11,
17/08/2017,CHIS.,"TUXTLA GUTIÉRREZ, CHIS.",1,2,3,0,0,10,
17/08/2017,N.L.,"MONTERREY, N.L.",2,0,2,0,0,0,
17/08/2017,D.F.,"VENUSTIANO CARRANZA, D.F.",2,0,2,0,0,0,
17/08/2017,DGO.,"DGO., DGO.",2,0,2,0,0,0,
17/08/2017,N.L.,"ALLENDE, N.L.",1,0,1,1,0,0,
17/08/2017,S.L.P.,"CIUDAD VALLES, S.L.P.",1,0,1,0,2,123,
17/08/2017,VER.,"CAMERINO Z. MENDOZA, VER.",1,0,1,0,0,0,
17/08/2017,VER.,"MISANTLA, VER.",1,0,1,1,0,1,
17/08/2017,B.C.,"TIJUANA, B.C.",1,0,1,0,0,0,
17/08/2017,COAH.,"MÚZQUIZ, COAH.",0,1,1,0,0,0,
17/08/2017,TAMPS.,"NUEVO LAREDO, TAMPS.",1,0,1,0,0,0,
17/08/2017,SIN.,"ANGOSTURA, SIN.",0,0,0,0,2,0,
17/08/2017,COAH.,"SALTILLO, COAH.",0,0,0,1,2,0,
18/08/2017,MEX.,"CHIMALHUACAN, MEX.",11,7,18,0,0,31,
18/08/2017,N.L.,"MONTERREY, N.L.",3,6,9,15,0,700,
18/08/2017,MEX.,"TEXCOCO, MEX.",6,1,7,0,0,0,
18/08/2017,CHIS.,"TUXTLA GUTIÉRREZ, CHIS.",5,1,6,2,0,30,
18/08/2017,SIN.,"ANGOSTURA, SIN.",0,6,6,0,0,0,
18/08/2017,TAMPS.,"MATAMOROS, TAMPS.",2,3,5,0,0,0,
18/08/2017,QRO.,"EL MARQUES, QRO.",1,1,2,0,0,494,
18/08/2017,DGO.,"DGO., DGO.",1,1,2,0,0,0,
18/08/2017,COAH.,"SALTILLO, COAH.",1,1,2,2,0,80,
18/08/2017,SIN.,"COSALA, SIN.",2,0,2,0,5,0,
18/08/2017,N.L.,"ALLENDE, N.L.",1,0,1,0,0,0,
18/08/2017,TAMPS.,"NUEVO LAREDO, TAMPS.",1,0,1,0,0,0,
18/08/2017,OAX.,"SANTO DOMINGO TEHUANTEPEC, OAX.",1,0,1,0,0,0,
18/08/2017,MICH.,"GABRIEL ZAMORA, MICH.",1,0,1,0,0,500,
18/08/2017,VER.,"SAYULA DE ALEMAN, VER.",1,0,1,0,0,0,
18/08/2017,COAH.,"MÚZQUIZ, COAH.",1,0,1,0,0,0,
18/08/2017,COAH.,"ACUÑA, COAH.",0,1,1,0,0,0,
18/08/2017,S.L.P.,"SAN LUIS POTOSI, S.L.P.",1,0,1,1,0,0,
18/08/2017,GRO.,"ATOYAC DE ALVAREZ, GRO.",1,0,1,1,0,9,
18/08/2017,TAB.,"CENTRO, TAB.",1,0,1,0,0,0,
18/08/2017,MOR.,"EMILIANO ZAPATA, MOR.",0,0,0,0,4,0,
19/08/2017,MEX.,"CHIMALHUACAN, MEX.",17,7,24,5,0,77,
19/08/2017,MEX.,"CHIMALHUACAN, MEX.",12,5,17,0,0,0,
19/08/2017,MEX.,"TEXCOCO, MEX.",4,1,5,2,0,66,
19/08/2017,MEX.,"TEXCOCO, MEX.",3,1,4,2,0,492,
19/08/2017,B.C.,"TIJUANA, B.C.",1,1,2,0,0,0,
19/08/2017,DGO.,"SANTIAGO PAPASQUIARO, DGO.",1,0,1,1,0,0,
19/08/2017,MEX.,"TIMILPAN, MEX.",1,0,1,1,0,0,
19/08/2017,GRO.,"ATOYAC DE ALVAREZ, GRO.",0,1,1,0,0,0,
19/08/2017,GRO.,"PUNGARABATO, GRO.",1,0,1,0,0,0,
19/08/2017,COAH.,"SABINAS, COAH.",1,0,1,0,0,0,
19/08/2017,TAMPS.,"MATAMOROS, TAMPS.",1,0,1,0,0,0,
19/08/2017,MEX.,"CHICONCUAC, MEX.",1,0,1,0,0,0,
19/08/2017,S.L.P.,"SAN LUIS POTOSI, S.L.P.",1,0,1,2,2,0,
19/08/2017,S.L.P.,"CIUDAD VALLES, S.L.P.",0,1,1,0,0,0,
19/08/2017,B.C.,"ENSENADA, B.C.",0,1,1,0,0,0,
19/08/2017,COAH.,"SALTILLO, COAH.",0,0,0,2,0,0,
20/08/2017,S.L.P.,"SAN LUIS POTOSI, S.L.P.",1,0,1,5,0,0,
21/08/2017,SIN.,"COSALA, SIN.",1,1,2,0,0,0,
22/08/2017,N.L.,"MONTERREY, N.L.",6,5,11,4,0,946,
22/08/2017,S.L.P.,"SAN LUIS POTOSI, S.L.P.",4,4,8,2,0,0,
22/08/2017,COAH.,"TORREÓN, COAH.",6,0,6,0,0,0,
22/08/2017,COAH.,"TORREÓN, COAH.",6,0,6,0,0,0,
22/08/2017,MEX.,"IXTAPALUCA, MEX.",4,0,4,0,0,1696,
22/08/2017,SIN.,"COSALA, SIN.",2,1,3,0,0,0,
22/08/2017,DGO.,"DGO., DGO.",0,2,2,0,0,0,
22/08/2017,HGO.,"ZACUALTIPAN DE ANGELES, HGO.",1,0,1,0,1,0,
22/08/2017,MOR.,"EMILIANO ZAPATA, MOR.",1,0,1,0,0,52,
22/08/2017,MEX.,"SAN MARTIN DE LAS PIRAMIDES, MEX.",1,0,1,1,0,288,
22/08/2017,COAH.,"PIEDRAS NEGRAS, COAH.",1,0,1,0,0,0,
22/08/2017,COAH.,"RAMOS ARIZPE, COAH.",0,1,1,1,0,494,
22/08/2017,COAH.,"SALTILLO, COAH.",1,0,1,0,0,28,
22/08/2017,COAH.,"SAN PEDRO, COAH.",1,0,1,0,0,0,
22/08/2017,COAH.,"SAN PEDRO, COAH.",1,0,1,0,0,0,
22/08/2017,MEX.,"VILLA DE ALLENDE, MEX.",1,0,1,0,0,0,
22/08/2017,YUC.,"TINUM, YUC.",1,0,1,0,0,0,
22/08/2017,VER.,"COATEPEC, VER.",1,0,1,1,0,24,
22/08/2017,TAB.,"CENTRO, TAB.",1,0,1,0,0,0,
22/08/2017,B.C.,"MEXICALI, B.C.",0,1,1,0,0,0,
22/08/2017,MEX.,"NICOLAS ROMERO, MEX.",0,0,0,0,0,23,
22/08/2017,COAH.,"MÚZQUIZ, COAH.",0,0,0,0,0,700,
22/08/2017,MEX.,"TONATICO, MEX.",0,0,0,0,0,320,
23/08/2017,N.L.,"APODACA, N.L.",2,3,5,0,0,0,
23/08/2017,VER.,"COATEPEC, VER.",4,0,4,3,0,214,
23/08/2017,B.C.,"TIJUANA, B.C.",1,2,3,0,0,0,
23/08/2017,D.F.,"VENUSTIANO CARRANZA, D.F.",3,0,3,0,0,514,
23/08/2017,S.L.P.,"SAN LUIS POTOSI, S.L.P.",2,0,2,1,0,0,
23/08/2017,TAMPS.,"REYNOSA, TAMPS.",1,1,2,0,0,12,
23/08/2017,GRO.,"ARCELIA, GRO.",1,0,1,0,0,0,
23/08/2017,MOR.,"EMILIANO ZAPATA, MOR.",0,0,0,0,0,31,
23/08/2017,SIN.,"COSALA, SIN.",0,0,0,0,3,0,
24/08/2017,N.L.,"MONTERREY, N.L.",2,5,7,0,1,33,
24/08/2017,MEX.,"IXTAPALUCA, MEX.",6,1,7,0,0,0,
24/08/2017,MEX.,"VILLA DE ALLENDE, MEX.",1,0,1,0,0,90,
24/08/2017,MOR.,"EMILIANO ZAPATA, MOR.",1,0,1,0,3,0,
24/08/2017,CHIH.,"JANOS, CHIH.",1,0,1,0,0,0,
24/08/2017,COAH.,"MATAMOROS, COAH.",1,0,1,0,0,0,
24/08/2017,COAH.,"MÚZQUIZ, COAH.",1,0,1,0,0,0,
24/08/2017,COAH.,"RAMOS ARIZPE, COAH.",1,0,1,0,0,34,
24/08/2017,COAH.,"SALTILLO, COAH.",1,0,1,0,0,930,
24/08/2017,GRO.,"COAHUAYUTLA DE JOSE MARIA IZAZAGA, GRO.",0,1,1,0,0,0,
24/08/2017,DGO.,"DGO., DGO.",1,0,1,1,0,0,
24/08/2017,MEX.,"SAN MARTIN DE LAS PIRAMIDES, MEX.",0,1,1,0,12,0,
24/08/2017,SIN.,"COSALA, SIN.",0,0,0,0,3,0,
24/08/2017,S.L.P.,"SAN LUIS POTOSI, S.L.P.",0,0,0,14,0,0,
25/08/2017,COAH.,"ACUÑA, COAH.",2,2,4,0,0,0,
25/08/2017,SIN.,"ANGOSTURA, SIN.",1,2,3,0,0,0,
25/08/2017,MEX.,"IXTAPALUCA, MEX.",3,0,3,0,0,0,
25/08/2017,N.L.,"MONTERREY, N.L.",1,2,3,7,0,79,
25/08/2017,COAH.,"TORREÓN, COAH.",2,0,2,0,0,0,
25/08/2017,MOR.,"EMILIANO ZAPATA, MOR.",2,0,2,9,0,153,
25/08/2017,D.F.,"VENUSTIANO CARRANZA, D.F.",1,0,1,0,0,338,
25/08/2017,COAH.,"SABINAS, COAH.",0,1,1,5,0,0,
25/08/2017,B.C.,"TIJUANA, B.C.",1,0,1,0,0,0,
25/08/2017,B.C.,"ENSENADA, B.C.",0,1,1,0,0,0,
25/08/2017,MEX.,"SAN MARTIN DE LAS PIRAMIDES, MEX.",1,0,1,0,0,0,
25/08/2017,N.L.,"LOS HERRERAS, N.L.",0,1,1,0,0,0,
25/08/2017,S.L.P.,"SAN LUIS POTOSI, S.L.P.",1,0,1,0,0,0,
25/08/2017,VER.,"ALTOTONGA, VER.",1,0,1,1,0,36,
25/08/2017,TAMPS.,"MATAMOROS, TAMPS.",0,0,0,9,0,26,
25/08/2017,VER.,"COATEPEC, VER.",0,0,0,0,0,28,
25/08/2017,VER.,"MISANTLA, VER.",0,0,0,1,0,8,
25/08/2017,COAH.,"RAMOS ARIZPE, COAH.",0,0,0,2,0,330,
26/08/2017,COAH.,"RAMOS ARIZPE, COAH.",5,0,5,1,0,500,
26/08/2017,S.L.P.,"SAN LUIS POTOSI, S.L.P.",3,0,3,8,0,180,
26/08/2017,MEX.,"VILLA DE ALLENDE, MEX.",1,1,2,2,0,0,
26/08/2017,S.L.P.,"CIUDAD VALLES, S.L.P.",2,0,2,0,0,0,
26/08/2017,TAMPS.,"MATAMOROS, TAMPS.",0,1,1,0,0,0,
26/08/2017,DGO.,"DGO., DGO.",1,0,1,0,0,0,
26/08/2017,B.C.,"TIJUANA, B.C.",0,1,1,0,0,0,
26/08/2017,HGO.,"ZACUALTIPAN DE ANGELES, HGO.",1,0,1,0,0,0,
26/08/2017,MEX.,"NICOLAS ROMERO, MEX.",0,0,0,0,0,88,
27/08/2017,MEX.,"IXTAPALUCA, MEX.",6,3,9,0,0,292,
27/08/2017,COAH.,"MONCLOVA, COAH.",2,2,4,0,0,119,
27/08/2017,COAH.,"SALTILLO, COAH.",3,0,3,0,0,30,
27/08/2017,MEX.,"SAN MARTIN DE LAS PIRAMIDES, MEX.",1,1,2,0,0,0,
27/08/2017,COAH.,"TORREÓN, COAH.",2,0,2,0,0,0,
27/08/2017,COAH.,"PIEDRAS NEGRAS, COAH.",1,0,1,0,0,0,
27/08/2017,S.L.P.,"SAN LUIS POTOSI, S.L.P.",1,0,1,0,0,0,
28/08/2017,S.L.P.,"SAN LUIS POTOSI, S.L.P.",2,1,3,2,0,0,
28/08/2017,GRO.,"ATOYAC DE ALVAREZ, GRO.",3,0,3,5,0,63,
28/08/2017,D.F.,"TLALPAN, D.F.",0,2,2,0,1,14,
28/08/2017,COAH.,"TORREÓN, COAH.",2,0,2,0,0,0,
28/08/2017,B.C.,"TIJUANA, B.C.",0,1,1,0,0,0,
28/08/2017,N.L.,"MONTERREY, N.L.",1,0,1,1,0,254,
28/08/2017,TAMPS.,"NUEVO LAREDO, TAMPS.",0,1,1,0,0,300,
28/08/2017,MOR.,"EMILIANO ZAPATA, MOR.",0,0,0,0,1,138,
28/08/2017,COAH.,"RAMOS ARIZPE, COAH.",0,0,0,0,0,294,
29/08/2017,MEX.,"CHICOLOAPAN, MEX.",11,5,16,0,0,188,
29/08/2017,DGO.,"DGO., DGO.",3,0,3,2,0,0,
29/08/2017,COAH.,"RAMOS ARIZPE, COAH.",2,0,2,2,0,400,
29/08/2017,COAH.,"MÚZQUIZ, COAH.",0,2,2,0,0,0,
29/08/2017,B.C.,"MEXICALI, B.C.",1,1,2,0,0,0,
29/08/2017,S.L.P.,"SAN LUIS POTOSI, S.L.P.",2,0,2,0,1,0,
29/08/2017,TAMPS.,"NUEVO LAREDO, TAMPS.",1,0,1,0,0,300,
29/08/2017,MEX.,"TULTITLAN, MEX.",1,0,1,0,0,0,
29/08/2017,MEX.,"LA PAZ, MEX.",1,0,1,0,0,24,
29/08/2017,COAH.,"TORREÓN, COAH.",1,0,1,0,0,0,
29/08/2017,COAH.,"MATAMOROS, COAH.",0,1,1,0,0,0,
29/08/2017,COAH.,"FRANCISCO I. MADERO, COAH.",1,0,1,0,0,0,
29/08/2017,COAH.,"SALTILLO, COAH.",0,1,1,0,2,0,
29/08/2017,B.C.,"TIJUANA, B.C.",0,1,1,0,0,0,
29/08/2017,TAMPS.,"TAMPICO, TAMPS.",0,0,0,1,0,187,
29/08/2017,D.F.,"TLALPAN, D.F.",0,0,0,0,0,444,
30/08/2017,N.L.,"MONTERREY, N.L.",0,3,3,0,0,77,
30/08/2017,SIN.,"ANGOSTURA, SIN.",1,1,2,0,0,0,
30/08/2017,TAMPS.,"NUEVO LAREDO, TAMPS.",2,0,2,5,0,370,
30/08/2017,COAH.,"TORREÓN, COAH.",2,0,2,0,0,0,
30/08/2017,DGO.,"DGO., DGO.",1,0,1,0,0,0,
30/08/2017,S.L.P.,"SAN LUIS POTOSI, S.L.P.",1,0,1,0,0,0,
30/08/2017,MEX.,"XALATLACO, MEX.",0,1,1,0,0,0,
30/08/2017,COAH.,"MATAMOROS, COAH.",1,0,1,0,0,0,
31/08/2017,COAH.,"MONCLOVA, COAH.",4,0,4,0,3,326,
31/08/2017,COAH.,"NUEVA ROSITA, COAH.",2,0,2,0,0,300,
31/08/2017,B.C.,"TIJUANA, B.C.",1,1,2,0,0,0,
31/08/2017,S.L.P.,"CIUDAD VALLES, S.L.P.",2,0,2,0,0,0,
31/08/2017,MEX.,"ZACAZONAPAN, MEX.",1,1,2,0,0,0,
31/08/2017,MEX.,"CHICOLOAPAN, MEX.",2,0,2,1,2,181,
31/08/2017,MEX.,"LA PAZ, MEX.",1,1,2,0,0,0,
31/08/2017,TAMPS.,"NUEVO LAREDO, TAMPS.",1,0,1,0,0,0,
31/08/2017,COAH.,"ACUÑA, COAH.",1,0,1,0,0,0,
31/08/2017,B.C.,"ENSENADA, B.C.",0,1,1,0,0,0,
31/08/2017,D.F.,"TLALPAN, D.F.",0,1,1,0,0,0,
31/08/2017,MEX.,"TULTITLAN, MEX.",0,1,1,0,0,23,
01/09/2017,MEX.,"XALATLACO, MEX.",0,3,3,0,0,0,
01/09/2017,CHIH.,"HGO. DEL PARRAL, CHIH.",2,0,2,0,0,0,
01/09/2017,N.L.,"MONTERREY, N.L.",1,1,2,2,0,150,
01/09/2017,MEX.,"ZACAZONAPAN, MEX.",1,0,1,0,0,0,
01/09/2017,D.F.,"TLALPAN, D.F.",1,0,1,0,0,0,
01/09/2017,TAMPS.,"NUEVO LAREDO, TAMPS.",1,0,1,0,0,200,
01/09/2017,MOR.,"EMILIANO ZAPATA, MOR.",0,0,0,10,6,0,
02/09/2017,COAH.,"RAMOS ARIZPE, COAH.",4,2,6,0,3,0,
02/09/2017,GRO.,"ATOYAC DE ALVAREZ, GRO.",1,1,2,1,0,34,
02/09/2017,COAH.,"TORREÓN, COAH.",1,0,1,0,0,0,
02/09/2017,S.L.P.,"SAN LUIS POTOSI, S.L.P.",1,0,1,0,0,0,
02/09/2017,DGO.,"DGO., DGO.",0,1,1,0,1,0,
02/09/2017,MEX.,"XALATLACO, MEX.",1,0,1,0,0,0,
02/09/2017,TAB.,"BENEMÉRITO DE LAS AMÉRICAS, CHIS.",1,0,1,0,0,0,
02/09/2017,COAH.,"SAN PEDRO, COAH.",1,0,1,0,0,0,
02/09/2017,COAH.,"SALTILLO, COAH.",0,0,0,4,0,135,
03/09/2017,MEX.,"CHICOLOAPAN, MEX.",5,2,7,0,0,72,
03/09/2017,MEX.,"TULTITLAN, MEX.",3,0,3,0,0,0,
03/09/2017,VER.,"ISLA, VER.",1,1,2,0,0,0,
03/09/2017,MEX.,"XALATLACO, MEX.",1,0,1,0,0,27,
03/09/2017,B.C.,"ENSENADA, B.C.",1,0,1,0,1,0,
03/09/2017,MEX.,"LA PAZ, MEX.",0,0,0,0,0,463,
04/09/2017,ZAC.,"GUADALUPE, ZAC.",2,4,6,0,0,0,
04/09/2017,Q. ROO,"TULUM, Q. ROO",0,1,1,0,0,0,
04/09/2017,D.F.,"TLALPAN, D.F.",1,0,1,0,7,1662,
04/09/2017,QRO.,"JALPAN DE SERRA, QRO.",0,1,1,0,0,0,
04/09/2017,DGO.,"DGO., DGO.",0,1,1,0,1,0,
04/09/2017,COAH.,"TORREÓN, COAH.",0,1,1,0,1,0,
04/09/2017,S.L.P.,"CIUDAD VALLES, S.L.P.",1,0,1,0,0,0,
04/09/2017,COAH.,"SALTILLO, COAH.",1,0,1,1,0,77,
04/09/2017,COAH.,"RAMOS ARIZPE, COAH.",1,0,1,0,0,0,
04/09/2017,B.C.,"ENSENADA, B.C.",0,0,0,0,1,0,
04/09/2017,AGS.,"AGS., AGS.",0,0,0,30,0,0,
05/09/2017,GTO.,"GTO., GTO.",7,0,7,0,0,99,
05/09/2017,COAH.,"TORREÓN, COAH.",5,1,6,0,0,0,
05/09/2017,MEX.,"ZACUALPAN, MEX.",0,2,2,0,0,0,
05/09/2017,VER.,"UXPANAPA, VER.",2,0,2,1,0,0,
05/09/2017,TAMPS.,"TAMPICO, TAMPS.",1,1,2,0,0,594,
05/09/2017,N.L.,"MONTERREY, N.L.",0,1,1,1,0,65,
05/09/2017,COAH.,"FRANCISCO I. MADERO, COAH.",0,1,1,0,0,0,
05/09/2017,S.L.P.,"CIUDAD VALLES, S.L.P.",1,0,1,0,0,0,
05/09/2017,MEX.,"APAXCO, MEX.",1,0,1,0,0,0,
05/09/2017,MEX.,"HUIXQUILUCAN, MEX.",0,0,0,0,0,200,
05/09/2017,MEX.,"HUIXQUILUCAN, MEX.",0,0,0,0,0,200,
05/09/2017,CHIH.,"NUEVO CASAS GRANDES, CHIH.",0,0,0,0,0,155,
06/09/2017,GTO.,"GTO., GTO.",10,4,14,0,0,13,
06/09/2017,COAH.,"TORREÓN, COAH.",3,0,3,0,0,316,
06/09/2017,N.L.,"MONTERREY, N.L.",1,1,2,0,0,0,
06/09/2017,GRO.,"CHILPANCINGO DE LOS BRAVO, GRO.",0,1,1,0,0,0,
06/09/2017,MEX.,"CHIAUTLA, MEX.",0,1,1,0,0,0,
06/09/2017,MEX.,"APAXCO, MEX.",1,0,1,1,0,0,
06/09/2017,ZAC.,"GUADALUPE, ZAC.",0,1,1,0,0,18,
06/09/2017,COAH.,"MATAMOROS, COAH.",1,0,1,0,0,0,
06/09/2017,COAH.,"SALTILLO, COAH.",1,0,1,0,0,47,
06/09/2017,COAH.,"RAMOS ARIZPE, COAH.",0,0,0,0,0,360,
06/09/2017,AGS.,"AGS., AGS.",0,0,0,51,0,0,
07/09/2017,GTO.,"GTO., GTO.",7,7,14,0,1,70,
07/09/2017,COAH.,"TORREÓN, COAH.",5,0,5,25,0,54,
07/09/2017,ZAC.,"GUADALUPE, ZAC.",3,2,5,0,0,640,
07/09/2017,COAH.,"SALTILLO, COAH.",2,0,2,0,0,175,
07/09/2017,MEX.,"APAXCO, MEX.",2,0,2,0,0,954,
07/09/2017,N.L.,"MONTERREY, N.L.",0,2,2,0,0,0,
07/09/2017,MEX.,"ZACUALPAN, MEX.",0,2,2,1,0,0,
07/09/2017,COAH.,"RAMOS ARIZPE, COAH.",1,0,1,0,0,0,
07/09/2017,COAH.,"PIEDRAS NEGRAS, COAH.",1,0,1,0,0,0,
07/09/2017,MEX.,"CHIAUTLA, MEX.",1,0,1,0,0,445,
07/09/2017,B.C.,"MEXICALI, B.C.",1,0,1,0,0,0,
07/09/2017,D.F.,"TLALPAN, D.F.",0,0,0,0,0,1119,
07/09/2017,Q. ROO,"TULUM, Q. ROO",0,0,0,0,0,21,
07/09/2017,CHIH.,"NUEVO CASAS GRANDES, CHIH.",0,0,0,0,0,93,
07/09/2017,GRO.,"AJUCHITLAN DEL PROGRESO, GRO.",0,0,0,0,0,88,
08/09/2017,MEX.,"ZACUALPAN, MEX.",4,2,6,0,0,3,
08/09/2017,QRO.,"JALPAN DE SERRA, QRO.",1,1,2,0,0,0,
08/09/2017,TAMPS.,"MATAMOROS, TAMPS.",1,1,2,1,0,28,
08/09/2017,S.L.P.,"CIUDAD VALLES, S.L.P.",1,0,1,0,0,0,
08/09/2017,COAH.,"SAN PEDRO, COAH.",1,0,1,0,0,0,
08/09/2017,COAH.,"SALTILLO, COAH.",1,0,1,0,0,44,
08/09/2017,COAH.,"SABINAS, COAH.",1,0,1,0,0,0,
08/09/2017,COAH.,"TORREÓN, COAH.",1,0,1,0,0,0,
08/09/2017,MEX.,"CHIAUTLA, MEX.",1,0,1,0,0,71,
08/09/2017,Q. ROO,"TULUM, Q. ROO",0,0,0,0,0,20,
08/09/2017,DGO.,"DGO., DGO.",0,0,0,0,10,0,
08/09/2017,MEX.,"APAXCO, MEX.",0,0,0,0,0,443,
09/09/2017,QRO.,"PINAL DE AMOLES, QRO.",7,1,8,0,0,0,
09/09/2017,MEX.,"CHIAUTLA, MEX.",4,0,4,0,0,0,
09/09/2017,B.C.,"ENSENADA, B.C.",1,2,3,0,0,0,
09/09/2017,TAMPS.,"MATAMOROS, TAMPS.",1,1,2,1,0,28,
09/09/2017,DGO.,"DGO., DGO.",1,0,1,0,0,0,
09/09/2017,S.L.P.,"CIUDAD VALLES, S.L.P.",1,0,1,0,0,0,
09/09/2017,S.L.P.,"SAN LUIS POTOSI, S.L.P.",1,0,1,3,1,0,
09/09/2017,MEX.,"ZACUALPAN, MEX.",0,1,1,0,0,0,
09/09/2017,MEX.,"ZUMPAHUACAN, MEX.",1,0,1,0,0,0,
09/09/2017,COAH.,"SAN PEDRO, COAH.",1,0,1,0,0,0,
09/09/2017,MEX.,"APAXCO, MEX.",0,1,1,0,0,0,
09/09/2017,B.C.,"MEXICALI, B.C.",0,1,1,0,0,0,
09/09/2017,ZAC.,"GUADALUPE, ZAC.",0,0,0,0,0,384,
10/09/2017,MEX.,"ZACUALPAN, MEX.",4,2,6,0,0,0,
10/09/2017,MEX.,"HUIXQUILUCAN, MEX.",2,1,3,1,0,1000,
10/09/2017,QRO.,"PINAL DE AMOLES, QRO.",2,1,3,0,0,0,
10/09/2017,MEX.,"CHIAUTLA, MEX.",1,1,2,0,0,796,
10/09/2017,COAH.,"SAN PEDRO, COAH.",1,0,1,0,0,0,
10/09/2017,MEX.,"APAXCO, MEX.",0,0,0,0,0,758,
11/09/2017,ZAC.,"TLALTENANGO DE SANCHEZ ROMAN, ZAC.",2,2,4,0,0,102,
11/09/2017,N.L.,"MONTERREY, N.L.",4,0,4,1,0,45,
11/09/2017,ZAC.,"TRANCOSO, ZAC.",3,0,3,0,0,830,
11/09/2017,GTO.,"GTO., GTO.",3,0,3,0,0,0,
11/09/2017,AGS.,"AGS., AGS.",2,0,2,0,0,0,
11/09/2017,DGO.,"DGO., DGO.",0,1,1,0,0,0,
11/09/2017,ZAC.,"GUADALUPE, ZAC.",0,0,0,0,0,76,
12/09/2017,GTO.,"GTO., GTO.",11,1,12,0,0,13,
12/09/2017,ZAC.,"FRESNILLO, ZAC.",7,3,10,0,0,274,
12/09/2017,DGO.,"DGO., DGO.",3,1,4,3,0,0,
12/09/2017,COAH.,"SALTILLO, COAH.",3,1,4,3,0,104,
12/09/2017,ZAC.,"GUADALUPE, ZAC.",3,1,4,6,2,918,
12/09/2017,COAH.,"RAMOS ARIZPE, COAH.",3,0,3,0,4,0,
12/09/2017,JAL.,"PUERTO VALLARTA, JAL.",1,2,3,0,0,0,
12/09/2017,B.C.,"TIJUANA, B.C.",2,0,2,0,0,0,
12/09/2017,AGS.,"AGS., AGS.",1,1,2,0,0,0,
12/09/2017,ZAC.,"TRANCOSO, ZAC.",2,0,2,0,0,0,
12/09/2017,B.C.,"ENSENADA, B.C.",0,1,1,0,0,0,
12/09/2017,ZAC.,"TLALTENANGO DE SANCHEZ ROMAN, ZAC.",1,0,1,0,0,0,
12/09/2017,CHIH.,"NUEVO CASAS GRANDES, CHIH.",0,0,0,0,0,345,
13/09/2017,GTO.,"GTO., GTO.",18,0,18,0,1,0,
13/09/2017,ZAC.,"FRESNILLO, ZAC.",11,1,12,0,0,90,
13/09/2017,ZAC.,"GUADALUPE, ZAC.",4,1,5,2,0,769,
13/09/2017,CHIH.,"GUADALUPE, CHIH.",0,3,3,1,0,63,
13/09/2017,B.C.,"MEXICALI, B.C.",0,2,2,0,0,0,
13/09/2017,COAH.,"SAN PEDRO, COAH.",1,0,1,0,0,0,
13/09/2017,ZAC.,"TLALTENANGO DE SANCHEZ ROMAN, ZAC.",0,1,1,0,0,35,
13/09/2017,D.F.,"TLALPAN, D.F.",1,0,1,0,0,200,
13/09/2017,D.F.,"ALVARO OBREGON, D.F.",0,1,1,0,1,0,
14/09/2017,GTO.,"GTO., GTO.",3,1,4,0,4,76,
14/09/2017,COAH.,"SALTILLO, COAH.",4,0,4,0,0,0,
14/09/2017,COAH.,"RAMOS ARIZPE, COAH.",3,0,3,0,0,0,
14/09/2017,ZAC.,"GUADALUPE, ZAC.",2,0,2,0,0,450,
14/09/2017,B.C.,"ENSENADA, B.C.",1,0,1,0,0,0,
14/09/2017,COAH.,"SAN PEDRO, COAH.",0,1,1,0,0,0,
14/09/2017,AGS.,"AGS., AGS.",1,0,1,0,0,0,
14/09/2017,D.F.,"ALVARO OBREGON, D.F.",1,0,1,0,0,0,
14/09/2017,ZAC.,"TLALTENANGO DE SANCHEZ ROMAN, ZAC.",1,0,1,0,0,210,
15/09/2017,ZAC.,"GUADALUPE, ZAC.",4,1,5,0,0,1060,
15/09/2017,N.L.,"MONTERREY, N.L.",3,0,3,0,0,0,
15/09/2017,N.L.,"LINARES, N.L.",2,1,3,0,1,35,
15/09/2017,DGO.,"DGO., DGO.",1,1,2,0,0,0,
15/09/2017,AGS.,"AGS., AGS.",1,1,2,0,0,0,
15/09/2017,ZAC.,"TLALTENANGO DE SANCHEZ ROMAN, ZAC.",2,0,2,0,0,351,
15/09/2017,ZAC.,"TAB., ZAC.",1,1,2,0,0,361,
15/09/2017,TAMPS.,"MATAMOROS, TAMPS.",0,1,1,6,0,297,
15/09/2017,VER.,"ISLA, VER.",1,0,1,0,0,0,
16/09/2017,DGO.,"DGO., DGO.",1,0,1,1,0,0,
17/09/2017,DGO.,"DGO., DGO.",1,0,1,0,0,0,
18/09/2017,D.F.,"CUAJIMALPA DE MOR., D.F.",5,1,6,0,0,0,
18/09/2017,COAH.,"TORREÓN, COAH.",4,1,5,0,0,0,
18/09/2017,DGO.,"DGO., DGO.",2,1,3,3,0,0,
18/09/2017,ZAC.,"GUADALUPE, ZAC.",2,1,3,0,0,220,
18/09/2017,ZAC.,"FRESNILLO, ZAC.",3,0,3,1,0,301,
18/09/2017,ZAC.,"TLALTENANGO DE SANCHEZ ROMAN, ZAC.",3,0,3,0,0,5,
18/09/2017,N.L.,"LINARES, N.L.",3,0,3,0,0,0,
18/09/2017,B.C.,"TIJUANA, B.C.",1,0,1,0,0,0,
18/09/2017,COAH.,"SALTILLO, COAH.",1,0,1,2,2,210,
18/09/2017,COAH.,"ACUÑA, COAH.",1,0,1,0,0,0,
18/09/2017,GRO.,"TECPAN DE GALEANA, GRO.",1,0,1,1,0,7,
18/09/2017,COAH.,"SAN PEDRO, COAH.",0,0,0,8,0,265,
19/09/2017,SIN.,"AHOME, SIN.",1,3,4,0,0,0,
19/09/2017,N.L.,"MONTERREY, N.L.",2,1,3,0,0,0,
19/09/2017,ZAC.,"GUADALUPE, ZAC.",1,0,1,0,0,0,
19/09/2017,DGO.,"DGO., DGO.",1,0,1,7,0,0,
19/09/2017,SIN.,"MOCORITO, SIN.",1,0,1,0,2,0,
19/09/2017,MEX.,"AMATEPEC, MEX.",1,0,1,0,0,0,
19/09/2017,MEX.,"COYOTEPEC, MEX.",0,1,1,0,0,0,
19/09/2017,TAMPS.,"TAMPICO, TAMPS.",1,0,1,0,0,0,
19/09/2017,B.C.,"TIJUANA, B.C.",0,1,1,0,0,0,
19/09/2017,B.C.,"MEXICALI, B.C.",1,0,1,0,0,0,
19/09/2017,GRO.,"TECPAN DE GALEANA, GRO.",1,0,1,1,0,8,
19/09/2017,ZAC.,"FRESNILLO, ZAC.",0,0,0,1,0,24,
19/09/2017,AGS.,"AGS., AGS.",0,0,0,1,0,0,
19/09/2017,GTO.,"GTO., GTO.",0,0,0,0,1,0,
20/09/2017,SIN.,"AHOME, SIN.",10,5,15,0,1,0,
20/09/2017,N.L.,"MONTERREY, N.L.",3,1,4,0,0,0,
20/09/2017,ZAC.,"FRESNILLO, ZAC.",1,1,2,13,0,506,
20/09/2017,ZAC.,"GUADALUPE, ZAC.",1,0,1,1,0,264,
20/09/2017,COAH.,"FRANCISCO I. MADERO, COAH.",0,1,1,1,0,0,
20/09/2017,GRO.,"TECPAN DE GALEANA, GRO.",0,1,1,0,0,0,
20/09/2017,MEX.,"AMATEPEC, MEX.",1,0,1,0,0,0,
20/09/2017,N.L.,"LINARES, N.L.",0,1,1,0,0,0,
20/09/2017,MEX.,"COYOTEPEC, MEX.",0,1,1,0,0,53,
20/09/2017,DGO.,"DGO., DGO.",0,0,0,0,3,0,
21/09/2017,SIN.,"AHOME, SIN.",4,2,6,0,1,0,
21/09/2017,AGS.,"AGS., AGS.",1,4,5,3,0,0,
21/09/2017,COAH.,"SALTILLO, COAH.",3,1,4,0,0,387,
21/09/2017,DGO.,"DGO., DGO.",0,2,2,0,0,0,
21/09/2017,ZAC.,"GUADALUPE, ZAC.",2,0,2,0,0,915,
21/09/2017,SIN.,"MOCORITO, SIN.",1,1,2,0,4,0,
21/09/2017,MEX.,"AMANALCO, MEX.",0,1,1,0,0,0,
21/09/2017,N.L.,"LINARES, N.L.",1,0,1,0,0,0,
21/09/2017,COAH.,"RAMOS ARIZPE, COAH.",1,0,1,0,0,650,
21/09/2017,COAH.,"ACUÑA, COAH.",1,0,1,0,0,0,
21/09/2017,N.L.,"CHINA, N.L.",0,0,0,0,1,0,
21/09/2017,SON.,"HERMOSILLO, SON.",0,0,0,7,0,0,
22/09/2017,ZAC.,"GUADALUPE, ZAC.",4,2,6,0,1,1217,
22/09/2017,ZAC.,"BENITO JUAREZ, ZAC.",4,2,6,0,0,0,
22/09/2017,SIN.,"AHOME, SIN.",6,0,6,0,0,0,
22/09/2017,MEX.,"AMATEPEC, MEX.",1,3,4,1,0,0,
22/09/2017,COAH.,"RAMOS ARIZPE, COAH.",3,0,3,2,2,0,
22/09/2017,TAMPS.,"MATAMOROS, TAMPS.",1,2,3,2,0,176,
22/09/2017,AGS.,"AGS., AGS.",3,0,3,0,0,0,
22/09/2017,SON.,"HERMOSILLO, SON.",2,0,2,1,0,32,
22/09/2017,COL.,"COL., COL.",0,2,2,0,0,0,
22/09/2017,ZAC.,"JALPA, ZAC.",1,1,2,0,0,242,
22/09/2017,B.C.,"ENSENADA, B.C.",1,1,2,0,0,0,
22/09/2017,B.C.,"MEXICALI, B.C.",1,1,2,0,0,0,
22/09/2017,MEX.,"COYOTEPEC, MEX.",2,0,2,2,0,18,
22/09/2017,ZAC.,"PINOS, ZAC.",1,0,1,0,0,0,
22/09/2017,COAH.,"SALTILLO, COAH.",0,1,1,0,0,0,
22/09/2017,N.L.,"LINARES, N.L.",0,1,1,0,0,0,
22/09/2017,TAB.,"CENTRO, TAB.",0,1,1,0,0,0,
22/09/2017,MEX.,"TEPOTZOTLAN, MEX.",1,0,1,0,0,0,
22/09/2017,N.L.,"MONTERREY, N.L.",0,0,0,4,0,40,
22/09/2017,SIN.,"MOCORITO, SIN.",0,0,0,0,1,0,
23/09/2017,MEX.,"AMANALCO, MEX.",1,0,1,0,0,0,
23/09/2017,TAB.,"TENOSIQUE, TAB.",1,0,1,0,0,0,
23/09/2017,COAH.,"SALTILLO, COAH.",1,0,1,0,1,0,
23/09/2017,TAMPS.,"NUEVO LAREDO, TAMPS.",0,0,0,2,0,50,
23/09/2017,TAB.,"CENTRO, TAB.",0,0,0,1,0,207,
24/09/2017,ZAC.,"ZAC., ZAC.",5,0,5,0,0,641,
24/09/2017,MEX.,"TEPOTZOTLAN, MEX.",1,2,3,3,0,69,
24/09/2017,DGO.,"DGO., DGO.",2,1,3,0,0,0,
24/09/2017,MEX.,"COYOTEPEC, MEX.",0,2,2,0,0,197,
24/09/2017,MEX.,"AMANALCO, MEX.",0,2,2,0,0,0,
24/09/2017,ZAC.,"GUADALUPE, ZAC.",1,0,1,0,0,1054,
24/09/2017,N.L.,"CHINA, N.L.",1,0,1,0,0,0,
25/09/2017,DGO.,"DGO., DGO.",10,4,14,0,0,0,
25/09/2017,SIN.,"AHOME, SIN.",4,1,5,0,1,183,
25/09/2017,COAH.,"RAMOS ARIZPE, COAH.",5,0,5,2,0,487,
25/09/2017,SIN.,"MOCORITO, SIN.",2,1,3,0,0,0,
25/09/2017,N.L.,"MONTERREY, N.L.",3,0,3,1,0,42,
25/09/2017,N.L.,"LINARES, N.L.",2,1,3,0,0,0,
25/09/2017,AGS.,"AGS., AGS.",2,0,2,0,0,0,
25/09/2017,B.C.,"TIJUANA, B.C.",1,0,1,0,0,0,
25/09/2017,B.C.,"ENSENADA, B.C.",1,0,1,0,0,0,
25/09/2017,GRO.,"COYUCA DE BENITEZ, GRO.",0,1,1,0,0,0,
25/09/2017,COAH.,"SAN PEDRO, COAH.",0,0,0,2,0,60,
26/09/2017,ZAC.,"ZAC., ZAC.",3,2,5,0,0,6,
26/09/2017,SIN.,"AHOME, SIN.",4,1,5,0,1,0,
26/09/2017,DGO.,"DGO., DGO.",2,0,2,2,0,0,
26/09/2017,ZAC.,"GUADALUPE, ZAC.",1,0,1,1,0,27,
26/09/2017,COAH.,"SAN PEDRO, COAH.",1,0,1,0,0,30,
26/09/2017,MEX.,"PAPALOTLA, MEX.",0,1,1,0,0,0,
26/09/2017,ZAC.,"JUCHIPILA, ZAC.",0,0,0,0,0,438,
27/09/2017,SIN.,"AHOME, SIN.",4,5,9,0,1,0,
27/09/2017,ZAC.,"FRESNILLO, ZAC.",3,3,6,3,1,3,
27/09/2017,ZAC.,"GUADALUPE, ZAC.",5,0,5,7,0,664,
27/09/2017,SIN.,"AHOME, SIN.",4,1,5,0,0,0,
27/09/2017,SIN.,"MOCORITO, SIN.",3,1,4,0,3,0,
27/09/2017,JAL.,"PUERTO VALLARTA, JAL.",1,2,3,0,0,0,
27/09/2017,ZAC.,"ZAC., ZAC.",2,1,3,0,0,8,
27/09/2017,SON.,"HERMOSILLO, SON.",2,1,3,4,0,48,
27/09/2017,B.C.,"MEXICALI, B.C.",2,0,2,0,0,0,
27/09/2017,MEX.,"PAPALOTLA, MEX.",1,1,2,0,0,0,
27/09/2017,MEX.,"CAPULHUAC, MEX.",0,1,1,0,0,0,
27/09/2017,N.L.,"LINARES, N.L.",1,0,1,0,0,0,
27/09/2017,N.L.,"MONTERREY, N.L.",1,0,1,5,0,80,
27/09/2017,B.C.,"ENSENADA, B.C.",0,1,1,0,0,0,
27/09/2017,DGO.,"DGO., DGO.",1,0,1,0,0,0,
27/09/2017,TAMPS.,"TAMPICO, TAMPS.",0,0,0,2,0,201,
27/09/2017,ZAC.,"JUCHIPILA, ZAC.",0,0,0,0,0,438,
27/09/2017,MEX.,"ATIZAPAN, MEX.",0,0,0,0,0,50,
28/09/2017,DGO.,"DGO., DGO.",2,3,5,0,0,0,
28/09/2017,ZAC.,"GUADALUPE, ZAC.",2,2,4,0,0,538,
28/09/2017,ZAC.,"ZAC., ZAC.",4,0,4,0,0,638,
28/09/2017,DGO.,"DGO., DGO.",3,1,4,0,0,0,
28/09/2017,SON.,"HERMOSILLO, SON.",2,1,3,4,0,36,
28/09/2017,COAH.,"SALTILLO, COAH.",2,0,2,0,0,0,
28/09/2017,COAH.,"RAMOS ARIZPE, COAH.",1,1,2,0,0,149,
28/09/2017,MEX.,"ATIZAPAN, MEX.",1,1,2,0,0,0,
28/09/2017,CHIH.,"CASAS GRANDES, CHIH.",0,1,1,0,0,0,
28/09/2017,MEX.,"PAPALOTLA, MEX.",1,0,1,0,0,0,
28/09/2017,SON.,"SAHUARIPA, SON.",1,0,1,0,0,0,
28/09/2017,COAH.,"PIEDRAS NEGRAS, COAH.",0,0,0,2,0,363,
28/09/2017,AGS.,"AGS., AGS.",0,0,0,1,0,0,
29/09/2017,N.L.,"MONTERREY, N.L.",3,1,4,0,0,0,
29/09/2017,ZAC.,"ZAC., ZAC.",3,1,4,0,0,0,
29/09/2017,MEX.,"ATIZAPAN, MEX.",2,2,4,2,0,55,
29/09/2017,TAMPS.,"TAMPICO, TAMPS.",0,4,4,2,0,123,
29/09/2017,ZAC.,"EL PLATEADO DE JOAQUIN AMARO, ZAC.",1,1,2,0,0,0,
29/09/2017,COAH.,"SALTILLO, COAH.",1,1,2,0,0,0,
29/09/2017,COAH.,"RAMOS ARIZPE, COAH.",2,0,2,0,0,0,
29/09/2017,MEX.,"TIANGUISTENCO, MEX.",2,0,2,0,0,0,
29/09/2017,SIN.,"AHOME, SIN.",2,0,2,0,7,0,
29/09/2017,GRO.,"COYUCA DE BENITEZ, GRO.",1,1,2,0,0,0,
29/09/2017,ZAC.,"JUCHIPILA, ZAC.",1,0,1,0,0,0,
30/09/2017,MEX.,"ATIZAPAN, MEX.",2,0,2,0,0,0,
30/09/2017,TAMPS.,"MATAMOROS, TAMPS.",0,2,2,0,0,0,
30/09/2017,CAMP.,"CALKINÍ, CAMP.",0,1,1,0,0,0,
30/09/2017,B.C.,"MEXICALI, B.C.",1,0,1,0,0,0,
01/10/2017,MEX.,"TIANGUISTENCO, MEX.",1,3,4,1,0,0,
01/10/2017,B.C.,"TIJUANA, B.C.",2,0,2,0,1,0,
02/10/2017,SON.,"HERMOSILLO, SON.",2,4,6,1,0,34,
02/10/2017,ZAC.,"JEREZ, ZAC.",4,0,4,2,0,4,
02/10/2017,N.L.,"MONTERREY, N.L.",3,0,3,1,0,0,
02/10/2017,ZAC.,"GUADALUPE, ZAC.",2,0,2,0,0,14,
02/10/2017,SON.,"GUAYMAS, SON.",1,0,1,1,0,22,
02/10/2017,SON.,"ALAMOS, SON.",1,0,1,1,0,0,
03/10/2017,SIN.,"AHOME, SIN.",6,1,7,0,2,0,
03/10/2017,ZAC.,"JEREZ, ZAC.",1,4,5,5,0,1468,
03/10/2017,ZAC.,"GUADALUPE, ZAC.",3,0,3,0,0,0,
03/10/2017,COAH.,"SALTILLO, COAH.",2,0,2,0,0,0,
03/10/2017,SON.,"HERMOSILLO, SON.",1,1,2,0,0,54,
03/10/2017,B.C.,"MEXICALI, B.C.",0,1,1,0,0,0,
03/10/2017,ZAC.,"OJOCALIENTE, ZAC.",1,0,1,0,0,0,
03/10/2017,ZAC.,"FRESNILLO, ZAC.",1,0,1,0,0,0,
03/10/2017,B.C.,"TIJUANA, B.C.",0,0,0,0,1,0,
04/10/2017,ZAC.,"GUADALUPE, ZAC.",4,5,9,0,0,178,
04/10/2017,ZAC.,"FRESNILLO, ZAC.",4,2,6,0,0,0,
04/10/2017,SON.,"HERMOSILLO, SON.",0,2,2,0,0,84,
04/10/2017,ZAC.,"JEREZ, ZAC.",0,1,1,0,0,0,
04/10/2017,CHIS.,"OCOSINGO, CHIS.",1,0,1,0,0,0,
04/10/2017,B.C.,"ENSENADA, B.C.",1,0,1,0,1,0,
04/10/2017,SON.,"GUAYMAS, SON.",0,0,0,0,0,78,
05/10/2017,ZAC.,"GUADALUPE, ZAC.",4,5,9,0,0,178,
05/10/2017,ZAC.,"JEREZ, ZAC.",2,1,3,1,0,5,
05/10/2017,SIN.,"AHOME, SIN.",2,0,2,0,0,0,
05/10/2017,CHIS.,"OCOSINGO, CHIS.",0,2,2,0,0,0,
05/10/2017,N.L.,"GRAL. BRAVO, N.L.",0,1,1,0,0,0,
05/10/2017,SON.,"ALAMOS, SON.",1,0,1,0,0,0,
05/10/2017,COL.,"COL., COL.",0,1,1,0,0,0,
05/10/2017,SIN.,"MOCORITO, SIN.",0,1,1,0,0,0,
05/10/2017,SON.,"HERMOSILLO, SON.",0,0,0,1,0,25,
06/10/2017,SIN.,"AHOME, SIN.",7,3,10,0,0,251,
06/10/2017,ZAC.,"GUADALUPE, ZAC.",4,0,4,0,0,50,
06/10/2017,TAMPS.,"MATAMOROS, TAMPS.",1,2,3,6,0,268,
06/10/2017,N.L.,"GALEANA, N.L.",2,0,2,0,0,0,
06/10/2017,ZAC.,"JEREZ, ZAC.",1,0,1,0,0,429,
06/10/2017,DGO.,"DGO., DGO.",1,0,1,0,0,0,
06/10/2017,GRO.,"TECPAN DE GALEANA, GRO.",0,1,1,0,0,0,
06/10/2017,SON.,"EMPALME, SON.",1,0,1,1,0,0,
06/10/2017,SON.,"HERMOSILLO, SON.",0,0,0,0,0,24,
07/10/2017,N.L.,"GRAL. BRAVO, N.L.",1,3,4,0,3,0,
07/10/2017,SON.,"HERMOSILLO, SON.",1,1,2,0,0,7,
07/10/2017,TAMPS.,"MATAMOROS, TAMPS.",0,0,0,0,0,89,
07/10/2017,TAMPS.,"NUEVO LAREDO, TAMPS.",0,0,0,0,0,271,
09/10/2017,SON.,"HERMOSILLO, SON.",2,1,3,0,0,41,
09/10/2017,D.F.,"IZTACALCO, D.F.",1,0,1,0,0,55,
09/10/2017,N.L.,"GALEANA, N.L.",1,0,1,0,0,0,
09/10/2017,ZAC.,"RIO GRANDE, ZAC.",1,0,1,0,0,0,
09/10/2017,N.L.,"GALEANA, N.L.",0,0,0,1,0,0,
10/10/2017,B.C.,"MEXICALI, B.C.",3,0,3,0,0,0,
10/10/2017,B.C.,"TIJUANA, B.C.",3,0,3,0,0,0,
10/10/2017,SIN.,"CULIACAN, SIN.",3,0,3,0,0,0,
10/10/2017,SON.,"HERMOSILLO, SON.",2,1,3,1,0,125,
10/10/2017,COAH.,"SALTILLO, COAH.",1,0,1,0,0,0,
10/10/2017,D.F.,"IZTACALCO, D.F.",1,0,1,0,0,13,
11/10/2017,ZAC.,"FRESNILLO, ZAC.",9,1,10,0,0,0,
11/10/2017,SIN.,"CULIACAN, SIN.",3,0,3,0,0,0,
11/10/2017,ZAC.,"GUADALUPE, ZAC.",3,0,3,0,0,0,
11/10/2017,ZAC.,"GUADALUPE, ZAC.",3,0,3,0,0,364,
11/10/2017,AGS.,"AGS., AGS.",2,0,2,1,0,0,
11/10/2017,D.F.,"IZTACALCO, D.F.",0,1,1,0,0,199,
11/10/2017,B.C.,"TIJUANA, B.C.",1,0,1,0,0,0,
11/10/2017,SON.,"HERMOSILLO, SON.",1,0,1,0,0,0,
11/10/2017,N.L.,"MONTERREY, N.L.",0,1,1,0,0,0,
11/10/2017,DGO.,"DGO., DGO.",1,0,1,0,0,0,
11/10/2017,COL.,"COL., COL.",1,0,1,0,0,0,
11/10/2017,GRO.,"TECPAN DE GALEANA, GRO.",1,0,1,1,0,0,
11/10/2017,COAH.,"SALTILLO, COAH.",0,0,0,0,0,115,
12/10/2017,SIN.,"CULIACAN, SIN.",16,1,17,0,0,0,
12/10/2017,D.F.,"IZTACALCO, D.F.",4,1,5,0,0,319,
12/10/2017,SIN.,"CULIACAN, SIN.",3,1,4,0,1,0,
12/10/2017,SON.,"HERMOSILLO, SON.",1,0,1,0,0,192,
12/10/2017,DGO.,"DGO., DGO.",0,1,1,0,0,0,
12/10/2017,MICH.,"APATZINGAN, MICH.",1,0,1,0,0,0,
12/10/2017,B.C.,"MEXICALI, B.C.",0,1,1,0,0,0,
12/10/2017,SON.,"HERMOSILLO, SON.",1,0,1,0,0,70,
12/10/2017,COAH.,"SALTILLO, COAH.",0,0,0,0,0,480,
13/10/2017,D.F.,"IZTACALCO, D.F.",3,2,5,0,0,0,
13/10/2017,N.L.,"MONTERREY, N.L.",4,0,4,0,0,0,
13/10/2017,SIN.,"GUASAVE, SIN.",2,2,4,0,0,0,
13/10/2017,B.C.,"TIJUANA, B.C.",0,3,3,0,0,0,
13/10/2017,COAH.,"ACUÑA, COAH.",0,1,1,0,0,20,
13/10/2017,N.L.,"GALEANA, N.L.",0,1,1,0,0,0,
14/10/2017,COAH.,"ACUÑA, COAH.",5,4,9,0,0,0,
14/10/2017,ZAC.,"OJOCALIENTE, ZAC.",1,0,1,0,0,0,
15/10/2017,TAMPS.,"MATAMOROS, TAMPS.",2,0,2,1,0,37,
15/10/2017,B.C.,"MEXICALI, B.C.",1,0,1,0,0,0,
16/10/2017,SIN.,"CULIACAN, SIN.",4,1,5,0,8,0,
16/10/2017,ZAC.,"GUADALUPE, ZAC.",3,0,3,0,0,0,
16/10/2017,DGO.,"DGO., DGO.",1,1,2,0,0,0,
16/10/2017,D.F.,"LA MAGDALENA CONTRERAS, D.F.",0,1,1,0,0,0,
16/10/2017,SON.,"HERMOSILLO, SON.",1,0,1,0,0,0,
16/10/2017,SIN.,"GUASAVE, SIN.",1,0,1,0,0,0,
16/10/2017,ZAC.,"CUAUHTEMOC, ZAC.",0,1,1,0,0,0,
16/10/2017,MICH.,"APATZINGAN, MICH.",0,0,0,0,0,42,
17/10/2017,SIN.,"CULIACAN, SIN.",3,1,4,0,11,0,
17/10/2017,SON.,"SAHUARIPA, SON.",1,0,1,0,0,0,
17/10/2017,SON.,"ALAMOS, SON.",1,0,1,0,0,0,
17/10/2017,SIN.,"GUASAVE, SIN.",1,0,1,0,0,0,
17/10/2017,ZAC.,"MOMAX, ZAC.",0,1,1,0,0,0,
17/10/2017,COL.,"COL., COL.",1,0,1,0,0,103,
17/10/2017,DGO.,"GOMEZ PALACIO, DGO.",0,1,1,0,0,0,
18/10/2017,ZAC.,"FRESNILLO, ZAC.",7,6,13,0,0,80,
18/10/2017,D.F.,"LA MAGDALENA CONTRERAS, D.F.",3,0,3,0,0,0,
18/10/2017,B.C.,"MEXICALI, B.C.",0,2,2,0,0,0,
18/10/2017,SIN.,"GUASAVE, SIN.",1,1,2,0,0,0,
18/10/2017,B.C.,"TIJUANA, B.C.",1,0,1,0,0,0,
18/10/2017,DGO.,"DGO., DGO.",1,0,1,0,0,0,
18/10/2017,N.L.,"MONTERREY, N.L.",1,0,1,0,0,0,
18/10/2017,SIN.,"CULIACAN, SIN.",1,0,1,0,0,0,
18/10/2017,SON.,"SAHUARIPA, SON.",0,1,1,0,0,0,
18/10/2017,ZAC.,"MOMAX, ZAC.",0,0,0,0,0,105,
19/10/2017,AGS.,"AGS., AGS.",4,0,4,0,0,0,
19/10/2017,D.F.,"LA MAGDALENA CONTRERAS, D.F.",1,2,3,0,0,0,
19/10/2017,COL.,"COL., COL.",1,1,2,0,0,0,
19/10/2017,SON.,"HERMOSILLO, SON.",1,0,1,1,0,0,
19/10/2017,SIN.,"CULIACAN, SIN.",1,0,1,0,0,0,
19/10/2017,DGO.,"SANTIAGO PAPASQUIARO, DGO.",1,0,1,0,0,0,
20/10/2017,SIN.,"CULIACAN, SIN.",3,0,3,0,0,0,
20/10/2017,AGS.,"AGS., AGS.",3,0,3,0,0,0,
20/10/2017,DGO.,"GOMEZ PALACIO, DGO.",1,1,2,0,0,0,
20/10/2017,ZAC.,"MOMAX, ZAC.",2,0,2,2,0,325,
20/10/2017,SON.,"HERMOSILLO, SON.",2,0,2,17,1,130,
20/10/2017,GRO.,"ATOYAC DE ALVAREZ, GRO.",0,2,2,1,0,0,
20/10/2017,SIN.,"GUASAVE, SIN.",1,0,1,0,0,0,
20/10/2017,SON.,"ALAMOS, SON.",1,0,1,0,0,0,
20/10/2017,D.F.,"LA MAGDALENA CONTRERAS, D.F.",0,0,0,0,0,124,
21/10/2017,TAMPS.,"REYNOSA, TAMPS.",8,1,9,2,0,132,
21/10/2017,TAMPS.,"MATAMOROS, TAMPS.",0,2,2,2,0,1,
21/10/2017,COAH.,"ACUÑA, COAH.",1,0,1,1,0,0,
21/10/2017,B.C.S.,"MULEGÉ, B.C.S.",0,1,1,0,0,300,
23/10/2017,ZAC.,"GUADALUPE, ZAC.",6,1,7,5,0,121,
23/10/2017,SIN.,"CULIACAN, SIN.",1,1,2,0,10,0,
23/10/2017,AGS.,"AGS., AGS.",1,0,1,0,0,0,
23/10/2017,SIN.,"GUASAVE, SIN.",1,0,1,0,0,0,
23/10/2017,DGO.,"GOMEZ PALACIO, DGO.",1,0,1,0,0,0,
23/10/2017,GRO.,"COYUCA DE BENITEZ, GRO.",1,0,1,0,0,0,
24/10/2017,SIN.,"CULIACAN, SIN.",6,0,6,0,1,0,
24/10/2017,D.F.,"LA MAGDALENA CONTRERAS, D.F.",3,1,4,0,0,114,
24/10/2017,SON.,"HERMOSILLO, SON.",4,0,4,0,0,5,
24/10/2017,B.C.,"MEXICALI, B.C.",3,0,3,0,0,0,
24/10/2017,SON.,"MOCTEZUMA, SON.",0,1,1,0,0,0,
24/10/2017,DGO.,"GOMEZ PALACIO, DGO.",1,0,1,0,0,0,
25/10/2017,ZAC.,"FRESNILLO, ZAC.",4,3,7,0,0,0,
25/10/2017,ZAC.,"GUADALUPE, ZAC.",5,1,6,0,0,88,
25/10/2017,DGO.,"GOMEZ PALACIO, DGO.",3,2,5,0,0,0,
25/10/2017,B.C.,"TIJUANA, B.C.",1,1,2,0,0,0,
25/10/2017,SON.,"ALAMOS, SON.",2,0,2,1,0,0,
25/10/2017,N.L.,"MONTERREY, N.L.",0,2,2,2,0,0,
25/10/2017,DGO.,"DGO., DGO.",0,1,1,0,0,0,
25/10/2017,SON.,"HERMOSILLO, SON.",1,0,1,0,0,20,
25/10/2017,SIN.,"GUASAVE, SIN.",1,0,1,0,2,0,
25/10/2017,SIN.,"CULIACAN, SIN.",1,0,1,0,9,0,
26/10/2017,ZAC.,"GUADALUPE, ZAC.",5,4,9,7,0,0,
26/10/2017,D.F.,"LA MAGDALENA CONTRERAS, D.F.",3,3,6,0,4,0,
26/10/2017,SIN.,"GUASAVE, SIN.",3,0,3,0,0,0,
26/10/2017,N.L.,"MONTERREY, N.L.",0,2,2,2,0,40,
26/10/2017,ZAC.,"MONTE ESCOBEDO, ZAC.",1,0,1,3,0,36,
26/10/2017,ZAC.,"MOYAHUA DE ESTRADA, ZAC.",1,0,1,0,0,0,
26/10/2017,SIN.,"CULIACAN, SIN.",0,0,0,0,15,0,
26/10/2017,SON.,"HERMOSILLO, SON.",0,0,0,0,0,382,
26/10/2017,B.C.,"ENSENADA, B.C.",0,0,0,0,1,0,
27/10/2017,SIN.,"CULIACAN, SIN.",5,0,5,0,18,0,
27/10/2017,D.F.,"LA MAGDALENA CONTRERAS, D.F.",2,1,3,0,4,0,
27/10/2017,COAH.,"ACUÑA, COAH.",2,0,2,0,0,0,
27/10/2017,CHIS.,"OCOSINGO, CHIS.",1,1,2,0,0,0,
27/10/2017,TAMPS.,"MATAMOROS, TAMPS.",1,0,1,0,0,0,
27/10/2017,AGS.,"AGS., AGS.",1,0,1,0,0,5,
27/10/2017,COAH.,"SABINAS, COAH.",1,0,1,0,0,0,
27/10/2017,DGO.,"GOMEZ PALACIO, DGO.",0,1,1,0,0,0,
27/10/2017,SIN.,"GUASAVE, SIN.",1,0,1,0,0,0,
28/10/2017,TAMPS.,"REYNOSA, TAMPS.",9,3,12,0,0,158,
28/10/2017,DGO.,"GOMEZ PALACIO, DGO.",3,3,6,0,0,0,
28/10/2017,DGO.,"GOMEZ PALACIO, DGO.",3,3,6,0,0,0,
28/10/2017,B.C.,"TIJUANA, B.C.",0,1,1,0,0,0,
28/10/2017,B.C.,"ENSENADA, B.C.",0,1,1,0,0,0,
28/10/2017,B.C.,"TIJUANA, B.C.",0,1,1,0,0,0,
28/10/2017,B.C.,"TIJUANA, B.C.",0,1,1,0,0,0,
29/10/2017,N.L.,"MONTERREY, N.L.",0,2,2,2,0,0,
30/10/2017,D.F.,"ALVARO OBREGON, D.F.",1,0,1,0,0,0,
30/10/2017,B.C.,"MEXICALI, B.C.",0,1,1,0,0,0,
30/10/2017,SON.,"HERMOSILLO, SON.",0,0,0,0,0,70,
31/10/2017,D.F.,"ALVARO OBREGON, D.F.",3,0,3,0,4,0,
31/10/2017,AGS.,"AGS., AGS.",3,0,3,2,0,0,
31/10/2017,CHIH.,"NUEVO CASAS GRANDES, CHIH.",2,0,2,0,0,97,
31/10/2017,B.C.,"TIJUANA, B.C.",0,1,1,0,0,0,
31/10/2017,B.C.,"ENSENADA, B.C.",1,0,1,0,0,0,
31/10/2017,DGO.,"GOMEZ PALACIO, DGO.",1,0,1,0,0,0,
31/10/2017,DGO.,"DGO., DGO.",0,1,1,0,0,0,
31/10/2017,TAMPS.,"TAMPICO, TAMPS.",0,0,0,0,1,0,
01/11/2017,ZAC.,"GUADALUPE, ZAC.",2,2,4,11,0,400,
01/11/2017,SON.,"ALAMOS, SON.",1,0,1,0,0,0,
01/11/2017,D.F.,"ALVARO OBREGON, D.F.",0,0,0,0,0,105,
01/11/2017,SON.,"HERMOSILLO, SON.",0,0,0,0,0,100,
02/11/2017,S.L.P.,"SAN LUIS POTOSI, S.L.P.",2,2,4,0,0,0,
02/11/2017,SON.,"HERMOSILLO, SON.",0,1,1,0,0,0,
03/11/2017,D.F.,"ALVARO OBREGON, D.F.",2,1,3,0,1,279,
03/11/2017,TAMPS.,"MATAMOROS, TAMPS.",1,1,2,5,0,34,
03/11/2017,DGO.,"GOMEZ PALACIO, DGO.",1,0,1,0,0,0,
03/11/2017,SON.,"HERMOSILLO, SON.",0,0,0,0,0,200,
04/11/2017,TAMPS.,"REYNOSA, TAMPS.",7,4,11,0,1,210,
04/11/2017,DGO.,"GOMEZ PALACIO, DGO.",2,2,4,0,0,0,
04/11/2017,S.L.P.,"SAN LUIS POTOSI, S.L.P.",2,0,2,0,0,0,
04/11/2017,TAMPS.,"MATAMOROS, TAMPS.",1,1,2,0,0,0,
05/11/2017,S.L.P.,"SAN LUIS POTOSI, S.L.P.",3,0,3,0,0,0,
05/11/2017,ZAC.,"GUADALUPE, ZAC.",2,1,3,0,0,110,
05/11/2017,D.F.,"ALVARO OBREGON, D.F.",0,0,0,0,4,102,
06/11/2017,VER.,"PANUCO, VER.",4,0,4,0,0,0,
06/11/2017,S.L.P.,"SAN LUIS POTOSI, S.L.P.",3,0,3,0,0,0,
06/11/2017,SON.,"HERMOSILLO, SON.",0,1,1,0,0,0,
06/11/2017,S.L.P.,"CIUDAD VALLES, S.L.P.",0,0,0,0,1,0,
06/11/2017,N.L.,"MONTERREY, N.L.",0,0,0,2,0,0,
07/11/2017,D.F.,"ALVARO OBREGON, D.F.",3,3,6,0,4,0,
07/11/2017,ZAC.,"GUADALUPE, ZAC.",3,2,5,0,0,12,
07/11/2017,SIN.,"MAZATLAN, SIN.",2,0,2,0,0,0,
07/11/2017,S.L.P.,"SAN LUIS POTOSI, S.L.P.",2,0,2,1,0,0,
07/11/2017,S.L.P.,"CIUDAD VALLES, S.L.P.",1,0,1,0,0,0,
07/11/2017,N.L.,"MONTERREY, N.L.",0,0,0,0,0,100,
08/11/2017,ZAC.,"FRESNILLO, ZAC.",3,0,3,6,0,106,
08/11/2017,S.L.P.,"SAN LUIS POTOSI, S.L.P.",2,0,2,0,0,0,
08/11/2017,SON.,"HERMOSILLO, SON.",0,1,1,0,0,0,
08/11/2017,DGO.,"GOMEZ PALACIO, DGO.",1,0,1,0,0,0,
08/11/2017,ZAC.,"ZAC., ZAC.",1,0,1,1,0,6,
08/11/2017,ZAC.,"GUADALUPE, ZAC.",1,0,1,3,0,640,
08/11/2017,D.F.,"ALVARO OBREGON, D.F.",0,0,0,0,14,197,
08/11/2017,DGO.,"DGO., DGO.",0,0,0,0,2,0,
08/11/2017,N.L.,"GRAL. ESCOBEDO, N.L.",0,0,0,1,1,37,
09/11/2017,B.C.,"TIJUANA, B.C.",3,0,3,0,0,0,
09/11/2017,D.F.,"ALVARO OBREGON, D.F.",1,2,3,0,0,116,
09/11/2017,ZAC.,"GUADALUPE, ZAC.",1,1,2,0,0,120,
09/11/2017,S.L.P.,"CIUDAD VALLES, S.L.P.",2,0,2,0,0,0,
09/11/2017,S.L.P.,"SAN LUIS POTOSI, S.L.P.",1,1,2,0,0,0,
09/11/2017,DGO.,"DGO., DGO.",0,1,1,0,0,0,
09/11/2017,ZAC.,"FRESNILLO, ZAC.",0,0,0,17,0,30,
09/11/2017,CHIH.,"NUEVO CASAS GRANDES, CHIH.",0,0,0,0,0,4,
10/11/2017,SIN.,"MAZATLAN, SIN.",2,0,2,0,0,0,
10/11/2017,B.C.,"TIJUANA, B.C.",0,2,2,0,0,0,
10/11/2017,S.L.P.,"CIUDAD VALLES, S.L.P.",2,0,2,0,0,0,
10/11/2017,SON.,"HERMOSILLO, SON.",1,0,1,0,0,0,
10/11/2017,ZAC.,"ZAC., ZAC.",0,0,0,0,0,13,
10/11/2017,TAMPS.,"MATAMOROS, TAMPS.",0,0,0,0,0,631,
11/11/2017,S.L.P.,"SAN LUIS POTOSI, S.L.P.",2,0,2,6,0,0,
11/11/2017,COAH.,"ACUÑA, COAH.",1,0,1,1,0,0,
11/11/2017,N.L.,"GRAL. ESCOBEDO, N.L.",1,0,1,0,0,0,
11/11/2017,TAMPS.,"MATAMOROS, TAMPS.",0,0,0,5,0,34,
13/11/2017,SON.,"HERMOSILLO, SON.",2,0,2,0,0,0,
13/11/2017,SIN.,"MAZATLAN, SIN.",1,0,1,0,0,0,
13/11/2017,S.L.P.,"SAN LUIS POTOSI, S.L.P.",1,0,1,0,0,58,
14/11/2017,SIN.,"MAZATLAN, SIN.",1,3,4,0,0,0,
14/11/2017,N.L.,"MONTERREY, N.L.",1,1,2,0,0,57,
14/11/2017,GRO.,"ATOYAC DE ALVAREZ, GRO.",0,2,2,0,0,0,
14/11/2017,CHIH.,"NUEVO CASAS GRANDES, CHIH.",0,1,1,0,4,355,
14/11/2017,B.C.,"MEXICALI, B.C.",0,1,1,0,1,0,
14/11/2017,ZAC.,"GUADALUPE, ZAC.",1,0,1,4,0,50,
14/11/2017,ZAC.,"FRESNILLO, ZAC.",1,0,1,0,0,0,
14/11/2017,D.F.,"COYOACAN, D.F.",1,0,1,0,1,0,
14/11/2017,B.C.,"MEXICALI, B.C.",1,0,1,0,1,0,
15/11/2017,SIN.,"MAZATLAN, SIN.",1,2,3,0,0,0,
15/11/2017,S.L.P.,"CIUDAD VALLES, S.L.P.",2,0,2,2,0,27,
15/11/2017,D.F.,"COYOACAN, D.F.",2,0,2,0,3,0,
15/11/2017,N.L.,"MONTERREY, N.L.",2,0,2,2,0,30,
15/11/2017,S.L.P.,"SAN LUIS POTOSI, S.L.P.",0,1,1,0,0,0,
15/11/2017,B.C.,"TIJUANA, B.C.",1,0,1,0,1,0,
15/11/2017,ZAC.,"FRESNILLO, ZAC.",1,0,1,15,0,194,
16/11/2017,SON.,"HERMOSILLO, SON.",12,0,12,0,0,0,
16/11/2017,N.L.,"MONTERREY, N.L.",1,1,2,8,0,0,
16/11/2017,SIN.,"MAZATLAN, SIN.",1,1,2,0,3,0,
16/11/2017,S.L.P.,"CIUDAD VALLES, S.L.P.",2,0,2,0,0,4,
16/11/2017,D.F.,"COYOACAN, D.F.",1,0,1,0,0,50,
16/11/2017,CHIH.,"NUEVO CASAS GRANDES, CHIH.",1,0,1,0,0,0,
16/11/2017,ZAC.,"ZAC., ZAC.",1,0,1,1,0,0,
16/11/2017,S.L.P.,"SAN LUIS POTOSI, S.L.P.",1,0,1,1,0,0,
17/11/2017,SON.,"HERMOSILLO, SON.",13,2,15,1,0,305,
17/11/2017,COAH.,"ACUÑA, COAH.",3,0,3,0,0,0,
17/11/2017,ZAC.,"FRESNILLO, ZAC.",1,2,3,3,0,0,
17/11/2017,SIN.,"MAZATLAN, SIN.",3,0,3,0,0,0,
17/11/2017,B.C.,"MEXICALI, B.C.",1,1,2,0,1,0,
17/11/2017,B.C.,"TIJUANA, B.C.",1,0,1,0,0,0,
17/11/2017,SON.,"YECORA, SON.",1,0,1,0,0,0,
17/11/2017,S.L.P.,"SAN LUIS POTOSI, S.L.P.",1,0,1,0,0,0,
17/11/2017,N.L.,"MONTERREY, N.L.",1,0,1,7,0,350,
17/11/2017,D.F.,"COYOACAN, D.F.",1,0,1,0,0,0,
18/11/2017,TAMPS.,"MATAMOROS, TAMPS.",2,0,2,2,0,6,
19/11/2017,TAMPS.,"MATAMOROS, TAMPS.",1,0,1,0,0,0,
19/11/2017,S.L.P.,"SAN LUIS POTOSI, S.L.P.",0,0,0,6,0,150,
20/11/2017,B.C.S.,"MULEGÉ, B.C.S.",1,0,1,1,0,25,
20/11/2017,B.C.,"MEXICALI, B.C.",1,0,1,0,0,0,
21/11/2017,B.C.,"TIJUANA, B.C.",1,0,1,0,0,0,
21/11/2017,S.L.P.,"SAN LUIS POTOSI, S.L.P.",1,0,1,0,1,0,
21/11/2017,Q. ROO,"COZUMEL, Q. ROO",1,0,1,0,0,0,
22/11/2017,D.F.,"GUSTAVO A. MADERO, D.F.",4,2,6,0,12,185,
22/11/2017,GTO.,"CELAYA, GTO.",2,0,2,0,0,0,
22/11/2017,GRO.,"COYUCA DE BENITEZ, GRO.",0,1,1,0,0,0,
22/11/2017,N.L.,"MONTERREY, N.L.",0,1,1,0,0,430,
23/11/2017,GTO.,"CELAYA, GTO.",1,2,3,0,0,0,
23/11/2017,SIN.,"MAZATLAN, SIN.",1,0,1,0,0,0,
24/11/2017,GTO.,"CELAYA, GTO.",4,2,6,0,0,0,
24/11/2017,B.C.,"MEXICALI, B.C.",0,3,3,0,0,0,
24/11/2017,S.L.P.,"SAN LUIS POTOSI, S.L.P.",0,2,2,0,0,0,
24/11/2017,DGO.,"DGO., DGO.",0,1,1,0,0,0,
24/11/2017,Q. ROO,"COZUMEL, Q. ROO",1,0,1,0,0,1531,
24/11/2017,GRO.,"COYUCA DE BENITEZ, GRO.",1,0,1,0,0,0,
24/11/2017,SIN.,"MAZATLAN, SIN.",0,0,0,0,1,0,
25/11/2017,DGO.,"DGO., DGO.",2,0,2,2,0,0,
25/11/2017,B.C.,"TIJUANA, B.C.",1,0,1,0,0,0,
25/11/2017,S.L.P.,"SAN LUIS POTOSI, S.L.P.",1,0,1,4,9,0,
25/11/2017,COAH.,"ACUÑA, COAH.",0,0,0,0,0,83,
26/11/2017,TAMPS.,"MATAMOROS, TAMPS.",1,1,2,1,0,0,
27/11/2017,S.L.P.,"SAN LUIS POTOSI, S.L.P.",1,0,1,2,0,0,
27/11/2017,Q. ROO,"COZUMEL, Q. ROO",0,0,0,0,0,354,
28/11/2017,GTO.,"CELAYA, GTO.",2,11,13,0,0,0,
28/11/2017,N.L.,"MONTERREY, N.L.",2,0,2,0,0,0,
28/11/2017,B.C.,"TIJUANA, B.C.",1,0,1,0,0,0,
28/11/2017,B.C.,"ENSENADA, B.C.",0,1,1,0,0,0,
28/11/2017,Q. ROO,"COZUMEL, Q. ROO",0,0,0,0,0,208,
28/11/2017,DGO.,"DGO., DGO.",0,0,0,0,1,0,
28/11/2017,Q. ROO,"COZUMEL, Q. ROO",0,0,0,0,0,306,
29/11/2017,CHIH.,"JUÁREZ, CHIH.",6,17,23,10,0,523,
29/11/2017,CHIH.,"JUÁREZ, CHIH.",6,16,22,10,0,559,
29/11/2017,GTO.,"CELAYA, GTO.",3,4,7,0,0,0,
29/11/2017,N.L.,"MONTERREY, N.L.",1,1,2,0,0,0,
29/11/2017,S.L.P.,"SAN LUIS POTOSI, S.L.P.",1,0,1,0,0,0,
29/11/2017,ZAC.,"FRESNILLO, ZAC.",1,0,1,2,0,8,
30/11/2017,S.L.P.,"SAN LUIS POTOSI, S.L.P.",1,3,4,0,0,0,
30/11/2017,B.C.,"MEXICALI, B.C.",1,1,2,0,0,0,
30/11/2017,GTO.,"CELAYA, GTO.",2,0,2,0,0,0,
30/11/2017,GRO.,"CHILPANCINGO DE LOS BRAVO, GRO.",1,0,1,1,0,0,
30/11/2017,B.C.,"TIJUANA, B.C.",0,1,1,0,0,0,
30/11/2017,SIN.,"MAZATLAN, SIN.",0,1,1,0,0,0,
30/11/2017,Q. ROO,"COZUMEL, Q. ROO",1,0,1,1,0,964,
30/11/2017,B.C.,"ENSENADA, B.C.",0,0,0,0,1,0,
01/12/2017,CHIH.,"JUÁREZ, CHIH.",6,3,9,1,1,419,
01/12/2017,GTO.,"CELAYA, GTO.",0,7,7,0,0,0,
01/12/2017,B.C.,"TIJUANA, B.C.",0,4,4,0,0,0,
01/12/2017,ZAC.,"GUADALUPE, ZAC.",1,2,3,51,0,0,
01/12/2017,ZAC.,"ZAC., ZAC.",1,1,2,0,0,0,
01/12/2017,ZAC.,"FRESNILLO, ZAC.",1,1,2,8,0,0,
01/12/2017,S.L.P.,"SAN LUIS POTOSI, S.L.P.",2,0,2,15,0,0,
01/12/2017,DGO.,"GOMEZ PALACIO, DGO.",1,0,1,0,0,0,
01/12/2017,COAH.,"ACUÑA, COAH.",1,0,1,0,0,60,
01/12/2017,Q. ROO,"COZUMEL, Q. ROO",0,0,0,0,0,1189,
02/12/2017,ZAC.,"GUADALUPE, ZAC.",1,2,3,51,0,0,
02/12/2017,ZAC.,"ZAC., ZAC.",1,1,2,0,0,0,
02/12/2017,ZAC.,"FRESNILLO, ZAC.",1,1,2,8,0,0,
02/12/2017,COAH.,"ACUÑA, COAH.",1,0,1,2,0,60,
02/12/2017,TAMPS.,"MATAMOROS, TAMPS.",0,0,0,4,0,64,
03/12/2017,GTO.,"CELAYA, GTO.",0,1,1,0,0,0,
04/12/2017,CHIH.,"JUÁREZ, CHIH.",6,10,16,6,0,364,
04/12/2017,GTO.,"LEON, GTO.",6,9,15,0,0,0,
04/12/2017,ZAC.,"GUADALUPE, ZAC.",2,0,2,35,0,1350,
04/12/2017,GRO.,"ATOYAC DE ALVAREZ, GRO.",1,0,1,1,0,0,
05/12/2017,GTO.,"LEON, GTO.",4,8,12,0,0,0,
05/12/2017,CHIH.,"JUÁREZ, CHIH.",3,5,8,15,0,802,
05/12/2017,B.C.,"TIJUANA, B.C.",1,3,4,0,0,0,
05/12/2017,B.C.,"ENSENADA, B.C.",1,1,2,0,0,0,
05/12/2017,ZAC.,"GUADALUPE, ZAC.",1,0,1,0,0,0,
05/12/2017,ZAC.,"FRESNILLO, ZAC.",1,0,1,0,0,301,
05/12/2017,COAH.,"MÚZQUIZ, COAH.",0,1,1,0,0,0,
05/12/2017,B.C.,"TIJUANA, B.C.",0,0,0,0,1,0,
06/12/2017,GTO.,"LEON, GTO.",6,7,13,0,0,0,
06/12/2017,D.F.,"IZTACALCO, D.F.",1,2,3,0,4,9,
06/12/2017,N.L.,"MONTERREY, N.L.",1,1,2,0,0,35,
06/12/2017,N.L.,"MONTERREY, N.L.",1,1,2,7,0,13,
06/12/2017,ZAC.,"ZAC., ZAC.",1,0,1,0,0,112,
06/12/2017,S.L.P.,"SAN LUIS POTOSI, S.L.P.",1,0,1,0,0,0,
06/12/2017,DGO.,"DGO., DGO.",0,1,1,0,0,0,
06/12/2017,COAH.,"ACUÑA, COAH.",1,0,1,0,0,0,
06/12/2017,GTO.,"CELAYA, GTO.",0,1,1,0,0,0,
06/12/2017,TAMPS.,"CAMARGO, TAMPS.",0,0,0,0,0,30,
06/12/2017,TAMPS.,"MATAMOROS, TAMPS.",0,0,0,15,0,100,
07/12/2017,GTO.,"LEON, GTO.",4,10,14,0,0,0,
07/12/2017,ZAC.,"GUADALUPE, ZAC.",1,0,1,17,1,578,
07/12/2017,DGO.,"DGO., DGO.",1,0,1,6,0,0,
07/12/2017,B.C.,"ENSENADA, B.C.",0,0,0,0,1,0,
07/12/2017,ZAC.,"ZAC., ZAC.",0,0,0,3,0,300,
08/12/2017,GTO.,"LEON, GTO.",3,2,5,0,4,0,
08/12/2017,ZAC.,"GUADALUPE, ZAC.",2,0,2,6,0,108,
08/12/2017,JAL.,"PUERTO VALLARTA, JAL.",1,1,2,0,0,0,
08/12/2017,B.C.,"ENSENADA, B.C.",1,0,1,0,0,0,
08/12/2017,ZAC.,"ZAC., ZAC.",1,0,1,0,0,0,
08/12/2017,D.F.,"IZTACALCO, D.F.",0,0,0,0,1,0,
08/12/2017,ZAC.,"FRESNILLO, ZAC.",0,0,0,3,0,0,
09/12/2017,TAMPS.,"MATAMOROS, TAMPS.",0,3,3,3,0,400,
09/12/2017,JAL.,"PUERTO VALLARTA, JAL.",1,1,2,0,0,0,
10/12/2017,ZAC.,"FRESNILLO, ZAC.",0,0,0,6,0,0,
11/12/2017,GTO.,"LEON, GTO.",3,2,5,0,1,0,
11/12/2017,N.L.,"AGUALEGUAS, N.L.",1,1,2,1,0,0,
11/12/2017,S.L.P.,"CIUDAD VALLES, S.L.P.",2,0,2,8,0,0,
11/12/2017,S.L.P.,"CIUDAD VALLES, S.L.P.",1,0,1,0,0,0,
11/12/2017,DGO.,"DGO., DGO.",1,0,1,0,0,0,
11/12/2017,B.C.,"TIJUANA, B.C.",1,0,1,0,0,0,
11/12/2017,N.L.,"APODACA, N.L.",1,0,1,0,0,0,
11/12/2017,PUE.,"SAN MARTIN TEXMELUCAN, PUE.",1,0,1,0,0,0,
12/12/2017,GTO.,"LEON, GTO.",3,2,5,0,0,0,
12/12/2017,B.C.,"TIJUANA, B.C.",1,0,1,0,0,0,
12/12/2017,TAB.,"CENTRO, TAB.",0,0,0,0,0,100,
13/12/2017,GTO.,"LEON, GTO.",13,9,22,0,2,0,
13/12/2017,DGO.,"GOMEZ PALACIO, DGO.",2,0,2,0,0,0,
13/12/2017,ZAC.,"GUADALUPE, ZAC.",2,0,2,33,0,298,
13/12/2017,S.L.P.,"SAN LUIS POTOSI, S.L.P.",1,0,1,25,0,0,
13/12/2017,GRO.,"SAN MIGUEL TOTOLAPAN, GRO.",0,1,1,0,0,0,
13/12/2017,N.L.,"AGUALEGUAS, N.L.",0,0,0,8,0,182,
13/12/2017,ZAC.,"ZAC., ZAC.",0,0,0,15,0,0,
14/12/2017,GTO.,"LEON, GTO.",25,13,38,0,3,0,
14/12/2017,S.L.P.,"SAN LUIS POTOSI, S.L.P.",3,1,4,0,0,0,
14/12/2017,ZAC.,"GUADALUPE, ZAC.",3,1,4,38,0,991,
14/12/2017,DGO.,"DGO., DGO.",2,1,3,25,0,0,
14/12/2017,B.C.,"TIJUANA, B.C.",0,2,2,0,0,0,
14/12/2017,N.L.,"MONTERREY, N.L.",2,0,2,0,0,0,
14/12/2017,B.C.,"MEXICALI, B.C.",0,1,1,0,0,0,
14/12/2017,N.L.,"APODACA, N.L.",1,0,1,0,0,0,
14/12/2017,PUE.,"SAN MARTIN TEXMELUCAN, PUE.",1,0,1,0,0,90,
14/12/2017,S.L.P.,"CIUDAD VALLES, S.L.P.",0,0,0,8,0,0,
14/12/2017,ZAC.,"ZAC., ZAC.",0,0,0,11,0,98,
14/12/2017,ZAC.,"FRESNILLO, ZAC.",0,0,0,63,0,0,
15/12/2017,GTO.,"LEON, GTO.",23,11,34,0,0,0,
15/12/2017,TAMPS.,"MATAMOROS, TAMPS.",1,7,8,1,0,77,
15/12/2017,B.C.,"TIJUANA, B.C.",1,1,2,0,0,0,
15/12/2017,DGO.,"GOMEZ PALACIO, DGO.",2,0,2,2,0,0,
15/12/2017,B.C.,"MEXICALI, B.C.",1,0,1,0,0,0,
15/12/2017,N.L.,"APODACA, N.L.",1,0,1,1,0,0,
15/12/2017,S.L.P.,"SAN LUIS POTOSI, S.L.P.",1,0,1,0,0,0,
15/12/2017,DGO.,"DGO., DGO.",1,0,1,0,0,0,
15/12/2017,PUE.,"SAN MARTIN TEXMELUCAN, PUE.",0,0,0,2,0,50,
16/12/2017,TAMPS.,"MATAMOROS, TAMPS.",3,1,4,1,0,51,
16/12/2017,DGO.,"SANTIAGO PAPASQUIARO, DGO.",1,0,1,0,0,0,
16/12/2017,S.L.P.,"CIUDAD VALLES, S.L.P.",0,0,0,1,0,0,
16/12/2017,PUE.,"SAN MARTIN TEXMELUCAN, PUE.",0,0,0,2,0,50,
17/12/2017,DGO.,"DGO., DGO.",0,1,1,0,0,0,
18/12/2017,GTO.,"LEON, GTO.",11,12,23,0,3,0,
18/12/2017,HGO.,"TULANCINGO DE BRAVO, HGO.",0,2,2,0,0,182,
18/12/2017,N.L.,"APODACA, N.L.",1,1,2,2,0,66,
18/12/2017,B.C.,"MEXICALI, B.C.",0,1,1,0,0,0,
18/12/2017,GRO.,"COYUCA DE BENITEZ, GRO.",1,0,1,0,0,23,
19/12/2017,GTO.,"LEON, GTO.",23,7,30,0,1,0,
19/12/2017,N.L.,"MONTERREY, N.L.",2,0,2,0,0,1730,
19/12/2017,B.C.,"MEXICALI, B.C.",0,1,1,0,0,0,
19/12/2017,COAH.,"ACUÑA, COAH.",0,1,1,0,0,0,
20/12/2017,D.F.,"CUAUHTEMOC, D.F.",3,4,7,0,3,162,
20/12/2017,HGO.,"HUEJUTLA DE REYES, HGO.",2,1,3,0,0,0,
20/12/2017,B.C.,"TIJUANA, B.C.",0,1,1,0,0,0,
20/12/2017,B.C.,"TIJUANA, B.C.",1,0,1,0,0,0,
20/12/2017,N.L.,"MONTERREY, N.L.",0,0,0,1,1,6010,
21/12/2017,DGO.,"DGO., DGO.",2,1,3,0,1,0,
21/12/2017,B.C.,"ENSENADA, B.C.",1,1,2,0,0,0,
21/12/2017,N.L.,"AGUALEGUAS, N.L.",2,0,2,1,1,876,
21/12/2017,B.C.,"MEXICALI, B.C.",0,1,1,0,0,0,
21/12/2017,D.F.,"CUAUHTEMOC, D.F.",0,0,0,0,4,0,
22/12/2017,B.C.,"TIJUANA, B.C.",4,1,5,0,0,0,
22/12/2017,B.C.,"MEXICALI, B.C.",1,2,3,0,0,0,
22/12/2017,D.F.,"CUAUHTEMOC, D.F.",1,1,2,0,0,0,
22/12/2017,TAMPS.,"MATAMOROS, TAMPS.",1,0,1,6,0,24,
24/12/2017,DGO.,"DGO., DGO.",1,0,1,0,0,0,
26/12/2017,B.C.,"MEXICALI, B.C.",0,1,1,0,0,0,
27/12/2017,GRO.,"ATOYAC DE ALVAREZ, GRO.",1,0,1,1,0,1,
27/12/2017,B.C.,"MEXICALI, B.C.",1,0,1,0,0,0,
28/12/2017,B.C.,"MEXICALI, B.C.",0,3,3,0,0,0,
28/12/2017,DGO.,"DGO., DGO.",1,0,1,1,0,0,
29/12/2017,B.C.,"TIJUANA, B.C.",3,0,3,0,0,0,
29/12/2017,DGO.,"DGO., DGO.",0,1,1,0,0,0,
30/12/2017,B.C.,"TIJUANA, B.C.",3,2,5,0,0,0,
02/01/2018,B.C.,"TIJUANA, B.C.",4,1,5,0,0,0,
02/01/2018,B.C.,"ENSENADA, B.C.",0,2,2,0,0,0,
02/01/2018,DGO.,"DGO., DGO.",1,0,1,0,1,0,
03/01/2018,B.C.,"TIJUANA, B.C.",3,1,4,0,0,0,
03/01/2018,DGO.,"DGO., DGO.",0,3,3,0,1,0,
06/01/2018,GRO.,"ATOYAC DE ALVAREZ, GRO.",0,1,1,1,0,8,
07/01/2018,B.C.,"TIJUANA, B.C.",2,0,2,0,0,0,
08/01/2018,COAH.,"SALTILLO, COAH.",1,1,2,0,0,22,
08/01/2018,B.C.,"TIJUANA, B.C.",2,0,2,0,0,0,
08/01/2018,B.C.,"MEXICALI, B.C.",0,1,1,0,0,0,
08/01/2018,COAH.,"MÚZQUIZ, COAH.",0,0,0,0,0,290,
09/01/2018,COAH.,"MONCLOVA, COAH.",3,0,3,1,0,78,
09/01/2018,COAH.,"SALTILLO, COAH.",0,2,2,1,0,0,
09/01/2018,COAH.,"MÚZQUIZ, COAH.",0,1,1,0,1,0,
09/01/2018,COAH.,"ACUÑA, COAH.",0,1,1,0,0,0,
10/01/2018,COAH.,"SALTILLO, COAH.",2,1,3,1,0,270,
10/01/2018,B.C.,"TIJUANA, B.C.",2,0,2,0,0,0,
10/01/2018,COAH.,"MONCLOVA, COAH.",2,0,2,1,0,2,
10/01/2018,COAH.,"MÚZQUIZ, COAH.",0,2,2,0,0,0,
10/01/2018,COAH.,"FRANCISCO I. MADERO, COAH.",1,0,1,1,0,0,
10/01/2018,COAH.,"RAMOS ARIZPE, COAH.",1,0,1,0,0,0,
10/01/2018,COAH.,"PIEDRAS NEGRAS, COAH.",0,1,1,0,0,0,
10/01/2018,COAH.,"ACUÑA, COAH.",1,0,1,0,0,0,
10/01/2018,COAH.,"TORREÓN, COAH.",0,0,0,1,0,7,
11/01/2018,COAH.,"SALTILLO, COAH.",2,2,4,0,0,0,
11/01/2018,COAH.,"PIEDRAS NEGRAS, COAH.",0,3,3,0,0,20,
11/01/2018,B.C.,"TIJUANA, B.C.",0,2,2,3,0,160,
11/01/2018,COAH.,"FRANCISCO I. MADERO, COAH.",1,0,1,1,0,0,
11/01/2018,COAH.,"MONCLOVA, COAH.",0,1,1,0,0,0,
11/01/2018,DGO.,"DGO., DGO.",0,1,1,0,0,0,
11/01/2018,COAH.,"TORREÓN, COAH.",0,0,0,1,0,7,
12/01/2018,COAH.,"TORREÓN, COAH.",0,2,2,0,0,0,
12/01/2018,COAH.,"RAMOS ARIZPE, COAH.",2,0,2,1,0,0,
12/01/2018,B.C.,"ENSENADA, B.C.",0,1,1,0,0,0,
12/01/2018,COAH.,"SALTILLO, COAH.",0,0,0,1,0,191,
12/01/2018,COAH.,"PIEDRAS NEGRAS, COAH.",0,0,0,0,0,54,
12/01/2018,COAH.,"SABINAS, COAH.",0,0,0,8,0,0,
13/01/2018,COAH.,"MONCLOVA, COAH.",2,0,2,1,0,3,
13/01/2018,B.C.,"TIJUANA, B.C.",1,0,1,0,0,0,
13/01/2018,GRO.,"ATOYAC DE ALVAREZ, GRO.",1,0,1,7,0,0,
13/01/2018,COAH.,"SABINAS, COAH.",0,1,1,5,1,0,
13/01/2018,TAB.,"CENTRO, TAB.",1,0,1,0,0,0,
15/01/2018,COAH.,"SALTILLO, COAH.",4,1,5,1,0,100,
15/01/2018,COAH.,"MONCLOVA, COAH.",1,4,5,7,5,0,
15/01/2018,COAH.,"TORREÓN, COAH.",1,1,2,1,0,20,
15/01/2018,COAH.,"FRANCISCO I. MADERO, COAH.",1,1,2,1,0,0,
15/01/2018,COAH.,"PIEDRAS NEGRAS, COAH.",1,1,2,0,0,0,
15/01/2018,B.C.,"ENSENADA, B.C.",0,2,2,0,0,0,
15/01/2018,COAH.,"RAMOS ARIZPE, COAH.",1,0,1,0,0,50,
15/01/2018,COAH.,"MÚZQUIZ, COAH.",0,1,1,0,0,0,
16/01/2018,COAH.,"TORREÓN, COAH.",2,0,2,1,0,185,
16/01/2018,COAH.,"SALTILLO, COAH.",0,1,1,0,0,0,
16/01/2018,COAH.,"PIEDRAS NEGRAS, COAH.",0,1,1,0,0,198,
17/01/2018,B.C.,"TIJUANA, B.C.",0,1,1,0,0,0,
17/01/2018,COAH.,"PIEDRAS NEGRAS, COAH.",1,0,1,0,0,106,
18/01/2018,COAH.,"MONCLOVA, COAH.",3,1,4,0,0,54,
18/01/2018,COAH.,"TORREÓN, COAH.",2,0,2,0,0,0,
18/01/2018,B.C.,"TIJUANA, B.C.",0,1,1,0,0,0,
18/01/2018,COAH.,"FRANCISCO I. MADERO, COAH.",0,1,1,0,0,0,
18/01/2018,COAH.,"PIEDRAS NEGRAS, COAH.",1,0,1,0,1,30,
19/01/2018,COAH.,"SALTILLO, COAH.",5,0,5,7,0,489,
19/01/2018,COAH.,"TORREÓN, COAH.",3,1,4,0,0,11,
19/01/2018,B.C.,"TIJUANA, B.C.",3,0,3,0,0,0,
19/01/2018,COAH.,"SAN PEDRO, COAH.",2,0,2,0,0,0,
19/01/2018,COAH.,"PIEDRAS NEGRAS, COAH.",0,1,1,0,0,60,
19/01/2018,COAH.,"MONCLOVA, COAH.",0,0,0,0,0,37,
20/01/2018,TAMPS.,"MATAMOROS, TAMPS.",0,1,1,1,0,26,
20/01/2018,COAH.,"SAN PEDRO, COAH.",1,0,1,0,0,0,
20/01/2018,COAH.,"SABINAS, COAH.",1,0,1,0,1,0,
20/01/2018,COAH.,"MONCLOVA, COAH.",0,0,0,0,1,0,
22/01/2018,D.F.,"CUAUHTEMOC, D.F.",15,3,18,0,0,246,
22/01/2018,COAH.,"SALTILLO, COAH.",5,2,7,1,0,0,
22/01/2018,B.C.,"TIJUANA, B.C.",3,0,3,0,0,0,
22/01/2018,COAH.,"TORREÓN, COAH.",2,0,2,0,0,0,
22/01/2018,COAH.,"MÚZQUIZ, COAH.",1,1,2,0,0,0,
22/01/2018,B.C.,"ENSENADA, B.C.",0,1,1,0,0,0,
22/01/2018,DGO.,"DGO., DGO.",1,0,1,0,0,0,
22/01/2018,COAH.,"SAN PEDRO, COAH.",1,0,1,0,0,0,
22/01/2018,COAH.,"RAMOS ARIZPE, COAH.",1,0,1,0,0,44,
22/01/2018,COAH.,"PIEDRAS NEGRAS, COAH.",1,0,1,0,0,0,
22/01/2018,GTO.,"IRAPUATO, GTO.",1,0,1,0,0,0,
23/01/2018,D.F.,"CUAUHTEMOC, D.F.",3,2,5,0,0,243,
23/01/2018,COAH.,"MONCLOVA, COAH.",3,1,4,0,0,0,
23/01/2018,COAH.,"SALTILLO, COAH.",3,0,3,1,0,58,
23/01/2018,COAH.,"RAMOS ARIZPE, COAH.",2,0,2,1,0,0,
23/01/2018,B.C.,"TIJUANA, B.C.",2,0,2,0,0,0,
23/01/2018,GTO.,"IRAPUATO, GTO.",1,1,2,0,0,1,
23/01/2018,COAH.,"PIEDRAS NEGRAS, COAH.",1,0,1,0,0,750,
23/01/2018,B.C.,"ENSENADA, B.C.",1,0,1,0,0,0,
23/01/2018,COAH.,"MÚZQUIZ, COAH.",0,0,0,0,0,146,
23/01/2018,VER.,"PUEBLO VIEJO, VER.",0,0,0,0,1,0,
24/01/2018,GTO.,"IRAPUATO, GTO.",1,2,3,0,2,10,
24/01/2018,COAH.,"SALTILLO, COAH.",3,0,3,0,0,31,
24/01/2018,COAH.,"MONCLOVA, COAH.",2,1,3,1,0,64,
24/01/2018,COAH.,"FRANCISCO I. MADERO, COAH.",2,0,2,0,0,0,
24/01/2018,COAH.,"RAMOS ARIZPE, COAH.",1,1,2,0,0,21,
24/01/2018,COAH.,"PIEDRAS NEGRAS, COAH.",1,1,2,0,0,0,
24/01/2018,B.C.,"ENSENADA, B.C.",1,0,1,0,0,0,
24/01/2018,COAH.,"TORREÓN, COAH.",1,0,1,0,0,0,
24/01/2018,VER.,"PUEBLO VIEJO, VER.",1,0,1,0,0,0,
24/01/2018,COAH.,"MÚZQUIZ, COAH.",0,1,1,0,0,0,
25/01/2018,D.F.,"CUAUHTEMOC, D.F.",7,3,10,0,1,228,
25/01/2018,GTO.,"IRAPUATO, GTO.",1,2,3,0,1,50,
25/01/2018,COAH.,"MÚZQUIZ, COAH.",1,2,3,2,0,0,
25/01/2018,COAH.,"TORREÓN, COAH.",2,0,2,0,0,0,
25/01/2018,COAH.,"ACUÑA, COAH.",0,2,2,0,0,0,
25/01/2018,COAH.,"FRANCISCO I. MADERO, COAH.",1,0,1,0,0,45,
25/01/2018,COAH.,"SALTILLO, COAH.",1,0,1,1,0,79,
25/01/2018,COAH.,"PIEDRAS NEGRAS, COAH.",0,0,0,2,0,231,
26/01/2018,GTO.,"IRAPUATO, GTO.",6,5,11,0,2,7,
26/01/2018,D.F.,"CUAUHTEMOC, D.F.",6,2,8,0,0,799,
26/01/2018,COAH.,"PIEDRAS NEGRAS, COAH.",1,4,5,0,0,0,
26/01/2018,COAH.,"SAN PEDRO, COAH.",3,1,4,0,0,0,
26/01/2018,COAH.,"TORREÓN, COAH.",1,1,2,1,0,0,
26/01/2018,COAH.,"MATAMOROS, COAH.",1,0,1,0,0,0,
26/01/2018,COAH.,"SALTILLO, COAH.",1,0,1,0,0,36,
26/01/2018,COAH.,"ACUÑA, COAH.",0,1,1,0,0,0,
26/01/2018,VER.,"PUEBLO VIEJO, VER.",1,0,1,0,0,0,
26/01/2018,TAB.,"CENTRO, TAB.",0,0,0,2,0,49,
27/01/2018,GTO.,"IRAPUATO, GTO.",4,6,10,0,0,0,
27/01/2018,COAH.,"MÚZQUIZ, COAH.",1,3,4,0,0,57,
27/01/2018,TAMPS.,"MATAMOROS, TAMPS.",2,0,2,1,0,0,
27/01/2018,COAH.,"PIEDRAS NEGRAS, COAH.",0,0,0,0,0,736,
29/01/2018,D.F.,"CUAUHTEMOC, D.F.",13,7,20,0,0,1623,
29/01/2018,COAH.,"MONCLOVA, COAH.",6,0,6,0,0,310,
29/01/2018,GTO.,"IRAPUATO, GTO.",4,1,5,2,0,38,
29/01/2018,B.C.,"TIJUANA, B.C.",3,1,4,0,0,0,
29/01/2018,ZAC.,"ZAC., ZAC.",3,0,3,29,0,33,
29/01/2018,DGO.,"GOMEZ PALACIO, DGO.",3,0,3,0,0,0,
29/01/2018,COAH.,"TORREÓN, COAH.",2,1,3,0,0,0,
29/01/2018,COAH.,"PIEDRAS NEGRAS, COAH.",0,3,3,0,0,0,
29/01/2018,ZAC.,"GUADALUPE, ZAC.",2,0,2,29,0,33,
29/01/2018,DGO.,"DGO., DGO.",0,1,1,1,0,0,
29/01/2018,COAH.,"FRANCISCO I. MADERO, COAH.",1,0,1,0,0,0,
29/01/2018,COAH.,"SALTILLO, COAH.",1,0,1,0,0,29,
29/01/2018,COAH.,"RAMOS ARIZPE, COAH.",1,0,1,1,0,25,
29/01/2018,COAH.,"ACUÑA, COAH.",0,1,1,2,2,130,
30/01/2018,D.F.,"CUAUHTEMOC, D.F.",13,2,15,0,0,1431,
30/01/2018,ZAC.,"GUADALUPE, ZAC.",4,0,4,6,0,58,
30/01/2018,GTO.,"IRAPUATO, GTO.",2,2,4,0,0,0,
30/01/2018,DGO.,"GOMEZ PALACIO, DGO.",4,0,4,0,0,0,
30/01/2018,COAH.,"SALTILLO, COAH.",4,0,4,2,0,62,
30/01/2018,COAH.,"MONCLOVA, COAH.",3,1,4,0,0,24,
30/01/2018,COAH.,"MÚZQUIZ, COAH.",4,0,4,7,0,0,
30/01/2018,COAH.,"PIEDRAS NEGRAS, COAH.",1,2,3,0,0,0,
30/01/2018,ZAC.,"ZAC., ZAC.",2,0,2,0,0,0,
30/01/2018,COAH.,"TORREÓN, COAH.",2,0,2,0,1,0,
30/01/2018,COAH.,"SAN PEDRO, COAH.",1,1,2,0,0,0,
30/01/2018,COAH.,"ACUÑA, COAH.",1,1,2,2,0,0,
30/01/2018,ZAC.,"FRESNILLO, ZAC.",0,1,1,58,0,220,
30/01/2018,TAMPS.,"NUEVO LAREDO, TAMPS.",0,0,0,0,0,33,
31/01/2018,D.F.,"CUAUHTEMOC, D.F.",11,9,20,0,0,176,
31/01/2018,DGO.,"GOMEZ PALACIO, DGO.",5,2,7,0,0,0,
31/01/2018,ZAC.,"GUADALUPE, ZAC.",7,0,7,3,0,0,
31/01/2018,ZAC.,"ZAC., ZAC.",6,1,7,2,0,38,
31/01/2018,ZAC.,"GUADALUPE, ZAC.",3,2,5,11,0,0,
31/01/2018,COAH.,"SALTILLO, COAH.",3,0,3,2,0,74,
31/01/2018,COAH.,"PIEDRAS NEGRAS, COAH.",1,2,3,0,0,0,
31/01/2018,ZAC.,"ZAC., ZAC.",2,1,3,29,0,0,
31/01/2018,ZAC.,"FRESNILLO, ZAC.",2,0,2,36,0,293,
31/01/2018,COAH.,"MÚZQUIZ, COAH.",0,1,1,0,0,0,
31/01/2018,ZAC.,"FRESNILLO, ZAC.",1,0,1,57,0,140,
01/02/2018,COAH.,"TORREÓN, COAH.",5,0,5,0,0,1,
01/02/2018,D.F.,"CUAUHTEMOC, D.F.",4,0,4,0,0,480,
01/02/2018,COAH.,"PIEDRAS NEGRAS, COAH.",2,0,2,1,0,0,
01/02/2018,COAH.,"FRANCISCO I. MADERO, COAH.",1,0,1,0,0,0,
01/02/2018,COAH.,"SALTILLO, COAH.",1,0,1,0,0,223,
01/02/2018,COAH.,"MONCLOVA, COAH.",1,0,1,0,0,0,
01/02/2018,COAH.,"ACUÑA, COAH.",1,0,1,0,0,0,
02/02/2018,COAH.,"SALTILLO, COAH.",4,0,4,0,0,12,
02/02/2018,ZAC.,"GUADALUPE, ZAC.",1,3,4,9,0,278,
02/02/2018,ZAC.,"FRESNILLO, ZAC.",4,0,4,9,0,155,
02/02/2018,COAH.,"MÚZQUIZ, COAH.",2,1,3,1,0,0,
02/02/2018,COAH.,"ACUÑA, COAH.",2,1,3,0,0,0,
02/02/2018,DGO.,"GOMEZ PALACIO, DGO.",3,0,3,0,0,0,
02/02/2018,COAH.,"TORREÓN, COAH.",2,0,2,0,0,0,
02/02/2018,COAH.,"PIEDRAS NEGRAS, COAH.",2,0,2,1,0,0,
02/02/2018,COAH.,"MONCLOVA, COAH.",1,0,1,0,0,0,
02/02/2018,ZAC.,"ZAC., ZAC.",1,0,1,4,0,18,
02/02/2018,TAMPS.,"NUEVO LAREDO, TAMPS.",0,0,0,1,0,51,
03/02/2018,TAMPS.,"NUEVO LAREDO, TAMPS.",5,1,6,3,0,86,
03/02/2018,COAH.,"SALTILLO, COAH.",5,0,5,1,0,96,
03/02/2018,COAH.,"SABINAS, COAH.",4,0,4,1,0,0,
03/02/2018,TAMPS.,"MATAMOROS, TAMPS.",0,4,4,5,0,848,
03/02/2018,COAH.,"ACUÑA, COAH.",1,1,2,0,0,0,
03/02/2018,DGO.,"GOMEZ PALACIO, DGO.",1,0,1,0,0,0,
03/02/2018,COAH.,"PIEDRAS NEGRAS, COAH.",0,0,0,11,0,387,
04/02/2018,CHIS.,"BENEMÉRITO DE LAS AMÉRICAS, CHIS.",1,0,1,0,0,0,
05/02/2018,COAH.,"PIEDRAS NEGRAS, COAH.",4,0,4,8,0,1162,
05/02/2018,TAMPS.,"REYNOSA, TAMPS.",1,0,1,1,0,61,
06/02/2018,COAH.,"SALTILLO, COAH.",5,0,5,1,0,96,
06/02/2018,ZAC.,"FRESNILLO, ZAC.",4,0,4,39,0,267,
06/02/2018,COAH.,"ACUÑA, COAH.",1,3,4,0,0,0,
06/02/2018,D.F.,"TLAHUAC, D.F.",1,3,4,0,0,0,
06/02/2018,ZAC.,"ZAC., ZAC.",3,0,3,0,0,0,
06/02/2018,COAH.,"TORREÓN, COAH.",2,0,2,1,0,18,
06/02/2018,COAH.,"FRANCISCO I. MADERO, COAH.",0,1,1,0,0,0,
06/02/2018,COAH.,"PIEDRAS NEGRAS, COAH.",0,1,1,1,0,0,
06/02/2018,DGO.,"GOMEZ PALACIO, DGO.",1,0,1,0,0,0,
07/02/2018,COAH.,"SALTILLO, COAH.",9,0,9,0,0,34,
07/02/2018,COAH.,"PIEDRAS NEGRAS, COAH.",2,4,6,10,0,275,
07/02/2018,TAMPS.,"REYNOSA, TAMPS.",0,2,2,0,0,0,
07/02/2018,B.C.,"TIJUANA, B.C.",2,0,2,0,0,0,
07/02/2018,COL.,"COL., COL.",1,0,1,0,0,0,
08/02/2018,COAH.,"SALTILLO, COAH.",5,1,6,0,4,0,
08/02/2018,D.F.,"TLAHUAC, D.F.",2,1,3,0,0,0,
08/02/2018,COAH.,"MONCLOVA, COAH.",2,1,3,5,0,200,
08/02/2018,COAH.,"TORREÓN, COAH.",2,0,2,0,0,0,
08/02/2018,COAH.,"PIEDRAS NEGRAS, COAH.",0,2,2,11,0,993,
08/02/2018,COAH.,"NUEVA ROSITA, COAH.",0,2,2,0,1,0,
08/02/2018,COAH.,"SAN PEDRO, COAH.",0,1,1,0,0,0,
08/02/2018,COAH.,"ACUÑA, COAH.",1,0,1,0,0,0,
08/02/2018,VER.,"SAN RAFAEL, VER.",0,0,0,0,0,41,
09/02/2018,COAH.,"SALTILLO, COAH.",2,4,6,2,0,90,
09/02/2018,D.F.,"TLAHUAC, D.F.",2,3,5,0,0,62,
09/02/2018,COAH.,"MONCLOVA, COAH.",3,2,5,4,1,155,
09/02/2018,COAH.,"TORREÓN, COAH.",3,1,4,0,0,81,
09/02/2018,COAH.,"FRANCISCO I. MADERO, COAH.",1,0,1,0,0,0,
09/02/2018,COAH.,"PIEDRAS NEGRAS, COAH.",1,0,1,0,0,0,
09/02/2018,COAH.,"SABINAS, COAH.",1,0,1,0,0,81,
10/02/2018,TAMPS.,"MATAMOROS, TAMPS.",4,6,10,2,0,89,
10/02/2018,COAH.,"SABINAS, COAH.",1,2,3,0,0,0,
10/02/2018,DGO.,"GOMEZ PALACIO, DGO.",2,0,2,0,1,0,
10/02/2018,TAMPS.,"NUEVO LAREDO, TAMPS.",0,0,0,4,0,170,
10/02/2018,COAH.,"PIEDRAS NEGRAS, COAH.",0,0,0,10,0,465,
10/02/2018,DGO.,"DGO., DGO.",0,0,0,0,2,0,
10/02/2018,TAMPS.,"MATAMOROS, TAMPS.",0,0,0,0,0,10,
12/02/2018,ZAC.,"GUADALUPE, ZAC.",6,0,6,10,0,461,
12/02/2018,ZAC.,"FRESNILLO, ZAC.",4,1,5,39,0,300,
12/02/2018,COAH.,"TORREÓN, COAH.",4,0,4,0,1,48,
12/02/2018,ZAC.,"ZAC., ZAC.",4,0,4,8,0,20,
12/02/2018,COAH.,"SALTILLO, COAH.",2,1,3,0,0,2155,
12/02/2018,VER.,"SAN RAFAEL, VER.",2,0,2,0,0,20,
12/02/2018,D.F.,"TLAHUAC, D.F.",0,2,2,0,0,0,
12/02/2018,COAH.,"MONCLOVA, COAH.",2,0,2,5,1,69,
12/02/2018,DGO.,"DGO., DGO.",0,1,1,0,0,0,
12/02/2018,SIN.,"CULIACAN, SIN.",0,1,1,0,0,0,
12/02/2018,COAH.,"ACUÑA, COAH.",1,0,1,0,0,0,
12/02/2018,COAH.,"RAMOS ARIZPE, COAH.",0,0,0,0,0,505,
12/02/2018,COAH.,"PIEDRAS NEGRAS, COAH.",0,0,0,7,0,691,
13/02/2018,SIN.,"CULIACAN, SIN.",16,2,18,0,5,0,
13/02/2018,ZAC.,"FRESNILLO, ZAC.",8,4,12,4,0,32,
13/02/2018,ZAC.,"GUADALUPE, ZAC.",7,1,8,8,0,0,
13/02/2018,COAH.,"SALTILLO, COAH.",2,1,3,0,0,45,
13/02/2018,COAH.,"PIEDRAS NEGRAS, COAH.",2,1,3,0,0,81,
13/02/2018,COAH.,"SABINAS, COAH.",1,2,3,0,0,0,
13/02/2018,ZAC.,"ZAC., ZAC.",2,0,2,20,0,250,
13/02/2018,COAH.,"TORREÓN, COAH.",1,0,1,1,0,0,
13/02/2018,COAH.,"SAN PEDRO, COAH.",1,0,1,2,0,0,
13/02/2018,TAB.,"CENTRO, TAB.",0,0,0,3,0,249,
13/02/2018,COAH.,"RAMOS ARIZPE, COAH.",0,0,0,0,0,50,
14/02/2018,COAH.,"SALTILLO, COAH.",4,3,7,0,0,0,
14/02/2018,COAH.,"MONCLOVA, COAH.",5,0,5,16,0,254,
14/02/2018,ZAC.,"FRESNILLO, ZAC.",4,0,4,8,0,44,
14/02/2018,ZAC.,"ZAC., ZAC.",2,1,3,15,0,0,
14/02/2018,COAH.,"TORREÓN, COAH.",3,0,3,0,0,0,
14/02/2018,SIN.,"CULIACAN, SIN.",2,0,2,0,0,0,
14/02/2018,COAH.,"FRANCISCO I. MADERO, COAH.",1,0,1,1,0,0,
14/02/2018,COAH.,"SABINAS, COAH.",0,1,1,0,1,0,
14/02/2018,DGO.,"GOMEZ PALACIO, DGO.",1,0,1,0,0,0,
14/02/2018,GRO.,"COYUCA DE CATALAN, GRO.",1,0,1,0,0,0,
14/02/2018,COAH.,"SAN PEDRO, COAH.",0,1,1,0,0,0,
14/02/2018,TAMPS.,"NUEVO LAREDO, TAMPS.",0,0,0,0,0,125,
14/02/2018,COAH.,"PIEDRAS NEGRAS, COAH.",0,0,0,0,0,50,
15/02/2018,COAH.,"MATAMOROS, COAH.",9,6,15,0,0,0,
15/02/2018,COAH.,"SALTILLO, COAH.",5,3,8,1,0,686,
15/02/2018,DGO.,"GOMEZ PALACIO, DGO.",3,0,3,0,0,0,
15/02/2018,GRO.,"ACAPULCO DE JUAREZ, GRO.",2,1,3,0,12,1028,
15/02/2018,COAH.,"MONCLOVA, COAH.",2,0,2,1,0,50,
15/02/2018,COAH.,"MÚZQUIZ, COAH.",1,1,2,0,0,0,
15/02/2018,SIN.,"CULIACAN, SIN.",2,0,2,0,0,0,
16/02/2018,COAH.,"SALTILLO, COAH.",5,2,7,0,0,165,
16/02/2018,ZAC.,"GUADALUPE, ZAC.",6,0,6,4,0,0,
16/02/2018,GRO.,"ACAPULCO DE JUAREZ, GRO.",6,0,6,0,7,119,
16/02/2018,COAH.,"PIEDRAS NEGRAS, COAH.",0,2,2,5,0,1156,
16/02/2018,SIN.,"CULIACAN, SIN.",1,0,1,0,0,0,
16/02/2018,COAH.,"FRANCISCO I. MADERO, COAH.",1,0,1,0,0,40,
16/02/2018,COAH.,"ACUÑA, COAH.",1,0,1,0,0,9,
16/02/2018,TAMPS.,"NUEVO LAREDO, TAMPS.",1,0,1,2,0,563,
17/02/2018,GRO.,"ACAPULCO DE JUAREZ, GRO.",6,1,7,0,5,119,
17/02/2018,COAH.,"MÚZQUIZ, COAH.",2,1,3,5,0,0,
17/02/2018,DGO.,"GOMEZ PALACIO, DGO.",2,0,2,0,1,0,
17/02/2018,TAB.,"CENTRO, TAB.",1,0,1,1,0,5,
17/02/2018,TAMPS.,"MATAMOROS, TAMPS.",1,0,1,0,0,102,
17/02/2018,TAMPS.,"NUEVO LAREDO, TAMPS.",1,0,1,2,0,563,
19/02/2018,COAH.,"PIEDRAS NEGRAS, COAH.",1,1,2,3,0,313,
19/02/2018,COAH.,"SAN PEDRO, COAH.",1,0,1,0,0,0,
19/02/2018,Q. ROO,"COZUMEL, Q. ROO",1,0,1,0,0,675,
19/02/2018,GRO.,"COYUCA DE BENITEZ, GRO.",0,0,0,0,0,15,
20/02/2018,COAH.,"TORREÓN, COAH.",7,1,8,0,0,163,
20/02/2018,D.F.,"IZTAPALAPA, D.F.",3,0,3,0,0,0,
20/02/2018,COAH.,"PIEDRAS NEGRAS, COAH.",0,3,3,2,0,135,
20/02/2018,TAMPS.,"NUEVO LAREDO, TAMPS.",2,1,3,1,0,0,
20/02/2018,COAH.,"ACUÑA, COAH.",1,0,1,0,0,0,
20/02/2018,Q. ROO,"COZUMEL, Q. ROO",0,0,0,0,0,20,
21/02/2018,COAH.,"SALTILLO, COAH.",4,3,7,4,0,0,
21/02/2018,COAH.,"TORREÓN, COAH.",2,0,2,0,0,0,
21/02/2018,COAH.,"MONCLOVA, COAH.",0,2,2,0,0,0,
21/02/2018,COAH.,"PIEDRAS NEGRAS, COAH.",2,0,2,0,0,230,
21/02/2018,SIN.,"CULIACAN, SIN.",2,0,2,0,0,0,
21/02/2018,COAH.,"MÚZQUIZ, COAH.",0,1,1,0,0,0,
21/02/2018,DGO.,"GOMEZ PALACIO, DGO.",1,0,1,0,0,0,
21/02/2018,GRO.,"ACAPULCO DE JUAREZ, GRO.",0,0,0,0,1,0,
21/02/2018,Q. ROO,"COZUMEL, Q. ROO",0,0,0,0,0,372,
22/02/2018,COAH.,"TORREÓN, COAH.",2,0,2,0,0,0,
22/02/2018,SIN.,"CULIACAN, SIN.",1,0,1,0,0,0,
22/02/2018,COAH.,"SAN PEDRO, COAH.",0,1,1,0,0,0,
22/02/2018,COAH.,"ACUÑA, COAH.",0,1,1,0,0,0,
22/02/2018,TAMPS.,"NUEVO LAREDO, TAMPS.",0,0,0,0,0,75,
22/02/2018,GRO.,"ACAPULCO DE JUAREZ, GRO.",0,0,0,0,0,309,
23/02/2018,COAH.,"MONCLOVA, COAH.",2,1,3,0,1,52,
23/02/2018,COAH.,"PIEDRAS NEGRAS, COAH.",2,1,3,0,0,145,
23/02/2018,COAH.,"ACUÑA, COAH.",1,1,2,0,0,0,
23/02/2018,COAH.,"SAN PEDRO, COAH.",1,0,1,0,0,0,
23/02/2018,DGO.,"GOMEZ PALACIO, DGO.",1,0,1,0,0,0,
23/02/2018,COAH.,"TORREÓN, COAH.",0,0,0,0,0,429,
23/02/2018,GRO.,"ACAPULCO DE JUAREZ, GRO.",0,0,0,0,1,143,
24/02/2018,COAH.,"PIEDRAS NEGRAS, COAH.",2,2,4,0,0,0,
24/02/2018,TAMPS.,"MATAMOROS, TAMPS.",2,0,2,4,0,30,
24/02/2018,DGO.,"GOMEZ PALACIO, DGO.",0,0,0,0,3,0,
25/02/2018,TAMPS.,"REYNOSA, TAMPS.",0,0,0,0,0,90,
26/02/2018,COAH.,"MONCLOVA, COAH.",2,2,4,0,0,181,
26/02/2018,COAH.,"MÚZQUIZ, COAH.",1,3,4,8,0,300,
26/02/2018,S.L.P.,"CIUDAD VALLES, S.L.P.",2,1,3,3,0,0,
26/02/2018,D.F.,"IZTAPALAPA, D.F.",3,0,3,0,0,0,
26/02/2018,SIN.,"CULIACAN, SIN.",1,0,1,0,0,0,
26/02/2018,COAH.,"PIEDRAS NEGRAS, COAH.",0,1,1,0,0,50,
26/02/2018,COAH.,"ACUÑA, COAH.",0,1,1,0,0,0,
27/02/2018,COAH.,"SALTILLO, COAH.",9,2,11,2,0,235,
27/02/2018,COAH.,"TORREÓN, COAH.",3,7,10,0,3,154,
27/02/2018,SIN.,"CULIACAN, SIN.",4,0,4,0,0,0,
27/02/2018,D.F.,"IZTAPALAPA, D.F.",2,2,4,0,0,24,
27/02/2018,COAH.,"SAN PEDRO, COAH.",0,1,1,0,0,0,
27/02/2018,SIN.,"CULIACAN, SIN.",0,1,1,0,0,0,
27/02/2018,COAH.,"PIEDRAS NEGRAS, COAH.",1,0,1,0,3,154,
28/02/2018,COAH.,"RAMOS ARIZPE, COAH.",3,0,3,11,2,481,
28/02/2018,COAH.,"MONCLOVA, COAH.",2,1,3,0,0,0,
28/02/2018,COAH.,"PIEDRAS NEGRAS, COAH.",1,1,2,0,0,0,
28/02/2018,COAH.,"MÚZQUIZ, COAH.",1,1,2,6,0,0,
28/02/2018,COAH.,"ACUÑA, COAH.",0,2,2,1,0,0,
28/02/2018,S.L.P.,"CIUDAD VALLES, S.L.P.",1,0,1,1,0,0,
28/02/2018,COAH.,"SALTILLO, COAH.",0,0,0,0,1,0,
01/03/2018,S.L.P.,"SAN LUIS POTOSI, S.L.P.",1,0,1,0,0,0,
01/03/2018,COAH.,"SALTILLO, COAH.",1,0,1,1,0,510,
01/03/2018,D.F.,"IZTAPALAPA, D.F.",0,0,0,0,0,761,
01/03/2018,COAH.,"RAMOS ARIZPE, COAH.",0,0,0,1,0,55,
02/03/2018,DGO.,"GOMEZ PALACIO, DGO.",1,1,2,0,0,0,
02/03/2018,S.L.P.,"SAN LUIS POTOSI, S.L.P.",1,0,1,1,0,0,
02/03/2018,TAMPS.,"MATAMOROS, TAMPS.",0,0,0,4,0,10,
05/03/2018,CHIH.,"CHIH., CHIH.",5,4,9,0,0,23,
05/03/2018,D.F.,"TLALPAN, D.F.",3,2,5,0,0,0,
05/03/2018,DGO.,"GOMEZ PALACIO, DGO.",2,0,2,0,0,0,
05/03/2018,VER.,"TIERRA BLANCA, VER.",1,0,1,0,0,0,
05/03/2018,COAH.,"SALTILLO, COAH.",0,0,0,0,2,0,
06/03/2018,CHIH.,"CHIH., CHIH.",9,6,15,0,0,504,
06/03/2018,S.L.P.,"SAN LUIS POTOSI, S.L.P.",2,0,2,1,0,0,
06/03/2018,COAH.,"SALTILLO, COAH.",0,1,1,0,0,172,
06/03/2018,COAH.,"SALTILLO, COAH.",0,0,0,1,0,172,
06/03/2018,D.F.,"TLALPAN, D.F.",0,0,0,0,0,81,
07/03/2018,CHIH.,"CHIH., CHIH.",17,2,19,0,0,272,
07/03/2018,SIN.,"CULIACAN, SIN.",2,2,4,0,2,0,
07/03/2018,S.L.P.,"SAN LUIS POTOSI, S.L.P.",3,1,4,0,0,0,
07/03/2018,COAH.,"PIEDRAS NEGRAS, COAH.",3,0,3,2,0,149,
07/03/2018,COAH.,"SALTILLO, COAH.",2,0,2,1,0,24,
07/03/2018,TAMPS.,"NUEVO LAREDO, TAMPS.",0,2,2,0,0,0,
07/03/2018,COAH.,"RAMOS ARIZPE, COAH.",1,0,1,1,0,108,
07/03/2018,COAH.,"ACUÑA, COAH.",1,0,1,0,0,0,
07/03/2018,VER.,"TIERRA BLANCA, VER.",1,0,1,0,0,0,
07/03/2018,DGO.,"LERDO, DGO.",0,1,1,0,0,120,
08/03/2018,CHIH.,"CHIH., CHIH.",14,8,22,0,0,137,
08/03/2018,D.F.,"MIGUEL HGO., D.F.",1,8,9,0,0,0,
08/03/2018,COAH.,"TORREÓN, COAH.",2,1,3,20,0,338,
08/03/2018,S.L.P.,"SAN LUIS POTOSI, S.L.P.",3,0,3,0,0,0,
08/03/2018,COAH.,"FRANCISCO I. MADERO, COAH.",1,2,3,0,0,338,
08/03/2018,DGO.,"LERDO, DGO.",1,2,3,0,0,0,
08/03/2018,DGO.,"GOMEZ PALACIO, DGO.",1,1,2,0,0,0,
08/03/2018,COAH.,"MATAMOROS, COAH.",1,0,1,0,0,0,
08/03/2018,VER.,"VEGA DE ALATORRE, VER.",1,0,1,0,0,0,
08/03/2018,COAH.,"MATAMOROS, COAH.",1,0,1,0,0,0,
09/03/2018,CHIH.,"CHIH., CHIH.",9,0,9,0,0,744,
09/03/2018,GRO.,"TECPAN DE GALEANA, GRO.",5,0,5,2,0,0,
09/03/2018,D.F.,"TLALPAN, D.F.",1,3,4,0,0,0,
09/03/2018,COAH.,"MONCLOVA, COAH.",2,1,3,1,0,158,
09/03/2018,DGO.,"LERDO, DGO.",3,0,3,0,0,0,
09/03/2018,S.L.P.,"SAN LUIS POTOSI, S.L.P.",3,0,3,0,0,0,
09/03/2018,COAH.,"SAN PEDRO, COAH.",1,0,1,0,0,0,
09/03/2018,DGO.,"GOMEZ PALACIO, DGO.",0,1,1,0,0,0,
09/03/2018,SIN.,"CULIACAN, SIN.",0,0,0,0,3,0,
10/03/2018,S.L.P.,"SAN LUIS POTOSI, S.L.P.",1,2,3,3,0,0,
10/03/2018,DGO.,"GOMEZ PALACIO, DGO.",1,1,2,0,0,0,
10/03/2018,DGO.,"LERDO, DGO.",1,0,1,0,0,0,
12/03/2018,COAH.,"SALTILLO, COAH.",9,2,11,2,0,85,
12/03/2018,S.L.P.,"SAN LUIS POTOSI, S.L.P.",3,2,5,0,0,0,
12/03/2018,COAH.,"MONCLOVA, COAH.",5,0,5,1,3,37,
12/03/2018,COAH.,"SAN PEDRO, COAH.",1,3,4,0,0,0,
12/03/2018,COAH.,"TORREÓN, COAH.",1,2,3,0,0,0,
12/03/2018,ZAC.,"GUADALUPE, ZAC.",2,0,2,0,0,5,
12/03/2018,COAH.,"RAMOS ARIZPE, COAH.",1,0,1,6,0,20,
12/03/2018,VER.,"VEGA DE ALATORRE, VER.",1,0,1,0,0,0,
12/03/2018,SIN.,"ELOTA, SIN.",0,0,0,0,2,0,
13/03/2018,COAH.,"ACUÑA, COAH.",0,5,5,0,0,0,
13/03/2018,ZAC.,"FRESNILLO, ZAC.",4,1,5,6,0,39,
13/03/2018,S.L.P.,"SAN LUIS POTOSI, S.L.P.",2,1,3,0,0,0,
13/03/2018,COAH.,"TORREÓN, COAH.",2,0,2,0,0,0,
13/03/2018,ZAC.,"ZAC., ZAC.",1,1,2,0,0,14,
13/03/2018,COAH.,"RAMOS ARIZPE, COAH.",1,0,1,0,0,0,
13/03/2018,COAH.,"SALTILLO, COAH.",0,0,0,0,0,254,
14/03/2018,QRO.,"QUERETARO, QRO.",3,1,4,0,0,0,
14/03/2018,COAH.,"PIEDRAS NEGRAS, COAH.",3,0,3,1,0,0,
14/03/2018,SIN.,"MAZATLAN, SIN.",0,2,2,0,0,0,
14/03/2018,ZAC.,"GUADALUPE, ZAC.",2,0,2,0,0,1,
14/03/2018,S.L.P.,"SAN LUIS POTOSI, S.L.P.",1,0,1,3,0,0,
14/03/2018,COAH.,"SALTILLO, COAH.",0,1,1,0,0,180,
14/03/2018,ZAC.,"FRESNILLO, ZAC.",1,0,1,0,0,8,
14/03/2018,SIN.,"ELOTA, SIN.",0,0,0,0,12,0,
14/03/2018,DGO.,"GOMEZ PALACIO, DGO.",0,0,0,0,1,0,
15/03/2018,S.L.P.,"SAN LUIS POTOSI, S.L.P.",3,1,4,0,0,0,
15/03/2018,QRO.,"EZEQUIEL MONTES, QRO.",1,1,2,0,0,0,
15/03/2018,QRO.,"QUERETARO, QRO.",2,0,2,0,0,23,
15/03/2018,SIN.,"MAZATLAN, SIN.",1,0,1,0,0,0,
15/03/2018,DGO.,"GOMEZ PALACIO, DGO.",0,1,1,0,0,0,
15/03/2018,DGO.,"LERDO, DGO.",0,1,1,0,0,0,
15/03/2018,S.L.P.,"SAN LUIS POTOSI, S.L.P.",1,0,1,3,0,0,
15/03/2018,ZAC.,"ZAC., ZAC.",1,0,1,0,0,0,
15/03/2018,GRO.,"BENITO JUAREZ, GRO.",0,1,1,1,0,3,
15/03/2018,S.L.P.,"CIUDAD VALLES, S.L.P.",1,0,1,0,0,0,
15/03/2018,S.L.P.,"CIUDAD VALLES, S.L.P.",0,0,0,0,0,1,
16/03/2018,DGO.,"LERDO, DGO.",19,0,19,0,0,0,
16/03/2018,TAMPS.,"MATAMOROS, TAMPS.",6,0,6,0,0,59,
16/03/2018,QRO.,"QUERETARO, QRO.",3,1,4,0,0,2,
16/03/2018,SIN.,"ELOTA, SIN.",2,1,3,0,0,0,
16/03/2018,ZAC.,"GUADALUPE, ZAC.",1,1,2,0,0,190,
16/03/2018,TAB.,"HUIMANGUILLO, TAB.",0,1,1,0,0,0,
17/03/2018,DGO.,"LERDO, DGO.",2,2,4,0,0,0,
17/03/2018,COAH.,"SABINAS, COAH.",0,1,1,0,0,57,
17/03/2018,S.L.P.,"SAN LUIS POTOSI, S.L.P.",1,0,1,0,0,0,
18/03/2018,QRO.,"QUERETARO, QRO.",6,2,8,2,0,0,
18/03/2018,S.L.P.,"SAN LUIS POTOSI, S.L.P.",0,1,1,0,0,0,
19/03/2018,SIN.,"MAZATLAN, SIN.",1,2,3,0,0,0,
19/03/2018,S.L.P.,"SAN LUIS POTOSI, S.L.P.",0,1,1,0,0,0,
20/03/2018,COAH.,"PIEDRAS NEGRAS, COAH.",4,0,4,1,0,0,
20/03/2018,QRO.,"QUERETARO, QRO.",2,0,2,0,1,0,
20/03/2018,S.L.P.,"SAN LUIS POTOSI, S.L.P.",1,0,1,6,4,0,
20/03/2018,DGO.,"GOMEZ PALACIO, DGO.",1,0,1,0,0,0,
20/03/2018,COAH.,"ACUÑA, COAH.",1,0,1,0,0,0,
20/03/2018,ZAC.,"GUADALUPE, ZAC.",1,0,1,0,0,0,
20/03/2018,VER.,"RIO BLANCO, VER.",0,0,0,0,0,34,
21/03/2018,COAH.,"SALTILLO, COAH.",6,3,9,0,0,0,
21/03/2018,S.L.P.,"SAN LUIS POTOSI, S.L.P.",1,2,3,0,0,0,
21/03/2018,QRO.,"QUERETARO, QRO.",1,1,2,0,0,0,
21/03/2018,GRO.,"TECPAN DE GALEANA, GRO.",0,2,2,1,0,2,
21/03/2018,VER.,"RIO BLANCO, VER.",1,0,1,1,0,117,
21/03/2018,COAH.,"RAMOS ARIZPE, COAH.",1,0,1,0,0,0,
21/03/2018,COAH.,"PIEDRAS NEGRAS, COAH.",0,1,1,0,0,0,
22/03/2018,ZAC.,"GUADALUPE, ZAC.",6,0,6,0,0,0,
22/03/2018,COAH.,"TORREÓN, COAH.",2,1,3,6,0,0,
22/03/2018,COAH.,"SALTILLO, COAH.",3,0,3,0,0,0,
22/03/2018,COAH.,"ACUÑA, COAH.",0,2,2,0,0,0,
22/03/2018,QRO.,"QUERETARO, QRO.",1,1,2,2,1,0,
22/03/2018,ZAC.,"FRESNILLO, ZAC.",0,0,0,0,0,111,
23/03/2018,COAH.,"TORREÓN, COAH.",3,1,4,1,0,973,
23/03/2018,QRO.,"QUERETARO, QRO.",2,1,3,0,0,0,
23/03/2018,COAH.,"SALTILLO, COAH.",2,0,2,0,0,15,
23/03/2018,COAH.,"ACUÑA, COAH.",0,2,2,0,0,0,
23/03/2018,SIN.,"MAZATLAN, SIN.",2,0,2,0,0,0,
23/03/2018,VER.,"RIO BLANCO, VER.",2,0,2,0,0,12,
23/03/2018,COAH.,"RAMOS ARIZPE, COAH.",1,0,1,0,0,0,
23/03/2018,S.L.P.,"SAN LUIS POTOSI, S.L.P.",1,0,1,0,0,0,
23/03/2018,VER.,"VER., VER.",1,0,1,0,0,0,
23/03/2018,DGO.,"LERDO, DGO.",1,0,1,0,0,0,
23/03/2018,COAH.,"PIEDRAS NEGRAS, COAH.",0,0,0,0,0,20,
23/03/2018,VER.,"MARTINEZ DE LA TORRE, VER.",0,0,0,0,0,94,
24/03/2018,S.L.P.,"CIUDAD VALLES, S.L.P.",4,0,4,0,0,0,
24/03/2018,S.L.P.,"SAN LUIS POTOSI, S.L.P.",4,0,4,5,4,0,
24/03/2018,QRO.,"QUERETARO, QRO.",2,1,3,1,0,0,
24/03/2018,COAH.,"SABINAS, COAH.",0,1,1,0,1,0,
24/03/2018,TAMPS.,"MATAMOROS, TAMPS.",0,1,1,0,0,53,
24/03/2018,COAH.,"PIEDRAS NEGRAS, COAH.",0,0,0,1,0,0,
25/03/2018,S.L.P.,"SAN LUIS POTOSI, S.L.P.",4,0,4,9,0,0,
25/03/2018,QRO.,"QUERETARO, QRO.",1,2,3,0,0,26,
25/03/2018,TAMPS.,"MATAMOROS, TAMPS.",1,0,1,1,0,0,
26/03/2018,S.L.P.,"SAN LUIS POTOSI, S.L.P.",2,0,2,9,0,0,
26/03/2018,GRO.,"PETATLAN, GRO.",1,0,1,1,0,4,
26/03/2018,COAH.,"MONCLOVA, COAH.",0,0,0,0,1,161,
26/03/2018,COAH.,"ACUÑA, COAH.",0,0,0,3,0,0,
27/03/2018,COAH.,"SALTILLO, COAH.",2,0,2,5,1,182,
27/03/2018,COAH.,"MONCLOVA, COAH.",1,1,2,1,0,16,
27/03/2018,VER.,"MARTINEZ DE LA TORRE, VER.",1,0,1,1,0,7,
27/03/2018,DGO.,"GOMEZ PALACIO, DGO.",1,0,1,0,0,0,
27/03/2018,S.L.P.,"SAN LUIS POTOSI, S.L.P.",1,0,1,4,0,0,
27/03/2018,QRO.,"QUERETARO, QRO.",0,1,1,0,0,0,
27/03/2018,COAH.,"TORREÓN, COAH.",0,0,0,0,8,0,
27/03/2018,COAH.,"PIEDRAS NEGRAS, COAH.",0,0,0,0,0,42,
28/03/2018,QRO.,"QUERETARO, QRO.",9,3,12,0,1,0,
28/03/2018,VER.,"MARTINEZ DE LA TORRE, VER.",2,0,2,0,0,0,
28/03/2018,S.L.P.,"SAN LUIS POTOSI, S.L.P.",1,0,1,0,2,0,
28/03/2018,COAH.,"FRANCISCO I. MADERO, COAH.",0,0,0,1,0,732,
28/03/2018,S.L.P.,"CIUDAD VALLES, S.L.P.",0,0,0,0,9,0,
28/03/2018,COAH.,"MÚZQUIZ, COAH.",0,0,0,0,0,305,
29/03/2018,S.L.P.,"SAN LUIS POTOSI, S.L.P.",1,1,2,5,0,0,
29/03/2018,COAH.,"NUEVA ROSITA, COAH.",0,0,0,0,0,76,
31/03/2018,S.L.P.,"CIUDAD VALLES, S.L.P.",1,0,1,0,0,0,
31/03/2018,GRO.,"PETATLAN, GRO.",0,1,1,0,0,0,
05/04/2018,TAMPS.,"REYNOSA, TAMPS.",1,1,2,0,0,350,
03/07/2018,SIN.,"CULIACAN, SIN.",4,1,5,0,0,0,
06/07/2018,N.L.,"APODACA, N.L.",0,1,1,7,0,56,
06/07/2018,COL.,"COL., COL.",1,0,1,0,0,28,
07/07/2018,N.L.,"APODACA, N.L.",0,0,0,16,0,500,
09/07/2018,SIN.,"SALVADOR ALVARADO, SIN.",2,0,2,0,0,0,
09/07/2018,N.L.,"MONTERREY, N.L.",1,0,1,25,0,1697,
09/07/2018,GRO.,"PUNGARABATO, GRO.",1,0,1,1,0,0,
10/07/2018,B.C.,"TIJUANA, B.C.",3,0,3,0,0,0,
10/07/2018,B.C.,"ENSENADA, B.C.",1,0,1,0,0,5,
10/07/2018,N.L.,"APODACA, N.L.",0,0,0,11,0,0,
11/07/2018,B.C.,"TIJUANA, B.C.",3,0,3,0,0,0,
11/07/2018,B.C.,"MEXICALI, B.C.",0,2,2,0,0,0,
11/07/2018,B.C.,"ENSENADA, B.C.",1,0,1,0,0,5,
11/07/2018,N.L.,"MONTERREY, N.L.",1,0,1,25,0,100,
11/07/2018,N.L.,"SALINAS VICTORIA, N.L.",0,0,0,20,0,513,
11/07/2018,TAB.,"PARAISO, TAB.",0,0,0,0,1,101,
13/07/2018,N.L.,"SALINAS VICTORIA, N.L.",0,3,3,3,0,0,
13/07/2018,N.L.,"SALINAS VICTORIA, N.L.",0,1,1,0,0,0,
14/07/2018,B.C.,"TIJUANA, B.C.",5,1,6,0,0,0,
14/07/2018,CHIS.,"PALENQUE, CHIS.",0,1,1,0,0,0,
14/07/2018,TAB.,"PARAISO, TAB.",0,0,0,0,0,30,
16/07/2018,B.C.,"TIJUANA, B.C.",5,1,6,0,0,0,
17/07/2018,N.L.,"MONTERREY, N.L.",8,0,8,2,0,0,
17/07/2018,GTO.,"IRAPUATO, GTO.",4,1,5,0,0,19,
17/07/2018,N.L.,"SALINAS VICTORIA, N.L.",0,1,1,0,0,0,
17/07/2018,ZAC.,"GUADALUPE, ZAC.",1,0,1,5,0,185,
18/07/2018,ZAC.,"GUADALUPE, ZAC.",1,3,4,7,1,88,
18/07/2018,N.L.,"MONTERREY, N.L.",0,2,2,1,0,20,
18/07/2018,B.C.,"TIJUANA, B.C.",1,0,1,0,0,0,
18/07/2018,N.L.,"APODACA, N.L.",1,0,1,0,0,0,
18/07/2018,GTO.,"IRAPUATO, GTO.",1,0,1,0,7,0,
19/07/2018,CHIH.,"HGO. DEL PARRAL, CHIH.",3,4,7,0,0,241,
19/07/2018,ZAC.,"GUADALUPE, ZAC.",4,2,6,2,0,0,
19/07/2018,GTO.,"IRAPUATO, GTO.",1,1,2,0,0,0,
19/07/2018,B.C.,"TIJUANA, B.C.",1,0,1,0,0,0,
19/07/2018,B.C.,"MEXICALI, B.C.",0,0,0,0,1,0,
20/07/2018,ZAC.,"GUADALUPE, ZAC.",3,2,5,9,0,187,
20/07/2018,GTO.,"CELAYA, GTO.",4,1,5,0,0,0,
20/07/2018,B.C.,"TIJUANA, B.C.",4,0,4,0,0,0,
20/07/2018,TAMPS.,"NUEVO LAREDO, TAMPS.",0,3,3,1,0,236,
20/07/2018,GTO.,"IRAPUATO, GTO.",3,0,3,2,0,32,
21/07/2018,CHIH.,"HGO. DEL PARRAL, CHIH.",3,3,6,0,0,2174,
21/07/2018,GRO.,"COYUCA DE CATALAN, GRO.",1,0,1,0,0,0,
21/07/2018,GTO.,"IRAPUATO, GTO.",0,0,0,0,2,20,
22/07/2018,TAMPS.,"MATAMOROS, TAMPS.",1,2,3,0,0,333,
22/07/2018,TAB.,"BALANCAN, TAB.",0,1,1,0,0,0,
23/07/2018,GTO.,"CELAYA, GTO.",3,4,7,0,0,118,
23/07/2018,ZAC.,"GUADALUPE, ZAC.",2,3,5,1,1,85,
23/07/2018,B.C.,"TIJUANA, B.C.",4,0,4,0,0,0,
23/07/2018,GTO.,"IRAPUATO, GTO.",3,0,3,0,0,22,
23/07/2018,N.L.,"SALINAS VICTORIA, N.L.",1,0,1,1,0,0,
23/07/2018,TAB.,"PARAISO, TAB.",1,0,1,1,0,0,
24/07/2018,ZAC.,"GUADALUPE, ZAC.",4,3,7,0,0,0,
24/07/2018,GTO.,"IRAPUATO, GTO.",2,0,2,0,2,20,
24/07/2018,GTO.,"CELAYA, GTO.",2,0,2,0,1,108,
24/07/2018,B.C.,"ENSENADA, B.C.",1,0,1,0,0,0,
24/07/2018,TLAX.,"PANOTLA, TLAX.",1,0,1,0,0,0,
25/07/2018,ZAC.,"GUADALUPE, ZAC.",6,0,6,7,0,127,
25/07/2018,B.C.,"TIJUANA, B.C.",3,0,3,0,0,0,
25/07/2018,GTO.,"CELAYA, GTO.",1,1,2,0,0,0,
25/07/2018,B.C.,"ENSENADA, B.C.",0,1,1,0,0,0,
25/07/2018,N.L.,"APODACA, N.L.",1,0,1,0,0,0,
25/07/2018,B.C.,"ENSENADA, B.C.",0,0,0,0,1,0,
25/07/2018,TAB.,"PARAISO, TAB.",0,0,0,0,1,0,
25/07/2018,N.L.,"SALINAS VICTORIA, N.L.",0,0,0,0,0,43,
26/07/2018,ZAC.,"GUADALUPE, ZAC.",3,4,7,6,0,235,
26/07/2018,TLAX.,"PANOTLA, TLAX.",0,3,3,0,0,0,
26/07/2018,N.L.,"APODACA, N.L.",1,0,1,0,0,0,
26/07/2018,SIN.,"NAVOLATO, SIN.",0,1,1,0,0,0,
26/07/2018,DGO.,"GOMEZ PALACIO, DGO.",1,0,1,0,0,0,
26/07/2018,GTO.,"CELAYA, GTO.",0,0,0,0,11,20,
27/07/2018,GTO.,"IRAPUATO, GTO.",12,2,14,0,0,0,
27/07/2018,ZAC.,"GUADALUPE, ZAC.",6,0,6,2,0,70,
27/07/2018,N.L.,"MONTERREY, N.L.",2,1,3,1,0,0,
27/07/2018,TLAX.,"CHIAUTEMPAN, TLAX.",3,0,3,1,0,0,
27/07/2018,TLAX.,"TLAX., TLAX.",1,1,2,0,0,0,
27/07/2018,PUE.,"PUE., PUE.",1,0,1,0,0,0,
27/07/2018,N.L.,"APODACA, N.L.",0,0,0,0,1,0,
28/07/2018,B.C.,"TIJUANA, B.C.",3,0,3,0,0,0,
28/07/2018,TLAX.,"TLAX., TLAX.",1,0,1,0,0,0,
28/07/2018,TAB.,"BALANCAN, TAB.",0,1,1,0,0,0,
29/07/2018,TAMPS.,"MATAMOROS, TAMPS.",2,1,3,0,0,0,
29/07/2018,TAB.,"EMILIANO ZAPATA, TAB.",2,0,2,1,0,0,
30/07/2018,B.C.,"TIJUANA, B.C.",7,2,9,0,0,0,
30/07/2018,GTO.,"IRAPUATO, GTO.",1,4,5,0,0,0,
30/07/2018,D.F.,"GUSTAVO A. MADERO, D.F.",4,0,4,0,2,773,
30/07/2018,SIN.,"NAVOLATO, SIN.",1,0,1,0,0,0,
30/07/2018,N.L.,"APODACA, N.L.",1,0,1,0,0,100,
31/07/2018,GTO.,"IRAPUATO, GTO.",1,2,3,0,4,7,
31/07/2018,GTO.,"CELAYA, GTO.",2,1,3,0,0,0,
31/07/2018,B.C.,"TIJUANA, B.C.",2,0,2,0,0,0,
31/07/2018,D.F.,"GUSTAVO A. MADERO, D.F.",1,0,1,0,0,21,
31/07/2018,TAB.,"CENTRO, TAB.",1,0,1,0,0,0,
01/08/2018,D.F.,"GUSTAVO A. MADERO, D.F.",5,1,6,0,1,2147,
01/08/2018,GTO.,"IRAPUATO, GTO.",2,0,2,0,0,0,
01/08/2018,GTO.,"CELAYA, GTO.",2,0,2,0,0,0,
01/08/2018,GTO.,"IRAPUATO, GTO.",1,0,1,0,12,0,
01/08/2018,DGO.,"GOMEZ PALACIO, DGO.",0,0,0,1,0,0,
01/08/2018,TAMPS.,"NUEVO LAREDO, TAMPS.",0,0,0,0,0,24,
02/08/2018,D.F.,"GUSTAVO A. MADERO, D.F.",34,13,47,0,1,1008,
02/08/2018,DGO.,"GOMEZ PALACIO, DGO.",5,4,9,1,2,12,
02/08/2018,CHIH.,"HGO. DEL PARRAL, CHIH.",3,1,4,5,0,1314,
02/08/2018,GTO.,"CELAYA, GTO.",2,1,3,0,0,0,
02/08/2018,N.L.,"APODACA, N.L.",2,1,3,20,12,1152,
02/08/2018,GTO.,"VILLAGRAN, GTO.",0,1,1,0,0,0,
02/08/2018,GTO.,"CELAYA, GTO.",1,0,1,0,0,0,
02/08/2018,B.C.,"TIJUANA, B.C.",1,0,1,0,1,0,
02/08/2018,D.F.,"GUSTAVO A. MADERO, D.F.",0,0,0,0,1,0,
02/08/2018,SIN.,"NAVOLATO, SIN.",0,0,0,0,3,0,
03/08/2018,B.C.,"TIJUANA, B.C.",9,0,9,0,0,0,
03/08/2018,TAMPS.,"MATAMOROS, TAMPS.",5,3,8,0,0,36,
03/08/2018,DGO.,"GOMEZ PALACIO, DGO.",5,0,5,3,0,0,
03/08/2018,GTO.,"IRAPUATO, GTO.",0,0,0,0,17,14,
04/08/2018,TAMPS.,"MATAMOROS, TAMPS.",3,0,3,0,0,146,
04/08/2018,N.L.,"APODACA, N.L.",0,1,1,1,0,0,
04/08/2018,TAMPS.,"NUEVO LAREDO, TAMPS.",0,1,1,0,0,119,
04/08/2018,DGO.,"GOMEZ PALACIO, DGO.",1,0,1,2,0,0,
04/08/2018,TLAX.,"APIZACO, TLAX.",1,0,1,0,0,0,
04/08/2018,TLAX.,"PANOTLA, TLAX.",1,0,1,0,0,0,
04/08/2018,TAB.,"EMILIANO ZAPATA, TAB.",0,0,0,1,0,0,
05/08/2018,TAB.,"JONUTA, TAB.",1,0,1,0,0,0,
06/08/2018,D.F.,"GUSTAVO A. MADERO, D.F.",21,5,26,0,1,893,
06/08/2018,TAMPS.,"TAMPICO, TAMPS.",5,3,8,0,1,86,
06/08/2018,CHIS.,"CHICOASÉN, CHIS.",5,0,5,1,0,16,
06/08/2018,MEX.,"ATIZAPAN, MEX.",3,2,5,0,0,138,
06/08/2018,MEX.,"CHALCO, MEX.",3,1,4,0,0,149,
06/08/2018,B.C.,"TIJUANA, B.C.",2,2,4,0,0,0,
06/08/2018,MEX.,"ATLACOMULCO, MEX.",1,3,4,0,0,148,
06/08/2018,CHIS.,"TAPACHULA, CHIS.",2,1,3,0,0,167,
06/08/2018,TAMPS.,"NUEVO LAREDO, TAMPS.",1,2,3,0,0,28,
06/08/2018,MEX.,"ZUMPANGO, MEX.",1,1,2,0,0,0,
06/08/2018,N.L.,"APODACA, N.L.",0,1,1,0,0,0,
06/08/2018,DGO.,"GOMEZ PALACIO, DGO.",0,1,1,0,0,0,
06/08/2018,B.C.,"MEXICALI, B.C.",0,1,1,0,0,0,
06/08/2018,GTO.,"IRAPUATO, GTO.",0,0,0,0,1,7,
06/08/2018,GTO.,"CELAYA, GTO.",0,0,0,0,0,50,
07/08/2018,D.F.,"GUSTAVO A. MADERO, D.F.",11,3,14,0,7,283,
07/08/2018,MEX.,"ATIZAPAN, MEX.",6,0,6,6,0,201,
07/08/2018,GTO.,"CELAYA, GTO.",5,0,5,0,0,69,
07/08/2018,TAMPS.,"TAMPICO, TAMPS.",4,1,5,0,0,16,
07/08/2018,MEX.,"ATLACOMULCO, MEX.",1,3,4,6,0,201,
07/08/2018,MEX.,"CHALCO, MEX.",2,1,3,0,0,678,
07/08/2018,QRO.,"QUERETARO, QRO.",2,1,3,0,0,0,
07/08/2018,MEX.,"ZUMPANGO, MEX.",2,0,2,0,0,29,
07/08/2018,DGO.,"DGO., DGO.",1,0,1,0,0,0,
07/08/2018,QRO.,"QUERETARO, QRO.",1,0,1,1,0,0,
07/08/2018,TAB.,"COMALCALCO, TAB.",1,0,1,1,0,0,
07/08/2018,TLAX.,"HUAMANTLA, TLAX.",1,0,1,0,0,0,
07/08/2018,TLAX.,"EL CARMEN TEQUEXQUITLA, TLAX.",0,1,1,0,0,0,
07/08/2018,TAMPS.,"NUEVO LAREDO, TAMPS.",1,0,1,0,0,4,
07/08/2018,TAMPS.,"MIER, TAMPS.",0,1,1,0,0,0,
07/08/2018,TAMPS.,"ALTAMIRA, TAMPS.",1,0,1,0,0,29,
08/08/2018,CHIS.,"TUXTLA GUTIÉRREZ, CHIS.",5,7,12,1,1,106,
08/08/2018,MEX.,"ATIZAPAN, MEX.",4,2,6,0,50,206,
08/08/2018,TAMPS.,"VICTORIA, TAMPS.",4,2,6,0,0,0,
08/08/2018,MEX.,"CHALCO, MEX.",2,3,5,0,0,461,
08/08/2018,CHIH.,"HGO. DEL PARRAL, CHIH.",3,0,3,0,0,1366,
08/08/2018,N.L.,"MONTERREY, N.L.",0,2,2,38,0,185,
08/08/2018,DGO.,"DGO., DGO.",1,1,2,0,0,0,
08/08/2018,GTO.,"CELAYA, GTO.",1,1,2,1,1,1,
08/08/2018,TLAX.,"HUAMANTLA, TLAX.",0,2,2,0,0,0,
08/08/2018,TLAX.,"EL CARMEN TEQUEXQUITLA, TLAX.",2,0,2,0,0,0,
08/08/2018,GTO.,"IRAPUATO, GTO.",0,1,1,0,5,34,
08/08/2018,MEX.,"ATLACOMULCO, MEX.",1,0,1,1,0,399,
08/08/2018,TAB.,"COMALCALCO, TAB.",1,0,1,1,0,0,
08/08/2018,MEX.,"ZUMPANGO, MEX.",1,0,1,0,7,17,
08/08/2018,TAMPS.,"NUEVO LAREDO, TAMPS.",0,1,1,0,0,4,
08/08/2018,TAMPS.,"TAMPICO, TAMPS.",1,0,1,0,0,0,
08/08/2018,TAMPS.,"ALTAMIRA, TAMPS.",0,0,0,0,0,23,
09/08/2018,D.F.,"GUSTAVO A. MADERO, D.F.",17,5,22,0,17,1180,
09/08/2018,CHIS.,"CHICOASÉN, CHIS.",9,2,11,4,0,186,
09/08/2018,MEX.,"CHALCO, MEX.",7,1,8,0,0,461,
09/08/2018,MEX.,"ATLACOMULCO, MEX.",5,0,5,2,0,710,
09/08/2018,CHIS.,"TAPACHULA, CHIS.",3,2,5,1,1,77,
09/08/2018,TAMPS.,"VICTORIA, TAMPS.",2,3,5,0,0,20,
09/08/2018,TAMPS.,"NUEVO LAREDO, TAMPS.",3,1,4,0,0,25,
09/08/2018,N.L.,"MONTERREY, N.L.",1,2,3,2,0,26,
09/08/2018,COAH.,"SABINAS, COAH.",0,3,3,0,0,0,
09/08/2018,MEX.,"ZUMPANGO, MEX.",2,1,3,0,1,72,
09/08/2018,TLAX.,"EL CARMEN TEQUEXQUITLA, TLAX.",1,1,2,0,0,0,
09/08/2018,COAH.,"SALTILLO, COAH.",2,0,2,1,0,55,
09/08/2018,TAMPS.,"EL MANTE, TAMPS.",2,0,2,0,0,0,
09/08/2018,GTO.,"CELAYA, GTO.",1,1,2,0,0,103,
09/08/2018,N.L.,"APODACA, N.L.",1,0,1,0,0,0,
09/08/2018,DGO.,"DGO., DGO.",1,0,1,0,0,0,
09/08/2018,TAMPS.,"TAMPICO, TAMPS.",1,0,1,0,0,0,
09/08/2018,MEX.,"ATLACOMULCO, MEX.",1,0,1,0,0,28,
09/08/2018,COAH.,"PIEDRAS NEGRAS, COAH.",0,0,0,0,0,269,
09/08/2018,TAMPS.,"ALTAMIRA, TAMPS.",0,0,0,0,0,23,
10/08/2018,D.F.,"GUSTAVO A. MADERO, D.F.",9,10,19,0,4,564,
10/08/2018,CHIS.,"TUXTLA GUTIÉRREZ, CHIS.",5,5,10,1,0,190,
10/08/2018,TAMPS.,"MATAMOROS, TAMPS.",3,6,9,0,0,0,
10/08/2018,MEX.,"ATIZAPAN, MEX.",5,1,6,5,35,320,
10/08/2018,CHIH.,"HGO. DEL PARRAL, CHIH.",5,1,6,7,1,1091,
10/08/2018,MEX.,"ZUMPANGO, MEX.",3,0,3,0,0,124,
10/08/2018,TAMPS.,"VICTORIA, TAMPS.",2,0,2,0,0,1039,
10/08/2018,TAMPS.,"TAMPICO, TAMPS.",2,0,2,0,0,0,
10/08/2018,GTO.,"IRAPUATO, GTO.",2,0,2,0,0,0,
10/08/2018,GTO.,"CELAYA, GTO.",1,1,2,0,0,0,
10/08/2018,CHIS.,"TAPACHULA, CHIS.",0,2,2,0,0,193,
10/08/2018,COAH.,"NUEVA ROSITA, COAH.",1,1,2,1,0,0,
10/08/2018,MEX.,"CHALCO, MEX.",0,2,2,0,0,73,
10/08/2018,COAH.,"SALTILLO, COAH.",1,0,1,0,0,0,
10/08/2018,COAH.,"ACUÑA, COAH.",1,0,1,0,0,0,
10/08/2018,TAMPS.,"NUEVO LAREDO, TAMPS.",0,1,1,0,0,44,
10/08/2018,QRO.,"ARROYO SECO, QRO.",1,0,1,0,0,0,
10/08/2018,TAB.,"COMALCALCO, TAB.",1,0,1,0,0,0,
10/08/2018,TLAX.,"HUAMANTLA, TLAX.",1,0,1,0,0,0,
10/08/2018,B.C.,"TIJUANA, B.C.",0,1,1,0,0,0,
10/08/2018,B.C.,"ENSENADA, B.C.",1,0,1,0,1,0,
10/08/2018,COAH.,"PIEDRAS NEGRAS, COAH.",1,0,1,2,0,0,
10/08/2018,COAH.,"MONCLOVA, COAH.",0,0,0,0,0,175,
10/08/2018,COAH.,"PIEDRAS NEGRAS, COAH.",0,0,0,0,0,90,
10/08/2018,TAMPS.,"ALTAMIRA, TAMPS.",0,0,0,0,2,0,
10/08/2018,TAMPS.,"CIUDAD MADERO, TAMPS.",0,0,0,0,0,113,
11/08/2018,CHIS.,"CHICOASÉN, CHIS.",4,2,6,0,2,262,
11/08/2018,MEX.,"CHALCO, MEX.",4,1,5,0,0,63,
11/08/2018,MEX.,"ZUMPANGO, MEX.",3,1,4,0,0,317,
11/08/2018,MEX.,"ATIZAPAN, MEX.",2,1,3,0,0,252,
11/08/2018,MEX.,"ATLACOMULCO, MEX.",3,0,3,0,0,346,
11/08/2018,TLAX.,"EL CARMEN TEQUEXQUITLA, TLAX.",3,0,3,1,0,0,
11/08/2018,CHIS.,"TAPACHULA, CHIS.",1,2,3,2,0,509,
11/08/2018,TAB.,"TENOSIQUE, TAB.",3,0,3,0,0,0,
11/08/2018,TAMPS.,"MIER, TAMPS.",1,1,2,0,0,700,
11/08/2018,TLAX.,"HUAMANTLA, TLAX.",1,1,2,0,0,0,
11/08/2018,TAMPS.,"CIUDAD MADERO, TAMPS.",1,1,2,0,0,0,
11/08/2018,TAMPS.,"MIER, TAMPS.",1,1,2,0,0,0,
11/08/2018,CHIS.,"BENEMÉRITO DE LAS AMÉRICAS, CHIS.",1,0,1,0,0,0,
11/08/2018,TAMPS.,"TAMPICO, TAMPS.",1,0,1,0,1,0,
11/08/2018,TAMPS.,"ALTAMIRA, TAMPS.",0,0,0,0,0,196,
11/08/2018,TAMPS.,"NUEVO LAREDO, TAMPS.",0,0,0,0,0,39,
12/08/2018,CHIS.,"TUXTLA GUTIÉRREZ, CHIS.",2,3,5,1,0,0,
12/08/2018,QRO.,"PINAL DE AMOLES, QRO.",1,0,1,1,0,0,
12/08/2018,CHIS.,"BENEMÉRITO DE LAS AMÉRICAS, CHIS.",1,0,1,0,0,0,
12/08/2018,CHIS.,"PALENQUE, CHIS.",1,0,1,0,0,0,
12/08/2018,TAB.,"TENOSIQUE, TAB.",1,0,1,0,0,0,
13/08/2018,D.F.,"GUSTAVO A. MADERO, D.F.",9,0,9,0,0,24,
13/08/2018,CHIH.,"HGO. DEL PARRAL, CHIH.",3,3,6,5,0,248,
13/08/2018,QRO.,"PINAL DE AMOLES, QRO.",5,0,5,1,0,0,
13/08/2018,MEX.,"ATIZAPAN, MEX.",4,1,5,3,0,66,
13/08/2018,MEX.,"SAN MATEO ATENCO, MEX.",3,2,5,1,0,71,
13/08/2018,MEX.,"CHALCO, MEX.",3,1,4,0,2,0,
13/08/2018,TLAX.,"IXTACUIXTLA DE MARIANO MATAMOROS, TLAX.",0,3,3,0,0,0,
13/08/2018,CHIS.,"TUXTLA GUTIÉRREZ, CHIS.",1,1,2,1,0,99,
13/08/2018,CHIS.,"TAPACHULA, CHIS.",1,1,2,0,0,95,
13/08/2018,B.C.,"TIJUANA, B.C.",0,1,1,0,0,0,
13/08/2018,COAH.,"SALTILLO, COAH.",1,0,1,0,0,27,
13/08/2018,COAH.,"NUEVA ROSITA, COAH.",0,1,1,5,0,0,
13/08/2018,COAH.,"ACUÑA, COAH.",1,0,1,1,0,0,
13/08/2018,TLAX.,"CALPULALPAN, TLAX.",0,1,1,1,0,0,
13/08/2018,GRO.,"ZIHUATANEJO DE AZUETA, GRO.",0,1,1,0,0,0,
13/08/2018,TLAX.,"IXTACUIXTLA DE MARIANO MATAMOROS, TLAX.",0,1,1,0,0,0,
13/08/2018,MEX.,"CUAUTITLAN IZCALLI, MEX.",1,0,1,0,0,0,
13/08/2018,COAH.,"TORREÓN, COAH.",0,0,0,1,0,0,
13/08/2018,COAH.,"TORREÓN, COAH.",0,0,0,1,0,223,
14/08/2018,TAMPS.,"TAMPICO, TAMPS.",0,4,4,0,3,201,
14/08/2018,TAMPS.,"VICTORIA, TAMPS.",4,0,4,0,0,19,
14/08/2018,B.C.,"TIJUANA, B.C.",1,3,4,0,0,0,
14/08/2018,DGO.,"DGO., DGO.",2,2,4,0,0,0,
14/08/2018,MEX.,"ATIZAPAN, MEX.",3,0,3,1,0,256,
14/08/2018,SIN.,"NAVOLATO, SIN.",1,1,2,0,0,0,
14/08/2018,TAMPS.,"CIUDAD MADERO, TAMPS.",1,1,2,0,0,648,
14/08/2018,COAH.,"MONCLOVA, COAH.",2,0,2,0,0,100,
14/08/2018,D.F.,"BENITO JUAREZ, D.F.",0,2,2,0,11,112,
14/08/2018,MEX.,"CHALCO, MEX.",2,0,2,0,0,233,
14/08/2018,CHIS.,"TUXTLA GUTIÉRREZ, CHIS.",1,1,2,0,0,63,
14/08/2018,CHIS.,"TAPACHULA, CHIS.",1,1,2,0,0,0,
14/08/2018,SIN.,"CHOIX, SIN.",1,0,1,0,0,0,
14/08/2018,TAMPS.,"EL MANTE, TAMPS.",1,0,1,0,0,0,
14/08/2018,COAH.,"PIEDRAS NEGRAS, COAH.",0,1,1,3,0,0,
14/08/2018,COAH.,"NUEVA ROSITA, COAH.",1,0,1,0,0,95,
14/08/2018,COAH.,"SALTILLO, COAH.",0,1,1,0,1,0,
14/08/2018,GTO.,"IRAPUATO, GTO.",1,0,1,0,0,0,
14/08/2018,GTO.,"CELAYA, GTO.",1,0,1,0,0,0,
14/08/2018,MEX.,"CUAUTITLAN IZCALLI, MEX.",1,0,1,0,0,0,
14/08/2018,TAMPS.,"ALTAMIRA, TAMPS.",0,0,0,0,0,40,
14/08/2018,TAMPS.,"NUEVO LAREDO, TAMPS.",0,0,0,0,0,129,
14/08/2018,MEX.,"SAN MATEO ATENCO, MEX.",0,0,0,0,0,49,
15/08/2018,D.F.,"BENITO JUAREZ, D.F.",10,1,11,0,0,185,
15/08/2018,COAH.,"ACUÑA, COAH.",3,3,6,0,0,0,
15/08/2018,MEX.,"ATIZAPAN, MEX.",6,0,6,1,0,232,
15/08/2018,CHIS.,"CHICOASÉN, CHIS.",4,0,4,0,0,15,
15/08/2018,CHIH.,"HGO. DEL PARRAL, CHIH.",3,1,4,4,0,740,
15/08/2018,B.C.,"TIJUANA, B.C.",3,0,3,0,0,0,
15/08/2018,COAH.,"MATAMOROS, COAH.",3,0,3,0,0,0,
15/08/2018,COAH.,"SALTILLO, COAH.",3,0,3,0,1,0,
15/08/2018,COAH.,"PIEDRAS NEGRAS, COAH.",0,3,3,3,0,80,
15/08/2018,GTO.,"CELAYA, GTO.",1,2,3,0,0,137,
15/08/2018,MEX.,"CHALCO, MEX.",2,0,2,0,0,31,
15/08/2018,MEX.,"CUAUTITLAN IZCALLI, MEX.",2,0,2,0,0,0,
15/08/2018,COAH.,"NUEVA ROSITA, COAH.",1,0,1,0,0,33,
15/08/2018,N.L.,"APODACA, N.L.",0,1,1,0,0,0,
15/08/2018,SIN.,"NAVOLATO, SIN.",1,0,1,0,0,0,
15/08/2018,MEX.,"SAN MATEO ATENCO, MEX.",1,0,1,0,0,0,
15/08/2018,TLAX.,"IXTACUIXTLA DE MARIANO MATAMOROS, TLAX.",1,0,1,0,0,0,
15/08/2018,CHIS.,"TAPACHULA, CHIS.",0,1,1,0,0,0,
15/08/2018,COAH.,"RAMOS ARIZPE, COAH.",0,0,0,0,0,92,
15/08/2018,COAH.,"MONCLOVA, COAH.",0,0,0,0,0,68,
16/08/2018,D.F.,"BENITO JUAREZ, D.F.",8,5,13,0,3,99,
16/08/2018,MEX.,"ATIZAPAN, MEX.",8,4,12,2,0,131,
16/08/2018,CHIS.,"CHICOASÉN, CHIS.",5,2,7,0,0,36,
16/08/2018,CHIH.,"HGO. DEL PARRAL, CHIH.",4,2,6,1,1,281,
16/08/2018,N.L.,"LINARES, N.L.",5,0,5,0,0,0,
16/08/2018,GTO.,"CELAYA, GTO.",3,2,5,0,0,0,
16/08/2018,COAH.,"SAN PEDRO, COAH.",3,0,3,0,0,0,
16/08/2018,COAH.,"TORREÓN, COAH.",3,0,3,0,0,0,
16/08/2018,TAMPS.,"MATAMOROS, TAMPS.",2,1,3,0,0,1,
16/08/2018,MEX.,"CHALCO, MEX.",2,1,3,0,0,123,
16/08/2018,MEX.,"CUAUTITLAN IZCALLI, MEX.",2,1,3,0,0,109,
16/08/2018,TAMPS.,"REYNOSA, TAMPS.",2,1,3,3,0,364,
16/08/2018,COAH.,"MATAMOROS, COAH.",1,1,2,0,0,0,
16/08/2018,COAH.,"TORREÓN, COAH.",2,0,2,0,0,0,
16/08/2018,COAH.,"TORREÓN, COAH.",1,1,2,0,0,0,
16/08/2018,N.L.,"MONTERREY, N.L.",2,0,2,2,0,0,
16/08/2018,TAMPS.,"MATAMOROS, TAMPS.",2,0,2,0,0,433,
16/08/2018,MEX.,"SAN MATEO ATENCO, MEX.",2,0,2,0,0,0,
16/08/2018,CHIS.,"TAPACHULA, CHIS.",2,0,2,9,1,131,
16/08/2018,TAMPS.,"MAINERO, TAMPS.",2,0,2,0,0,559,
16/08/2018,TAMPS.,"TAMPICO, TAMPS.",2,0,2,0,0,6,
16/08/2018,B.C.,"ENSENADA, B.C.",0,1,1,0,1,0,
16/08/2018,COAH.,"TORREÓN, COAH.",1,0,1,0,0,0,
16/08/2018,TAMPS.,"TAMPICO, TAMPS.",1,0,1,0,0,29,
16/08/2018,SIN.,"NAVOLATO, SIN.",1,0,1,0,0,0,
16/08/2018,TLAX.,"IXTACUIXTLA DE MARIANO MATAMOROS, TLAX.",0,1,1,0,0,0,
16/08/2018,GRO.,"ZIHUATANEJO DE AZUETA, GRO.",1,0,1,0,0,20,
16/08/2018,TAMPS.,"VICTORIA, TAMPS.",1,0,1,3,5,0,
16/08/2018,B.C.,"ENSENADA, B.C.",0,0,0,0,1,0,
16/08/2018,B.C.,"MEXICALI, B.C.",0,0,0,0,1,0,
16/08/2018,COAH.,"SALTILLO, COAH.",0,0,0,2,0,13,
16/08/2018,COAH.,"PIEDRAS NEGRAS, COAH.",0,0,0,0,0,199,
16/08/2018,TAMPS.,"NUEVO LAREDO, TAMPS.",0,0,0,0,0,129,
17/08/2018,MEX.,"ATIZAPAN, MEX.",6,5,11,1,4,1161,
17/08/2018,D.F.,"GUSTAVO A. MADERO, D.F.",4,4,8,0,8,342,
17/08/2018,CHIH.,"HGO. DEL PARRAL, CHIH.",5,1,6,3,0,1224,
17/08/2018,TAMPS.,"MATAMOROS, TAMPS.",3,1,4,1,0,159,
17/08/2018,CHIS.,"TUXTLA GUTIÉRREZ, CHIS.",2,2,4,0,0,0,
17/08/2018,B.C.,"TIJUANA, B.C.",1,2,3,0,0,0,
17/08/2018,COAH.,"TORREÓN, COAH.",3,0,3,0,0,0,
17/08/2018,TAMPS.,"CIUDAD MADERO, TAMPS.",2,1,3,0,0,559,
17/08/2018,MEX.,"CHALCO, MEX.",2,1,3,0,1,83,
17/08/2018,GTO.,"CELAYA, GTO.",2,0,2,0,0,18,
17/08/2018,TAMPS.,"TAMPICO, TAMPS.",2,0,2,0,0,160,
17/08/2018,TAMPS.,"VICTORIA, TAMPS.",2,0,2,0,0,18,
17/08/2018,TAMPS.,"REYNOSA, TAMPS.",2,0,2,2,0,175,
17/08/2018,B.C.,"ENSENADA, B.C.",1,0,1,0,0,0,
17/08/2018,COAH.,"SAN PEDRO, COAH.",0,1,1,1,0,6,
17/08/2018,COAH.,"SALTILLO, COAH.",0,1,1,36,0,0,
17/08/2018,COAH.,"RAMOS ARIZPE, COAH.",0,1,1,3,1,149,
17/08/2018,COAH.,"MONCLOVA, COAH.",0,1,1,1,0,100,
17/08/2018,N.L.,"LINARES, N.L.",1,0,1,0,0,0,
17/08/2018,MEX.,"SAN MATEO ATENCO, MEX.",1,0,1,0,0,50,
17/08/2018,TLAX.,"CALPULALPAN, TLAX.",1,0,1,0,0,0,
17/08/2018,SIN.,"CHOIX, SIN.",1,0,1,0,0,0,
17/08/2018,TAMPS.,"CAMARGO, TAMPS.",0,1,1,0,0,0,
17/08/2018,GRO.,"ZIHUATANEJO DE AZUETA, GRO.",1,0,1,0,0,0,
17/08/2018,MEX.,"CUAUTITLAN IZCALLI, MEX.",1,0,1,1,1,0,
18/08/2018,MEX.,"ATIZAPAN, MEX.",3,9,12,0,0,164,
18/08/2018,MEX.,"CHALCO, MEX.",5,1,6,0,0,9,
18/08/2018,CHIS.,"TUXTLA GUTIÉRREZ, CHIS.",1,2,3,0,0,0,
18/08/2018,TAMPS.,"REYNOSA, TAMPS.",2,1,3,2,0,80,
18/08/2018,VER.,"TUXPAM, VER.",2,0,2,0,0,0,
18/08/2018,MEX.,"CUAUTITLAN IZCALLI, MEX.",1,0,1,0,0,0,
18/08/2018,MEX.,"SAN MATEO ATENCO, MEX.",1,0,1,0,0,2659,
18/08/2018,S.L.P.,"CIUDAD VALLES, S.L.P.",1,0,1,0,0,0,
18/08/2018,CHIS.,"TAPACHULA, CHIS.",0,0,0,2,1,278,
19/08/2018,CHIS.,"TUXTLA GUTIÉRREZ, CHIS.",7,5,12,0,0,119,
19/08/2018,TAB.,"BALANCAN, TAB.",0,1,1,0,0,0,
19/08/2018,CHIS.,"TAPACHULA, CHIS.",0,0,0,0,0,757,
20/08/2018,D.F.,"BENITO JUAREZ, D.F.",17,2,19,0,15,3131,
20/08/2018,MEX.,"TLALNEPANTLA DE BAZ, MEX.",5,2,7,2,0,255,
20/08/2018,CHIH.,"HGO. DEL PARRAL, CHIH.",6,0,6,1,0,1,
20/08/2018,SIN.,"CHOIX, SIN.",2,1,3,0,0,0,
20/08/2018,TAMPS.,"VICTORIA, TAMPS.",2,1,3,2,0,35,
20/08/2018,COAH.,"SALTILLO, COAH.",1,1,2,1,1,192,
20/08/2018,DGO.,"DGO., DGO.",2,0,2,0,0,0,
20/08/2018,MEX.,"ZACUALPAN, MEX.",1,1,2,0,0,0,
20/08/2018,TAMPS.,"CIUDAD MADERO, TAMPS.",1,1,2,1,0,150,
20/08/2018,TAMPS.,"NUEVO LAREDO, TAMPS.",2,0,2,0,0,122,
20/08/2018,B.C.,"ENSENADA, B.C.",0,1,1,0,0,0,
20/08/2018,COAH.,"MONCLOVA, COAH.",1,0,1,1,0,0,
20/08/2018,TAMPS.,"GONZALEZ, TAMPS.",1,0,1,0,0,0,
20/08/2018,TAMPS.,"TAMPICO, TAMPS.",1,0,1,0,1,0,
20/08/2018,TAMPS.,"MATAMOROS, TAMPS.",0,1,1,1,0,37,
20/08/2018,TAMPS.,"ALTAMIRA, TAMPS.",0,0,0,0,0,86,
20/08/2018,TAMPS.,"MIER, TAMPS.",0,0,0,0,0,61,
21/08/2018,MEX.,"TLALNEPANTLA DE BAZ, MEX.",7,3,10,2,0,2768,
21/08/2018,B.C.,"ENSENADA, B.C.",6,3,9,0,2,0,
21/08/2018,MEX.,"CHIMALHUACAN, MEX.",7,0,7,2,0,0,
21/08/2018,TAMPS.,"REYNOSA, TAMPS.",2,3,5,0,0,70,
21/08/2018,COAH.,"SALTILLO, COAH.",1,4,5,0,0,0,
21/08/2018,B.C.,"TIJUANA, B.C.",5,0,5,0,0,0,
21/08/2018,N.L.,"LINARES, N.L.",4,0,4,2,0,0,
21/08/2018,CHIH.,"HGO. DEL PARRAL, CHIH.",3,0,3,0,0,30,
21/08/2018,MEX.,"ZACUALPAN, MEX.",1,2,3,1,0,0,
21/08/2018,TLAX.,"NATIVITAS, TLAX.",2,0,2,0,0,0,
21/08/2018,B.C.,"TIJUANA, B.C.",0,2,2,0,1,0,
21/08/2018,B.C.,"TIJUANA, B.C.",1,1,2,0,1,0,
21/08/2018,TAMPS.,"ALTAMIRA, TAMPS.",1,0,1,0,0,0,
21/08/2018,TAMPS.,"EL MANTE, TAMPS.",1,0,1,0,0,10,
21/08/2018,TAMPS.,"VICTORIA, TAMPS.",1,0,1,1,0,38,
21/08/2018,TAMPS.,"MIER, TAMPS.",0,1,1,0,0,0,
21/08/2018,COAH.,"MATAMOROS, COAH.",1,0,1,0,0,0,
21/08/2018,COAH.,"ACUÑA, COAH.",0,1,1,0,0,0,
21/08/2018,MEX.,"APAXCO, MEX.",1,0,1,0,2,0,
21/08/2018,TAMPS.,"CIUDAD MADERO, TAMPS.",0,0,0,0,0,669,
21/08/2018,TAMPS.,"MATAMOROS, TAMPS.",0,0,0,0,0,76,
21/08/2018,COAH.,"RAMOS ARIZPE, COAH.",0,0,0,0,2,0,
21/08/2018,COAH.,"NUEVA ROSITA, COAH.",0,0,0,7,0,530,
22/08/2018,COAH.,"MÚZQUIZ, COAH.",1,2,3,4,0,0,
22/08/2018,COAH.,"TORREÓN, COAH.",2,0,2,1,0,7,
22/08/2018,MEX.,"TLALNEPANTLA DE BAZ, MEX.",1,1,2,0,0,144,
22/08/2018,TLAX.,"NATIVITAS, TLAX.",1,1,2,0,0,0,
22/08/2018,COAH.,"PIEDRAS NEGRAS, COAH.",1,0,1,0,0,0,
22/08/2018,GTO.,"CELAYA, GTO.",0,0,0,0,0,57,
23/08/2018,CHIH.,"HGO. DEL PARRAL, CHIH.",19,3,22,9,1,1583,
23/08/2018,B.C.,"TIJUANA, B.C.",3,6,9,0,1,0,
23/08/2018,MEX.,"CHIMALHUACAN, MEX.",4,3,7,3,0,58,
23/08/2018,D.F.,"BENITO JUAREZ, D.F.",6,0,6,0,4,346,
23/08/2018,B.C.,"TIJUANA, B.C.",2,4,6,0,1,0,
23/08/2018,MEX.,"ZACUALPAN, MEX.",3,1,4,0,0,0,
23/08/2018,MEX.,"TLALNEPANTLA DE BAZ, MEX.",2,2,4,0,0,39,
23/08/2018,ZAC.,"FRESNILLO, ZAC.",2,1,3,0,0,31,
23/08/2018,COAH.,"TORREÓN, COAH.",3,0,3,0,0,36,
23/08/2018,ZAC.,"ZAC., ZAC.",3,0,3,1,0,56,
23/08/2018,N.L.,"MONTERREY, N.L.",1,1,2,2,0,363,
23/08/2018,TAMPS.,"MATAMOROS, TAMPS.",2,0,2,0,0,0,
23/08/2018,Q. ROO,"OTHON P. BLANCO, Q. ROO",2,0,2,3,0,403,
23/08/2018,N.L.,"MELCHOR OCAMPO, N.L.",0,1,1,250,0,0,
23/08/2018,SIN.,"CHOIX, SIN.",1,0,1,0,0,0,
23/08/2018,TAMPS.,"VICTORIA, TAMPS.",1,0,1,0,0,236,
23/08/2018,TAMPS.,"MIER, TAMPS.",0,1,1,0,0,63,
23/08/2018,TAMPS.,"ALTAMIRA, TAMPS.",1,0,1,1,0,17,
23/08/2018,TAMPS.,"CIUDAD MADERO, TAMPS.",1,0,1,1,0,0,
23/08/2018,TAMPS.,"TAMPICO, TAMPS.",1,0,1,0,0,105,
23/08/2018,ZAC.,"GUADALUPE, ZAC.",0,1,1,0,0,48,
23/08/2018,PUE.,"PUE., PUE.",1,0,1,0,1,147,
23/08/2018,TAMPS.,"NUEVO LAREDO, TAMPS.",0,0,0,1,0,511,
23/08/2018,TAMPS.,"REYNOSA, TAMPS.",0,0,0,4,0,278,
23/08/2018,TAB.,"CENTRO, TAB.",0,0,0,0,0,25,
23/08/2018,B.C.,"ENSENADA, B.C.",0,0,0,0,1,0,
23/08/2018,MEX.,"APAXCO, MEX.",0,0,0,0,0,28,
24/08/2018,MEX.,"CHIMALHUACAN, MEX.",5,4,9,5,70,899,
24/08/2018,MEX.,"TLALNEPANTLA DE BAZ, MEX.",7,0,7,0,0,473,
24/08/2018,CHIH.,"HGO. DEL PARRAL, CHIH.",4,3,7,7,0,1850,
24/08/2018,D.F.,"BENITO JUAREZ, D.F.",6,0,6,0,15,123,
24/08/2018,TAMPS.,"MIER, TAMPS.",2,4,6,0,0,130,
24/08/2018,MEX.,"ZACUALPAN, MEX.",1,3,4,1,0,0,
24/08/2018,GTO.,"CELAYA, GTO.",3,1,4,0,0,9,
24/08/2018,TAMPS.,"TAMPICO, TAMPS.",1,1,2,1,1,35,
24/08/2018,COAH.,"SALTILLO, COAH.",0,1,1,58,0,17,
24/08/2018,COAH.,"MÚZQUIZ, COAH.",0,1,1,0,0,0,
24/08/2018,N.L.,"SANTA CATARINA, N.L.",1,0,1,0,0,0,
24/08/2018,TAMPS.,"NUEVO LAREDO, TAMPS.",1,0,1,0,0,0,
24/08/2018,TAMPS.,"MATAMOROS, TAMPS.",1,0,1,5,0,44,
24/08/2018,TAMPS.,"CIUDAD MADERO, TAMPS.",1,0,1,0,0,0,
24/08/2018,TLAX.,"PANOTLA, TLAX.",1,0,1,0,0,0,
24/08/2018,COAH.,"SABINAS, COAH.",1,0,1,4,0,0,
24/08/2018,SIN.,"CHOIX, SIN.",0,1,1,0,0,0,
24/08/2018,COAH.,"MONCLOVA, COAH.",0,0,0,0,1,17,
24/08/2018,N.L.,"MELCHOR OCAMPO, N.L.",0,0,0,3,0,0,
24/08/2018,TAMPS.,"REYNOSA, TAMPS.",0,0,0,4,0,68,
24/08/2018,TAMPS.,"VICTORIA, TAMPS.",0,0,0,1,0,17,
24/08/2018,COAH.,"MONCLOVA, COAH.",0,0,0,0,2,0,
25/08/2018,MEX.,"CHIMALHUACAN, MEX.",7,4,11,3,0,11,
25/08/2018,MEX.,"TLALNEPANTLA DE BAZ, MEX.",7,1,8,0,0,261,
25/08/2018,TAMPS.,"REYNOSA, TAMPS.",5,0,5,0,0,0,
25/08/2018,TLAX.,"PANOTLA, TLAX.",1,2,3,0,0,0,
25/08/2018,MEX.,"ZACUALPAN, MEX.",1,1,2,0,0,1,
25/08/2018,N.L.,"MELCHOR OCAMPO, N.L.",1,0,1,5,0,0,
25/08/2018,B.C.S.,"MULEGÉ, B.C.S.",1,0,1,1,0,0,
25/08/2018,MEX.,"APAXCO, MEX.",1,0,1,0,0,0,
27/08/2018,TAMPS.,"NUEVO LAREDO, TAMPS.",8,1,9,4,4,255,
27/08/2018,ZAC.,"FRESNILLO, ZAC.",3,3,6,0,0,174,
27/08/2018,COAH.,"TORREÓN, COAH.",4,1,5,2,0,24,
27/08/2018,D.F.,"AZCAPOTZALCO, D.F.",4,1,5,0,1,156,
27/08/2018,COAH.,"SALTILLO, COAH.",2,1,3,1,2,480,
27/08/2018,MEX.,"IXTAPAN DE LA SAL, MEX.",1,2,3,1,0,0,
27/08/2018,MEX.,"TLALNEPANTLA DE BAZ, MEX.",1,2,3,0,0,34,
27/08/2018,MEX.,"CHIMALHUACAN, MEX.",2,1,3,0,0,0,
27/08/2018,B.C.,"TIJUANA, B.C.",2,0,2,0,0,0,
27/08/2018,COAH.,"PIEDRAS NEGRAS, COAH.",1,1,2,0,0,0,
27/08/2018,MEX.,"CHICOLOAPAN, MEX.",2,0,2,0,0,0,
27/08/2018,VER.,"TANTOYUCA, VER.",0,1,1,0,0,0,
27/08/2018,TLAX.,"TETLATLAHUCA, TLAX.",1,0,1,0,0,0,
27/08/2018,TLAX.,"SAN PABLO DEL MONTE, TLAX.",1,0,1,0,0,0,
27/08/2018,N.L.,"MELCHOR OCAMPO, N.L.",1,0,1,7,0,0,
28/08/2018,ZAC.,"ZAC., ZAC.",7,1,8,0,0,9,
28/08/2018,MEX.,"CHIMALHUACAN, MEX.",5,2,7,2,0,81,
28/08/2018,MEX.,"CHICOLOAPAN, MEX.",1,2,3,0,0,0,
28/08/2018,TAMPS.,"VICTORIA, TAMPS.",2,0,2,2,0,0,
28/08/2018,TAMPS.,"NUEVO LAREDO, TAMPS.",2,0,2,2,0,25,
28/08/2018,SIN.,"CHOIX, SIN.",2,0,2,0,0,0,
28/08/2018,VER.,"ALAMO, VER.",2,0,2,0,0,0,
28/08/2018,MEX.,"TLALNEPANTLA DE BAZ, MEX.",2,0,2,1,0,0,
28/08/2018,MEX.,"IXTAPAN DE LA SAL, MEX.",0,2,2,0,0,0,
28/08/2018,TLAX.,"SAN PABLO DEL MONTE, TLAX.",2,0,2,0,0,0,
28/08/2018,MOR.,"TEPOZTLAN, MOR.",2,0,2,45,0,6,
28/08/2018,B.C.,"MEXICALI, B.C.",0,1,1,0,0,0,
28/08/2018,COAH.,"TORREÓN, COAH.",0,1,1,0,0,0,
28/08/2018,COAH.,"FRANCISCO I. MADERO, COAH.",0,1,1,0,0,0,
28/08/2018,COAH.,"SALTILLO, COAH.",1,0,1,14,0,0,
28/08/2018,TAMPS.,"TAMPICO, TAMPS.",1,0,1,1,2,0,
28/08/2018,TAMPS.,"MIER, TAMPS.",1,0,1,0,0,81,
28/08/2018,D.F.,"AZCAPOTZALCO, D.F.",0,0,0,0,0,5300,
28/08/2018,COAH.,"SAN PEDRO, COAH.",0,0,0,0,0,81,
28/08/2018,TAMPS.,"MATAMOROS, TAMPS.",0,0,0,0,1,0,
28/08/2018,TAMPS.,"REYNOSA, TAMPS.",0,0,0,12,0,32,
28/08/2018,ZAC.,"FRESNILLO, ZAC.",0,0,0,25,0,0,
29/08/2018,ZAC.,"FRESNILLO, ZAC.",5,3,8,0,0,0,
29/08/2018,AGS.,"AGS., AGS.",3,2,5,0,0,0,
29/08/2018,MEX.,"TLALNEPANTLA DE BAZ, MEX.",3,1,4,0,0,6353,
29/08/2018,B.C.,"TIJUANA, B.C.",3,0,3,0,2,0,
29/08/2018,COAH.,"TORREÓN, COAH.",2,0,2,0,0,16,
29/08/2018,N.L.,"SANTA CATARINA, N.L.",1,1,2,0,0,0,
29/08/2018,TLAX.,"SAN PABLO DEL MONTE, TLAX.",1,1,2,0,0,0,
29/08/2018,COAH.,"PIEDRAS NEGRAS, COAH.",0,2,2,0,0,0,
29/08/2018,MEX.,"IXTAPAN DE LA SAL, MEX.",1,0,1,1,0,0,
29/08/2018,COAH.,"MONCLOVA, COAH.",1,0,1,0,0,0,
29/08/2018,N.L.,"APODACA, N.L.",0,0,0,10,0,0,
29/08/2018,MOR.,"TEPOZTLAN, MOR.",0,0,0,56,0,585,
30/08/2018,MEX.,"CHIMALHUACAN, MEX.",5,2,7,2,0,81,
30/08/2018,TLAX.,"SAN PABLO DEL MONTE, TLAX.",2,0,2,0,0,0,
30/08/2018,MEX.,"CHICOLOAPAN, MEX.",1,0,1,0,0,39,
30/08/2018,MEX.,"IXTAPAN DE LA SAL, MEX.",0,0,0,1,0,160,
30/08/2018,MEX.,"TLALNEPANTLA DE BAZ, MEX.",0,0,0,0,0,634,
31/08/2018,D.F.,"AZCAPOTZALCO, D.F.",21,0,21,0,0,37,
31/08/2018,SIN.,"CHOIX, SIN.",3,4,7,0,0,0,
31/08/2018,TLAX.,"PANOTLA, TLAX.",3,3,6,0,0,0,
31/08/2018,MEX.,"CHIMALHUACAN, MEX.",3,2,5,0,0,18228,
31/08/2018,TAMPS.,"ALTAMIRA, TAMPS.",3,1,4,0,0,0,
31/08/2018,AGS.,"AGS., AGS.",2,1,3,0,0,0,
31/08/2018,MEX.,"CHICOLOAPAN, MEX.",2,1,3,0,0,546,
31/08/2018,N.L.,"APODACA, N.L.",1,2,3,45,0,0,
31/08/2018,TAMPS.,"TAMPICO, TAMPS.",1,1,2,1,0,0,
31/08/2018,B.C.,"TIJUANA, B.C.",0,1,1,0,0,0,
31/08/2018,COAH.,"SALTILLO, COAH.",0,1,1,0,0,50,
31/08/2018,COAH.,"RAMOS ARIZPE, COAH.",1,0,1,0,1,0,
31/08/2018,COAH.,"MONCLOVA, COAH.",1,0,1,0,0,70,
31/08/2018,COAH.,"PIEDRAS NEGRAS, COAH.",0,1,1,3,0,300,
31/08/2018,TAMPS.,"MATAMOROS, TAMPS.",1,0,1,0,0,8,
31/08/2018,TAMPS.,"VICTORIA, TAMPS.",0,1,1,0,0,19,
31/08/2018,TAMPS.,"MIER, TAMPS.",0,1,1,0,0,458,
31/08/2018,DGO.,"SANTIAGO PAPASQUIARO, DGO.",0,1,1,0,0,0,
31/08/2018,MEX.,"TLALNEPANTLA DE BAZ, MEX.",1,0,1,0,0,309,
31/08/2018,MOR.,"TEPOZTLAN, MOR.",1,0,1,3,0,107,
31/08/2018,TAMPS.,"NUEVO LAREDO, TAMPS.",0,0,0,0,0,33,
01/09/2018,TLAX.,"SAN PABLO DEL MONTE, TLAX.",5,0,5,0,0,0,
01/09/2018,COAH.,"ACUÑA, COAH.",1,0,1,1,0,0,
01/09/2018,MEX.,"IXTAPAN DE LA SAL, MEX.",0,1,1,1,0,55,
01/09/2018,TLAX.,"TETLATLAHUCA, TLAX.",0,1,1,0,0,0,
01/09/2018,MEX.,"TLALNEPANTLA DE BAZ, MEX.",0,0,0,0,0,8398,
02/09/2018,TAMPS.,"MATAMOROS, TAMPS.",0,4,4,0,0,0,
02/09/2018,TAMPS.,"REYNOSA, TAMPS.",1,1,2,1,0,5,
03/09/2018,MEX.,"NEZAHUALCOYOTL, MEX.",4,3,7,3,0,79,
03/09/2018,B.C.,"TIJUANA, B.C.",3,2,5,0,0,0,
03/09/2018,MEX.,"TENANCINGO, MEX.",3,2,5,1,0,0,
03/09/2018,COAH.,"TORREÓN, COAH.",4,0,4,8,0,16,
03/09/2018,D.F.,"AZCAPOTZALCO, D.F.",3,0,3,0,0,3828,
03/09/2018,TAMPS.,"REYNOSA, TAMPS.",1,1,2,1,0,5,
03/09/2018,AGS.,"AGS., AGS.",2,0,2,0,0,0,
03/09/2018,COAH.,"MONCLOVA, COAH.",1,0,1,1,0,0,
03/09/2018,MEX.,"TOLUCA, MEX.",0,1,1,0,0,0,
03/09/2018,Q. ROO,"COZUMEL, Q. ROO",1,0,1,0,1,21,
03/09/2018,COAH.,"SAN PEDRO, COAH.",0,0,0,0,0,140,
04/09/2018,MEX.,"AMECAMECA, MEX.",4,2,6,1,0,0,
04/09/2018,D.F.,"AZCAPOTZALCO, D.F.",4,0,4,0,0,6739,
04/09/2018,MEX.,"NEZAHUALCOYOTL, MEX.",4,0,4,0,1,10600,
04/09/2018,B.C.,"TIJUANA, B.C.",2,1,3,0,0,0,
04/09/2018,B.C.,"MEXICALI, B.C.",1,1,2,0,0,0,
04/09/2018,VER.,"BOCA DEL RIO, VER.",2,0,2,0,0,93,
04/09/2018,B.C.,"TIJUANA, B.C.",1,0,1,0,0,0,
04/09/2018,B.C.,"TIJUANA, B.C.",0,1,1,0,0,0,
04/09/2018,AGS.,"AGS., AGS.",1,0,1,0,0,475,
04/09/2018,MEX.,"TOLUCA, MEX.",1,0,1,0,1,2863,
04/09/2018,MEX.,"SOYANIQUILPAN DE JUAREZ, MEX.",0,0,0,0,0,37,
04/09/2018,VER.,"VER., VER.",0,0,0,0,0,45,
05/09/2018,ZAC.,"FRESNILLO, ZAC.",3,3,6,0,0,50,
05/09/2018,MEX.,"AMECAMECA, MEX.",2,2,4,1,0,13,
05/09/2018,B.C.,"TIJUANA, B.C.",0,3,3,0,0,0,
05/09/2018,D.F.,"AZCAPOTZALCO, D.F.",3,0,3,0,0,83,
05/09/2018,MEX.,"NEZAHUALCOYOTL, MEX.",2,0,2,0,0,14,
05/09/2018,MEX.,"TOLUCA, MEX.",1,1,2,0,1,382,
05/09/2018,VER.,"XALAPA, VER.",0,2,2,0,0,0,
05/09/2018,COAH.,"SALTILLO, COAH.",0,1,1,0,0,0,
05/09/2018,VER.,"VER., VER.",1,0,1,0,0,100,
05/09/2018,N.L.,"LINARES, N.L.",0,1,1,0,0,0,
05/09/2018,TAMPS.,"VICTORIA, TAMPS.",1,0,1,1,0,0,
05/09/2018,TAMPS.,"REYNOSA, TAMPS.",1,0,1,7,0,124,
05/09/2018,ZAC.,"GUADALUPE, ZAC.",0,0,0,3,0,0,
05/09/2018,AGS.,"AGS., AGS.",0,0,0,0,0,41,
05/09/2018,VER.,"BOCA DEL RIO, VER.",0,0,0,1,0,233,
05/09/2018,TAMPS.,"EL MANTE, TAMPS.",0,0,0,0,0,103,
05/09/2018,TAMPS.,"MATAMOROS, TAMPS.",0,0,0,3,0,56,
05/09/2018,TAMPS.,"NUEVO LAREDO, TAMPS.",0,0,0,0,0,74,
06/09/2018,ZAC.,"FRESNILLO, ZAC.",8,0,8,0,0,0,
06/09/2018,MEX.,"TOLUCA, MEX.",6,1,7,6,0,1067,
06/09/2018,D.F.,"AZCAPOTZALCO, D.F.",3,1,4,0,0,173,
06/09/2018,COAH.,"PIEDRAS NEGRAS, COAH.",0,2,2,0,0,0,
06/09/2018,AGS.,"AGS., AGS.",1,1,2,1,0,0,
06/09/2018,COAH.,"TORREÓN, COAH.",0,1,1,0,0,0,
06/09/2018,COAH.,"RAMOS ARIZPE, COAH.",0,1,1,0,0,0,
06/09/2018,N.L.,"GUADALUPE, N.L.",0,1,1,0,0,0,
06/09/2018,ZAC.,"GUADALUPE, ZAC.",1,0,1,21,0,0,
06/09/2018,VER.,"VER., VER.",1,0,1,1,0,71,
06/09/2018,VER.,"MARTINEZ DE LA TORRE, VER.",1,0,1,0,0,0,
06/09/2018,MEX.,"NEZAHUALCOYOTL, MEX.",1,0,1,0,0,50,
06/09/2018,COAH.,"MATAMOROS, COAH.",0,0,0,3,0,195,
06/09/2018,COAH.,"SAN PEDRO, COAH.",0,0,0,0,0,222,
06/09/2018,COAH.,"SALTILLO, COAH.",0,0,0,1,0,53,
06/09/2018,VER.,"BOCA DEL RIO, VER.",0,0,0,0,0,95,
06/09/2018,MEX.,"AMECAMECA, MEX.",0,0,0,0,0,127,
07/09/2018,ZAC.,"FRESNILLO, ZAC.",6,1,7,7,0,0,
07/09/2018,MEX.,"NEZAHUALCOYOTL, MEX.",6,0,6,0,0,276,
07/09/2018,TAMPS.,"MATAMOROS, TAMPS.",2,2,4,1,0,467,
07/09/2018,AGS.,"AGS., AGS.",1,2,3,2,0,10,
07/09/2018,TAMPS.,"VICTORIA, TAMPS.",2,0,2,2,0,10,
07/09/2018,MEX.,"TOLUCA, MEX.",1,1,2,0,0,3855,
07/09/2018,VER.,"VER., VER.",1,1,2,10,0,279,
07/09/2018,MEX.,"AMECAMECA, MEX.",2,0,2,0,0,49,
07/09/2018,COAH.,"SAN PEDRO, COAH.",1,0,1,0,0,0,
07/09/2018,COAH.,"ACUÑA, COAH.",0,1,1,0,0,0,
07/09/2018,VER.,"BOCA DEL RIO, VER.",1,0,1,0,0,0,
07/09/2018,TAMPS.,"TAMPICO, TAMPS.",0,0,0,0,0,94,
07/09/2018,MEX.,"SOYANIQUILPAN DE JUAREZ, MEX.",0,0,0,0,1,6064,
07/09/2018,VER.,"XALAPA, VER.",0,0,0,3,0,266,
07/09/2018,Q. ROO,"COZUMEL, Q. ROO",0,0,0,0,0,17,
07/09/2018,N.L.,"GUADALUPE, N.L.",0,0,0,11,0,345,
08/09/2018,MEX.,"NEZAHUALCOYOTL, MEX.",5,2,7,1,5,783,
08/09/2018,TAMPS.,"REYNOSA, TAMPS.",3,0,3,3,0,0,
08/09/2018,B.C.,"MEXICALI, B.C.",0,3,3,0,0,0,
08/09/2018,VER.,"XALAPA, VER.",2,0,2,12,0,35,
08/09/2018,B.C.,"TIJUANA, B.C.",2,0,2,0,0,0,
08/09/2018,MOR.,"TEPOZTLAN, MOR.",1,0,1,0,0,0,
08/09/2018,VER.,"VER., VER.",1,0,1,0,0,273,
08/09/2018,VER.,"BOCA DEL RIO, VER.",1,0,1,0,0,0,
08/09/2018,MEX.,"AMECAMECA, MEX.",0,1,1,0,0,1044,
08/09/2018,COAH.,"MONCLOVA, COAH.",0,0,0,3,3,170,
09/09/2018,MEX.,"SOYANIQUILPAN DE JUAREZ, MEX.",4,0,4,0,0,0,
09/09/2018,MEX.,"TOLUCA, MEX.",1,0,1,1,0,0,
10/09/2018,D.F.,"XOCHIMILCO, D.F.",6,1,7,0,0,114,
10/09/2018,VER.,"VER., VER.",5,1,6,1,0,754,
10/09/2018,B.C.,"TIJUANA, B.C.",0,3,3,0,0,0,
10/09/2018,ZAC.,"FRESNILLO, ZAC.",2,1,3,0,0,2,
10/09/2018,AGS.,"AGS., AGS.",3,0,3,4,0,11,
10/09/2018,MOR.,"CUERNAVACA, MOR.",2,0,2,0,0,172,
10/09/2018,B.C.,"TIJUANA, B.C.",0,1,1,0,0,0,
10/09/2018,COAH.,"TORREÓN, COAH.",0,1,1,0,0,57,
10/09/2018,VER.,"BOCA DEL RIO, VER.",1,0,1,5,0,85,
10/09/2018,COAH.,"MONCLOVA, COAH.",0,0,0,0,0,249,
10/09/2018,VER.,"XALAPA, VER.",0,0,0,0,0,26,
11/09/2018,TAMPS.,"CIUDAD MADERO, TAMPS.",4,0,4,1,0,113,
11/09/2018,MOR.,"CUERNAVACA, MOR.",2,0,2,2,0,0,
11/09/2018,COAH.,"TORREÓN, COAH.",1,1,2,0,0,0,
11/09/2018,ZAC.,"FRESNILLO, ZAC.",2,0,2,0,0,239,
11/09/2018,B.C.,"TIJUANA, B.C.",1,0,1,0,0,0,
11/09/2018,N.L.,"LOS RAMONES, N.L.",1,0,1,0,0,6000,
11/09/2018,QRO.,"PEÑAMILLER, QRO.",1,0,1,0,0,0,
11/09/2018,VER.,"BOCA DEL RIO, VER.",1,0,1,2,0,106,
11/09/2018,MOR.,"TEPOZTLAN, MOR.",0,1,1,0,0,0,
11/09/2018,ZAC.,"GUADALUPE, ZAC.",1,0,1,0,0,0,
11/09/2018,TAMPS.,"ALTAMIRA, TAMPS.",1,0,1,0,0,0,
11/09/2018,TAMPS.,"MATAMOROS, TAMPS.",0,1,1,5,0,22,
11/09/2018,N.L.,"GUADALUPE, N.L.",0,0,0,12,0,130,
11/09/2018,VER.,"XALAPA, VER.",0,0,0,6,0,23,
11/09/2018,VER.,"VER., VER.",0,0,0,0,0,72,
11/09/2018,VER.,"MARTINEZ DE LA TORRE, VER.",0,0,0,2,0,44,
12/09/2018,D.F.,"XOCHIMILCO, D.F.",5,1,6,0,0,234,
12/09/2018,AGS.,"AGS., AGS.",4,0,4,0,0,213,
12/09/2018,MEX.,"SOYANIQUILPAN DE JUAREZ, MEX.",4,0,4,0,0,0,
12/09/2018,MEX.,"TOLUCA, MEX.",1,3,4,1,0,0,
12/09/2018,MOR.,"TEPOZTLAN, MOR.",1,1,2,0,0,21,
12/09/2018,MOR.,"CUERNAVACA, MOR.",2,0,2,0,7,751,
12/09/2018,B.C.,"TIJUANA, B.C.",0,1,1,0,0,0,
12/09/2018,COAH.,"PIEDRAS NEGRAS, COAH.",1,0,1,0,0,600,
12/09/2018,COAH.,"MÚZQUIZ, COAH.",0,1,1,0,0,0,
12/09/2018,VER.,"VER., VER.",0,1,1,2,0,881,
12/09/2018,COAH.,"MONCLOVA, COAH.",0,0,0,0,2,119,
12/09/2018,TAMPS.,"CIUDAD MADERO, TAMPS.",0,0,0,0,1,0,
12/09/2018,VER.,"BOCA DEL RIO, VER.",0,0,0,0,1,0,
13/09/2018,D.F.,"XOCHIMILCO, D.F.",2,2,4,0,0,8907,
13/09/2018,TAMPS.,"VICTORIA, TAMPS.",2,0,2,0,0,0,
13/09/2018,MOR.,"CUERNAVACA, MOR.",1,0,1,0,0,63,
13/09/2018,MOR.,"EMILIANO ZAPATA, MOR.",1,0,1,0,0,170,
13/09/2018,TAMPS.,"MATAMOROS, TAMPS.",1,0,1,0,0,0,
13/09/2018,TAMPS.,"NUEVO LAREDO, TAMPS.",1,0,1,1,0,7,
13/09/2018,ZAC.,"FRESNILLO, ZAC.",0,0,0,6,0,0,
13/09/2018,TAMPS.,"REYNOSA, TAMPS.",0,0,0,16,0,7,
14/09/2018,MOR.,"EMILIANO ZAPATA, MOR.",4,0,4,5,4,198,
14/09/2018,D.F.,"XOCHIMILCO, D.F.",1,1,2,0,0,0,
14/09/2018,B.C.,"TIJUANA, B.C.",0,2,2,0,0,0,
14/09/2018,ZAC.,"GUADALUPE, ZAC.",0,2,2,0,0,0,
14/09/2018,COAH.,"PIEDRAS NEGRAS, COAH.",1,0,1,6,0,154,
14/09/2018,N.L.,"LOS RAMONES, N.L.",1,0,1,0,0,0,
14/09/2018,TAMPS.,"CIUDAD MADERO, TAMPS.",1,0,1,0,0,0,
14/09/2018,MOR.,"CUERNAVACA, MOR.",0,1,1,0,0,50,
14/09/2018,TAMPS.,"MATAMOROS, TAMPS.",0,0,0,1,0,26,
14/09/2018,ZAC.,"FRESNILLO, ZAC.",0,0,0,6,0,0,
14/09/2018,VER.,"VER., VER.",0,0,0,3,0,633,
17/09/2018,MEX.,"TULTEPEC, MEX.",6,0,6,0,0,37,
17/09/2018,MEX.,"NEZAHUALCOYOTL, MEX.",4,0,4,0,0,0,
17/09/2018,MEX.,"TOLUCA, MEX.",2,0,2,1,0,3546,
17/09/2018,CHIH.,"DELICIAS, CHIH.",1,1,2,0,0,50,
17/09/2018,N.L.,"LOS RAMONES, N.L.",1,0,1,0,0,1000,
17/09/2018,AGS.,"AGS., AGS.",1,0,1,4,0,121,
17/09/2018,MOR.,"CUERNAVACA, MOR.",0,1,1,8,0,276,
17/09/2018,TAB.,"HUIMANGUILLO, TAB.",0,0,0,0,1,0,
18/09/2018,D.F.,"XOCHIMILCO, D.F.",8,1,9,0,0,0,
18/09/2018,MEX.,"NEZAHUALCOYOTL, MEX.",5,2,7,0,2,82,
18/09/2018,ZAC.,"GUADALUPE, ZAC.",2,1,3,0,0,0,
18/09/2018,ZAC.,"FRESNILLO, ZAC.",3,0,3,0,0,20,
18/09/2018,AGS.,"AGS., AGS.",3,0,3,3,0,0,
18/09/2018,PUE.,"CHIAUTZINGO, PUE.",1,2,3,0,0,0,
18/09/2018,MEX.,"TOLUCA, MEX.",2,0,2,0,0,5,
18/09/2018,COAH.,"PIEDRAS NEGRAS, COAH.",0,1,1,5,0,0,
18/09/2018,ZAC.,"ZAC., ZAC.",0,1,1,0,0,0,
18/09/2018,MEX.,"SAN SIMON DE GRO., MEX.",0,1,1,0,0,0,
18/09/2018,VER.,"XALAPA, VER.",1,0,1,0,0,0,
18/09/2018,TAMPS.,"ALTAMIRA, TAMPS.",0,0,0,0,0,47,
18/09/2018,MOR.,"CUERNAVACA, MOR.",0,0,0,25,0,210,
19/09/2018,MEX.,"TOLUCA, MEX.",4,1,5,2,0,7196,
19/09/2018,MEX.,"TULTEPEC, MEX.",2,2,4,0,0,0,
19/09/2018,MEX.,"NEZAHUALCOYOTL, MEX.",3,0,3,0,0,200,
19/09/2018,MEX.,"SAN SIMON DE GRO., MEX.",1,0,1,0,0,0,
19/09/2018,AGS.,"AGS., AGS.",1,0,1,2,0,59,
20/09/2018,D.F.,"XOCHIMILCO, D.F.",11,0,11,0,0,1256,
20/09/2018,MEX.,"NEZAHUALCOYOTL, MEX.",7,1,8,0,1,26,
20/09/2018,ZAC.,"FRESNILLO, ZAC.",4,2,6,0,0,0,
20/09/2018,AGS.,"AGS., AGS.",5,0,5,0,0,35,
20/09/2018,COAH.,"TORREÓN, COAH.",1,2,3,0,0,16,
20/09/2018,ZAC.,"GUADALUPE, ZAC.",2,0,2,2,0,14,
20/09/2018,MOR.,"TETELA DEL VOLCAN, MOR.",0,2,2,0,0,0,
20/09/2018,MEX.,"TULTEPEC, MEX.",1,0,1,0,0,46,
20/09/2018,ZAC.,"ZAC., ZAC.",0,1,1,0,0,0,
20/09/2018,COAH.,"MONCLOVA, COAH.",0,1,1,0,0,0,
20/09/2018,COAH.,"PIEDRAS NEGRAS, COAH.",0,1,1,0,0,0,
20/09/2018,COAH.,"ACUÑA, COAH.",0,1,1,0,0,0,
20/09/2018,MEX.,"SAN SIMON DE GRO., MEX.",0,1,1,0,0,0,
20/09/2018,B.C.,"MEXICALI, B.C.",1,0,1,0,0,0,
20/09/2018,COAH.,"RAMOS ARIZPE, COAH.",0,0,0,2,0,0,
20/09/2018,MEX.,"TOLUCA, MEX.",0,0,0,0,0,4350,
21/09/2018,D.F.,"XOCHIMILCO, D.F.",8,2,10,0,0,1836,
21/09/2018,N.L.,"LOS RAMONES, N.L.",2,2,4,0,0,35,
21/09/2018,COAH.,"TORREÓN, COAH.",3,0,3,0,0,84,
21/09/2018,AGS.,"AGS., AGS.",3,0,3,4,0,10,
21/09/2018,MOR.,"TETELA DEL VOLCAN, MOR.",1,1,2,0,0,0,
21/09/2018,MEX.,"TOLUCA, MEX.",0,1,1,0,0,395,
21/09/2018,MEX.,"SAN SIMON DE GRO., MEX.",0,1,1,0,0,0,
21/09/2018,MOR.,"TEPOZTLAN, MOR.",1,0,1,0,0,0,
21/09/2018,VER.,"VER., VER.",1,0,1,0,0,0,
22/09/2018,MEX.,"TOLUCA, MEX.",5,0,5,4,0,3608,
22/09/2018,MOR.,"CUERNAVACA, MOR.",5,0,5,0,0,653,
22/09/2018,MEX.,"NEZAHUALCOYOTL, MEX.",3,0,3,2,0,901,
22/09/2018,B.C.,"MEXICALI, B.C.",1,1,2,0,0,0,
22/09/2018,S.L.P.,"SAN LUIS POTOSI, S.L.P.",2,0,2,0,0,0,
22/09/2018,COAH.,"PIEDRAS NEGRAS, COAH.",1,0,1,0,0,400,
22/09/2018,TAMPS.,"MATAMOROS, TAMPS.",0,1,1,1,0,778,
22/09/2018,MEX.,"SAN SIMON DE GRO., MEX.",0,1,1,0,0,0,
22/09/2018,MOR.,"EMILIANO ZAPATA, MOR.",0,1,1,41,0,210,
22/09/2018,COAH.,"MONCLOVA, COAH.",0,0,0,0,0,111,
22/09/2018,MEX.,"TULTEPEC, MEX.",0,0,0,0,0,54,
22/09/2018,MOR.,"TETELA DEL VOLCAN, MOR.",0,0,0,25,0,0,
23/09/2018,S.L.P.,"SAN LUIS POTOSI, S.L.P.",7,0,7,1,0,0,
23/09/2018,N.L.,"MELCHOR OCAMPO, N.L.",2,0,2,0,0,0,
23/09/2018,TAB.,"JONUTA, TAB.",1,0,1,0,0,0,
23/09/2018,S.L.P.,"CIUDAD VALLES, S.L.P.",1,0,1,5,4,0,
24/09/2018,MEX.,"RAYON, MEX.",6,0,6,0,0,0,
24/09/2018,MEX.,"CHAPA DE MOTA, MEX.",2,1,3,0,0,0,
24/09/2018,COAH.,"ACUÑA, COAH.",3,0,3,0,0,122,
24/09/2018,MOR.,"CUERNAVACA, MOR.",1,1,2,0,0,1472,
24/09/2018,MEX.,"ECATEPEC DE MOR., MEX.",1,0,1,0,7,240,
24/09/2018,N.L.,"MELCHOR OCAMPO, N.L.",1,0,1,0,0,0,
24/09/2018,COAH.,"FRANCISCO I. MADERO, COAH.",1,0,1,0,0,0,
24/09/2018,COAH.,"PIEDRAS NEGRAS, COAH.",0,1,1,4,0,300,
24/09/2018,COAH.,"FRANCISCO I. MADERO, COAH.",1,0,1,0,0,65,
24/09/2018,COAH.,"TORREÓN, COAH.",0,0,0,0,0,65,
24/09/2018,COAH.,"MONCLOVA, COAH.",0,0,0,0,1,0,
25/09/2018,MEX.,"IXTAPALUCA, MEX.",11,2,13,36,0,0,
25/09/2018,MEX.,"RAYON, MEX.",2,0,2,1,0,0,
25/09/2018,MEX.,"ECATEPEC DE MOR., MEX.",2,0,2,0,1,5058,
25/09/2018,MEX.,"CHAPA DE MOTA, MEX.",0,1,1,0,0,0,
26/09/2018,COAH.,"TORREÓN, COAH.",2,2,4,0,0,19,
26/09/2018,MEX.,"IXTAPALUCA, MEX.",4,0,4,0,1,546,
26/09/2018,MEX.,"ECATEPEC DE MOR., MEX.",3,0,3,0,0,11,
26/09/2018,VER.,"POZA RICA DE HGO., VER.",0,2,2,0,0,92,
26/09/2018,COAH.,"FRANCISCO I. MADERO, COAH.",1,0,1,0,0,0,
26/09/2018,COAH.,"SALTILLO, COAH.",1,0,1,0,0,0,
26/09/2018,COAH.,"MÚZQUIZ, COAH.",0,1,1,0,0,0,
26/09/2018,TAMPS.,"ALTAMIRA, TAMPS.",1,0,1,0,0,0,
26/09/2018,S.L.P.,"SAN LUIS POTOSI, S.L.P.",0,1,1,0,0,0,
26/09/2018,MEX.,"CHAPA DE MOTA, MEX.",1,0,1,0,0,0,
26/09/2018,MOR.,"CUERNAVACA, MOR.",1,0,1,2,0,885,
26/09/2018,COAH.,"PIEDRAS NEGRAS, COAH.",0,0,0,0,0,450,
26/09/2018,AGS.,"AGS., AGS.",0,0,0,1,0,10,
26/09/2018,MEX.,"RAYON, MEX.",0,0,0,0,0,3112,
26/09/2018,MOR.,"TEPOZTLAN, MOR.",0,0,0,20,0,207,
27/09/2018,MEX.,"ECATEPEC DE MOR., MEX.",3,0,3,0,0,8,
27/09/2018,MEX.,"RAYON, MEX.",1,1,2,0,0,0,
27/09/2018,MEX.,"CHAPA DE MOTA, MEX.",1,0,1,0,0,0,
27/09/2018,MEX.,"IXTAPALUCA, MEX.",1,0,1,0,2,51,
28/09/2018,MEX.,"ECATEPEC DE MOR., MEX.",2,1,3,0,0,0,
28/09/2018,VER.,"POZA RICA DE HGO., VER.",0,2,2,0,0,92,
28/09/2018,MOR.,"CUERNAVACA, MOR.",1,0,1,1,0,800,
28/09/2018,B.C.,"TIJUANA, B.C.",0,1,1,0,0,0,
28/09/2018,MEX.,"IXTAPALUCA, MEX.",1,0,1,0,0,4,
28/09/2018,MEX.,"RAYON, MEX.",0,0,0,0,0,2658,
28/09/2018,AGS.,"AGS., AGS.",0,0,0,2,0,6,
28/09/2018,COAH.,"PIEDRAS NEGRAS, COAH.",0,0,0,5,0,797,
29/09/2018,MEX.,"IXTAPALUCA, MEX.",2,1,3,0,0,50,
29/09/2018,COAH.,"PIEDRAS NEGRAS, COAH.",0,1,1,0,0,0,
29/09/2018,MEX.,"RAYON, MEX.",0,0,0,0,0,2932,
29/09/2018,COAH.,"MÚZQUIZ, COAH.",0,0,0,1,0,0,
01/10/2018,S.L.P.,"SAN LUIS POTOSI, S.L.P.",5,0,5,0,0,0,
01/10/2018,N.L.,"MELCHOR OCAMPO, N.L.",2,2,4,0,0,0,
01/10/2018,COAH.,"TORREÓN, COAH.",3,0,3,0,0,0,
01/10/2018,AGS.,"AGS., AGS.",2,0,2,0,0,0,
01/10/2018,MEX.,"JILOTEPEC, MEX.",0,1,1,0,0,0,
01/10/2018,MEX.,"RAYON, MEX.",1,0,1,0,0,0,
01/10/2018,MOR.,"EMILIANO ZAPATA, MOR.",1,0,1,1,1,0,
01/10/2018,MEX.,"IXTAPALUCA, MEX.",1,0,1,0,0,46,
01/10/2018,COAH.,"SALTILLO, COAH.",0,0,0,2,0,112,
03/10/2018,D.F.,"MIGUEL HGO., D.F.",7,2,9,0,0,426,
03/10/2018,MEX.,"JILOTEPEC, MEX.",4,0,4,0,0,0,
03/10/2018,N.L.,"MELCHOR OCAMPO, N.L.",2,2,4,0,0,0,
03/10/2018,MEX.,"IXTAPALUCA, MEX.",3,1,4,0,7,0,
03/10/2018,DGO.,"GOMEZ PALACIO, DGO.",1,1,2,0,0,0,
03/10/2018,GTO.,"LEON, GTO.",2,0,2,0,0,0,
03/10/2018,MEX.,"TOLUCA, MEX.",1,0,1,1,0,122,
03/10/2018,COAH.,"SALTILLO, COAH.",1,0,1,1,0,11,
03/10/2018,MEX.,"IXTAPALUCA, MEX.",0,1,1,0,0,0,
03/10/2018,MEX.,"ECATEPEC DE MOR., MEX.",1,0,1,0,0,0,
03/10/2018,COAH.,"PIEDRAS NEGRAS, COAH.",0,0,0,0,0,581,
03/10/2018,MOR.,"TEPOZTLAN, MOR.",0,0,0,39,0,0,
03/10/2018,MOR.,"CUERNAVACA, MOR.",0,0,0,0,0,511,
04/10/2018,D.F.,"MIGUEL HGO., D.F.",5,0,5,0,3,134,
04/10/2018,ZAC.,"FRESNILLO, ZAC.",3,0,3,0,0,0,
04/10/2018,GTO.,"LEON, GTO.",2,1,3,0,2,0,
04/10/2018,AGS.,"AGS., AGS.",2,0,2,0,0,3,
04/10/2018,ZAC.,"GUADALUPE, ZAC.",1,0,1,9,0,0,
04/10/2018,S.L.P.,"SAN LUIS POTOSI, S.L.P.",1,0,1,0,0,0,
04/10/2018,MEX.,"LERMA, MEX.",1,0,1,0,0,5197,
04/10/2018,MEX.,"IXTAPALUCA, MEX.",1,0,1,0,0,295,
04/10/2018,COAH.,"RAMOS ARIZPE, COAH.",0,0,0,0,0,108,
04/10/2018,COAH.,"PIEDRAS NEGRAS, COAH.",0,0,0,4,0,503,
04/10/2018,ZAC.,"ZAC., ZAC.",0,0,0,21,0,0,
04/10/2018,MEX.,"IXTAPALUCA, MEX.",0,0,0,0,0,2495,
05/10/2018,GTO.,"LEON, GTO.",12,13,25,0,0,0,
05/10/2018,MEX.,"LERMA, MEX.",1,1,2,0,0,4124,
05/10/2018,AGS.,"AGS., AGS.",1,1,2,0,0,513,
05/10/2018,S.L.P.,"MATEHUALA, S.L.P.",1,0,1,0,0,0,
05/10/2018,MEX.,"IXTAPALUCA, MEX.",1,0,1,0,0,206,
05/10/2018,MEX.,"ECATEPEC DE MOR., MEX.",0,1,1,0,0,5724,
06/10/2018,TAB.,"TENOSIQUE, TAB.",2,1,3,0,0,71,
06/10/2018,S.L.P.,"SAN LUIS POTOSI, S.L.P.",2,0,2,0,0,0,
06/10/2018,MEX.,"LERMA, MEX.",1,1,2,1,0,0,
06/10/2018,MEX.,"IXTAPALUCA, MEX.",2,0,2,2,0,50,
07/10/2018,S.L.P.,"SAN LUIS POTOSI, S.L.P.",1,0,1,0,0,0,
08/10/2018,GTO.,"LEON, GTO.",5,2,7,0,6,0,
08/10/2018,MEX.,"NAUCALPAN DE JUAREZ, MEX.",4,0,4,3,0,3,
08/10/2018,MEX.,"COACALCO DE BERRIOZABAL, MEX.",3,0,3,0,0,296,
08/10/2018,COAH.,"SAN PEDRO, COAH.",1,1,2,0,0,0,
08/10/2018,MEX.,"VILLA VICTORIA, MEX.",2,0,2,0,0,2,
08/10/2018,S.L.P.,"SAN LUIS POTOSI, S.L.P.",2,0,2,0,0,0,
08/10/2018,D.F.,"MIGUEL HGO., D.F.",1,0,1,0,1,366,
08/10/2018,AGS.,"AGS., AGS.",1,0,1,0,0,518,
08/10/2018,B.C.,"MEXICALI, B.C.",0,0,0,0,1,0,
08/10/2018,COAH.,"MÚZQUIZ, COAH.",0,0,0,20,0,0,
08/10/2018,ZAC.,"GUADALUPE, ZAC.",0,0,0,2,0,93,
09/10/2018,GTO.,"LEON, GTO.",7,3,10,0,2,1,
09/10/2018,MEX.,"NAUCALPAN DE JUAREZ, MEX.",5,1,6,1,0,28,
09/10/2018,D.F.,"MIGUEL HGO., D.F.",2,2,4,0,0,1099,
09/10/2018,ZAC.,"GUADALUPE, ZAC.",3,0,3,6,0,41,
09/10/2018,AGS.,"AGS., AGS.",3,0,3,0,0,0,
09/10/2018,COAH.,"PIEDRAS NEGRAS, COAH.",1,1,2,0,0,0,
09/10/2018,S.L.P.,"SAN LUIS POTOSI, S.L.P.",1,1,2,5,0,919,
09/10/2018,B.C.,"TIJUANA, B.C.",1,0,1,0,0,0,
09/10/2018,COAH.,"RAMOS ARIZPE, COAH.",1,0,1,1,0,247,
09/10/2018,DGO.,"GOMEZ PALACIO, DGO.",1,0,1,0,0,0,
09/10/2018,SIN.,"ROSARIO, SIN.",0,1,1,0,0,0,
09/10/2018,MEX.,"COACALCO DE BERRIOZABAL, MEX.",1,0,1,0,0,50,
09/10/2018,B.C.,"MEXICALI, B.C.",0,0,0,0,1,0,
09/10/2018,COAH.,"MÚZQUIZ, COAH.",0,0,0,1,0,0,
10/10/2018,GTO.,"LEON, GTO.",9,3,12,0,0,0,
10/10/2018,D.F.,"MIGUEL HGO., D.F.",2,1,3,0,0,2261,
10/10/2018,MEX.,"NAUCALPAN DE JUAREZ, MEX.",1,2,3,1,0,0,
10/10/2018,N.L.,"MELCHOR OCAMPO, N.L.",2,1,3,0,0,20,
10/10/2018,B.C.,"TIJUANA, B.C.",0,2,2,0,0,0,
10/10/2018,COAH.,"PIEDRAS NEGRAS, COAH.",0,2,2,0,0,300,
10/10/2018,COAH.,"SAN PEDRO, COAH.",0,1,1,0,0,0,
10/10/2018,COAH.,"ACUÑA, COAH.",0,1,1,0,0,0,
10/10/2018,S.L.P.,"SAN LUIS POTOSI, S.L.P.",0,1,1,0,0,0,
10/10/2018,MEX.,"TEPOTZOTLAN, MEX.",0,1,1,0,0,109,
10/10/2018,MEX.,"COACALCO DE BERRIOZABAL, MEX.",1,0,1,0,0,75,
10/10/2018,COAH.,"TORREÓN, COAH.",0,0,0,3,0,0,
10/10/2018,S.L.P.,"CIUDAD VALLES, S.L.P.",0,0,0,0,0,40,
10/10/2018,AGS.,"AGS., AGS.",0,0,0,1,0,0,
11/10/2018,GTO.,"LEON, GTO.",6,0,6,0,5,0,
11/10/2018,AGS.,"AGS., AGS.",2,1,3,1,0,0,
11/10/2018,MEX.,"TEPOTZOTLAN, MEX.",1,1,2,1,0,1818,
11/10/2018,S.L.P.,"SAN LUIS POTOSI, S.L.P.",1,0,1,0,0,0,
11/10/2018,S.L.P.,"MATEHUALA, S.L.P.",1,0,1,0,0,0,
11/10/2018,MEX.,"COACALCO DE BERRIOZABAL, MEX.",0,0,0,0,0,268,
12/10/2018,GTO.,"LEON, GTO.",12,2,14,0,1,0,
12/10/2018,D.F.,"MIGUEL HGO., D.F.",5,2,7,0,0,676,
12/10/2018,MEX.,"NAUCALPAN DE JUAREZ, MEX.",4,0,4,3,0,498,
12/10/2018,MEX.,"TEPOTZOTLAN, MEX.",2,0,2,1,0,3763,
12/10/2018,COAH.,"PIEDRAS NEGRAS, COAH.",0,1,1,0,0,485,
12/10/2018,S.L.P.,"EBANO, S.L.P.",1,0,1,0,0,53,
12/10/2018,S.L.P.,"SAN LUIS POTOSI, S.L.P.",1,0,1,0,0,0,
12/10/2018,S.L.P.,"SAN LUIS POTOSI, S.L.P.",1,0,1,0,0,0,
12/10/2018,B.C.,"TIJUANA, B.C.",0,0,0,0,1,0,
13/10/2018,N.L.,"MELCHOR OCAMPO, N.L.",7,0,7,0,0,0,
13/10/2018,B.C.,"TIJUANA, B.C.",1,0,1,0,0,0,
13/10/2018,S.L.P.,"EBANO, S.L.P.",1,0,1,1,0,0,
13/10/2018,MEX.,"NAUCALPAN DE JUAREZ, MEX.",1,0,1,0,0,2110,
13/10/2018,COAH.,"PIEDRAS NEGRAS, COAH.",0,0,0,0,0,250,
13/10/2018,MEX.,"VILLA VICTORIA, MEX.",0,0,0,0,0,899,
14/10/2018,S.L.P.,"SOLEDAD DE GRACIANO SANCHEZ, S.L.P.",1,0,1,0,0,0,
14/10/2018,N.L.,"MELCHOR OCAMPO, N.L.",0,0,0,10,0,0,
15/10/2018,GTO.,"LEON, GTO.",8,5,13,0,4,0,
15/10/2018,D.F.,"VENUSTIANO CARRANZA, D.F.",7,0,7,0,0,402,
15/10/2018,B.C.,"TIJUANA, B.C.",0,2,2,0,0,0,
15/10/2018,S.L.P.,"SAN LUIS POTOSI, S.L.P.",1,1,2,0,0,0,
15/10/2018,S.L.P.,"MATEHUALA, S.L.P.",2,0,2,0,0,0,
15/10/2018,S.L.P.,"EBANO, S.L.P.",1,0,1,0,0,0,
15/10/2018,COAH.,"MÚZQUIZ, COAH.",0,0,0,5,0,350,
15/10/2018,S.L.P.,"CIUDAD VALLES, S.L.P.",0,0,0,0,1,0,
15/10/2018,MOR.,"TEPOZTLAN, MOR.",0,0,0,27,0,138,
15/10/2018,MEX.,"HUEHUETOCA, MEX.",0,0,0,0,0,63,
16/10/2018,GTO.,"LEON, GTO.",19,8,27,0,0,0,
16/10/2018,MEX.,"HUEHUETOCA, MEX.",4,1,5,0,0,36,
16/10/2018,D.F.,"VENUSTIANO CARRANZA, D.F.",4,1,5,0,0,76,
16/10/2018,MEX.,"NAUCALPAN DE JUAREZ, MEX.",1,1,2,0,0,25,
16/10/2018,DGO.,"GOMEZ PALACIO, DGO.",2,0,2,0,0,0,
16/10/2018,COAH.,"PIEDRAS NEGRAS, COAH.",2,0,2,0,0,0,
16/10/2018,MEX.,"ATIZAPAN, MEX.",1,0,1,0,0,0,
16/10/2018,COAH.,"SALTILLO, COAH.",1,0,1,0,0,554,
16/10/2018,B.C.,"TIJUANA, B.C.",0,1,1,0,0,0,
16/10/2018,S.L.P.,"CIUDAD VALLES, S.L.P.",0,0,0,2,0,110,
16/10/2018,AGS.,"AGS., AGS.",0,0,0,5,0,14,
17/10/2018,GTO.,"LEON, GTO.",21,4,25,0,1,0,
17/10/2018,MEX.,"HUEHUETOCA, MEX.",2,1,3,0,0,37,
17/10/2018,MEX.,"NAUCALPAN DE JUAREZ, MEX.",2,0,2,10,0,10,
17/10/2018,MEX.,"ATIZAPAN, MEX.",2,0,2,141,0,0,
17/10/2018,SIN.,"ROSARIO, SIN.",2,0,2,0,0,0,
17/10/2018,AGS.,"AGS., AGS.",1,0,1,0,0,50,
17/10/2018,S.L.P.,"SAN LUIS POTOSI, S.L.P.",1,0,1,0,0,0,
17/10/2018,COAH.,"PIEDRAS NEGRAS, COAH.",0,0,0,3,0,0,
18/10/2018,D.F.,"VENUSTIANO CARRANZA, D.F.",5,0,5,0,0,1201,
18/10/2018,GTO.,"LEON, GTO.",4,1,5,0,3,0,
18/10/2018,MEX.,"ATIZAPAN, MEX.",2,1,3,0,0,91,
18/10/2018,MEX.,"HUEHUETOCA, MEX.",1,1,2,0,11,0,
18/10/2018,S.L.P.,"MATEHUALA, S.L.P.",1,1,2,0,0,0,
18/10/2018,SIN.,"ROSARIO, SIN.",0,2,2,0,0,0,
18/10/2018,MEX.,"NAUCALPAN DE JUAREZ, MEX.",1,0,1,1,0,2389,
18/10/2018,AGS.,"AGS., AGS.",1,0,1,1,0,721,
18/10/2018,COAH.,"SALTILLO, COAH.",0,1,1,0,0,0,
18/10/2018,COAH.,"PIEDRAS NEGRAS, COAH.",0,1,1,1,0,25,
18/10/2018,COAH.,"ACUÑA, COAH.",1,0,1,0,0,455,
19/10/2018,GTO.,"LEON, GTO.",11,3,14,0,0,0,
19/10/2018,CHIH.,"JUÁREZ, CHIH.",8,6,14,8,0,781,
19/10/2018,MEX.,"ATIZAPAN, MEX.",6,2,8,0,0,0,
19/10/2018,AGS.,"AGS., AGS.",5,1,6,15,0,457,
19/10/2018,MEX.,"NAUCALPAN DE JUAREZ, MEX.",3,0,3,1,0,67,
19/10/2018,COAH.,"ACUÑA, COAH.",3,0,3,0,0,0,
19/10/2018,D.F.,"VENUSTIANO CARRANZA, D.F.",2,1,3,0,0,3591,
19/10/2018,B.C.,"TIJUANA, B.C.",0,2,2,0,0,0,
19/10/2018,MEX.,"COACALCO DE BERRIOZABAL, MEX.",0,1,1,0,0,44,
19/10/2018,COAH.,"MATAMOROS, COAH.",1,0,1,2,0,0,
19/10/2018,COAH.,"PIEDRAS NEGRAS, COAH.",0,1,1,0,0,0,
19/10/2018,S.L.P.,"SAN LUIS POTOSI, S.L.P.",1,0,1,6,0,0,
19/10/2018,MEX.,"HUEHUETOCA, MEX.",0,0,0,0,0,104,
19/10/2018,ZAC.,"GUADALUPE, ZAC.",0,0,0,0,0,200,
19/10/2018,ZAC.,"FRESNILLO, ZAC.",0,0,0,0,0,755,
20/10/2018,MEX.,"NAUCALPAN DE JUAREZ, MEX.",4,2,6,2,0,0,
20/10/2018,CHIH.,"JUÁREZ, CHIH.",6,0,6,4,0,146,
20/10/2018,MEX.,"ATIZAPAN, MEX.",1,4,5,0,0,0,
20/10/2018,S.L.P.,"SALINAS, S.L.P.",1,0,1,0,0,0,
20/10/2018,MEX.,"COACALCO DE BERRIOZABAL, MEX.",1,0,1,1,0,0,
20/10/2018,COAH.,"PIEDRAS NEGRAS, COAH.",0,1,1,0,0,0,
20/10/2018,COAH.,"ACUÑA, COAH.",0,1,1,5,0,0,
22/10/2018,MEX.,"ALMOLOYA DE JUAREZ, MEX.",5,1,6,0,0,0,
22/10/2018,CHIH.,"JUÁREZ, CHIH.",4,1,5,1,0,185,
22/10/2018,D.F.,"VENUSTIANO CARRANZA, D.F.",3,1,4,0,0,2825,
22/10/2018,MEX.,"TECAMAC, MEX.",2,1,3,0,0,0,
22/10/2018,GTO.,"LEON, GTO.",1,1,2,0,4,0,
22/10/2018,ZAC.,"FRESNILLO, ZAC.",1,1,2,0,0,1006,
22/10/2018,B.C.,"TIJUANA, B.C.",0,2,2,0,0,0,
22/10/2018,D.F.,"VENUSTIANO CARRANZA, D.F.",2,0,2,0,0,0,
22/10/2018,B.C.,"TIJUANA, B.C.",0,2,2,0,0,0,
22/10/2018,MOR.,"TEPOZTLAN, MOR.",0,1,1,8,0,1385,
22/10/2018,MEX.,"LA PAZ, MEX.",1,0,1,0,0,0,
23/10/2018,CHIH.,"JUÁREZ, CHIH.",9,8,17,4,0,379,
23/10/2018,GTO.,"LEON, GTO.",3,0,3,0,1,0,
23/10/2018,MEX.,"ALMOLOYA DE JUAREZ, MEX.",3,0,3,0,0,98,
23/10/2018,MEX.,"TECAMAC, MEX.",3,0,3,3,0,723,
23/10/2018,B.C.,"TIJUANA, B.C.",0,2,2,0,0,0,
23/10/2018,B.C.,"TIJUANA, B.C.",0,2,2,0,0,0,
23/10/2018,COAH.,"ACUÑA, COAH.",0,2,2,0,0,0,
23/10/2018,ZAC.,"GUADALUPE, ZAC.",1,1,2,2,0,0,
23/10/2018,COAH.,"MÚZQUIZ, COAH.",0,1,1,0,0,170,
23/10/2018,MOR.,"CUERNAVACA, MOR.",0,0,0,2,3,222,
23/10/2018,MEX.,"LA PAZ, MEX.",0,0,0,0,6,0,
24/10/2018,CHIH.,"JUÁREZ, CHIH.",3,11,14,7,0,1322,
24/10/2018,MEX.,"ALMOLOYA DE JUAREZ, MEX.",1,3,4,0,1,5,
24/10/2018,COAH.,"MÚZQUIZ, COAH.",2,1,3,1,0,0,
24/10/2018,S.L.P.,"SAN LUIS POTOSI, S.L.P.",2,1,3,0,0,0,
24/10/2018,MOR.,"CUERNAVACA, MOR.",2,1,3,0,0,0,
24/10/2018,COAH.,"PIEDRAS NEGRAS, COAH.",0,2,2,0,0,0,
24/10/2018,ZAC.,"GUADALUPE, ZAC.",1,0,1,15,0,0,
24/10/2018,ZAC.,"FRESNILLO, ZAC.",1,0,1,0,0,0,
24/10/2018,GTO.,"LEON, GTO.",1,0,1,0,0,0,
24/10/2018,MEX.,"TECAMAC, MEX.",1,0,1,0,0,1467,
24/10/2018,MEX.,"LA PAZ, MEX.",1,0,1,0,14,91,
24/10/2018,S.L.P.,"CIUDAD VALLES, S.L.P.",0,0,0,2,0,115,
25/10/2018,CHIH.,"JUÁREZ, CHIH.",2,10,12,4,0,374,
25/10/2018,MEX.,"ALMOLOYA DE JUAREZ, MEX.",4,3,7,0,0,27,
25/10/2018,GTO.,"LEON, GTO.",3,3,6,0,0,0,
25/10/2018,ZAC.,"GUADALUPE, ZAC.",3,1,4,8,0,50,
25/10/2018,S.L.P.,"SAN LUIS POTOSI, S.L.P.",2,0,2,0,0,0,
25/10/2018,MEX.,"TECAMAC, MEX.",2,0,2,0,0,115,
25/10/2018,MEX.,"LA PAZ, MEX.",1,1,2,0,0,0,
25/10/2018,MOR.,"CUERNAVACA, MOR.",0,1,1,4,4,440,
25/10/2018,COAH.,"PIEDRAS NEGRAS, COAH.",0,1,1,1,1,215,
25/10/2018,DGO.,"GOMEZ PALACIO, DGO.",0,1,1,0,0,0,
26/10/2018,CHIH.,"JUÁREZ, CHIH.",6,4,10,15,0,418,
26/10/2018,MEX.,"TECAMAC, MEX.",3,0,3,1,5,5508,
26/10/2018,ZAC.,"GUADALUPE, ZAC.",2,0,2,8,0,50,
26/10/2018,MEX.,"LA PAZ, MEX.",2,0,2,2,12,163,
26/10/2018,MEX.,"TEJUPILCO, MEX.",1,0,1,0,0,26,
26/10/2018,DGO.,"GOMEZ PALACIO, DGO.",1,0,1,0,0,0,
26/10/2018,COAH.,"PIEDRAS NEGRAS, COAH.",0,1,1,0,0,0,
26/10/2018,MEX.,"ALMOLOYA DE JUAREZ, MEX.",0,0,0,0,0,5,
26/10/2018,ZAC.,"FRESNILLO, ZAC.",0,0,0,7,0,0,
27/10/2018,S.L.P.,"SAN LUIS POTOSI, S.L.P.",3,0,3,0,0,0,
27/10/2018,COAH.,"MÚZQUIZ, COAH.",1,1,2,0,0,315,
27/10/2018,MEX.,"TECAMAC, MEX.",1,0,1,0,0,126,
27/10/2018,MEX.,"LA PAZ, MEX.",0,1,1,0,15,0,
27/10/2018,MOR.,"CUERNAVACA, MOR.",1,0,1,18,0,80,
27/10/2018,COAH.,"ACUÑA, COAH.",0,1,1,0,0,0,
27/10/2018,CHIH.,"JUÁREZ, CHIH.",1,0,1,0,1,23,
27/10/2018,MEX.,"ALMOLOYA DE JUAREZ, MEX.",0,0,0,0,1,322,
27/10/2018,COAH.,"PIEDRAS NEGRAS, COAH.",0,0,0,6,0,485,
28/10/2018,CHIH.,"JUÁREZ, CHIH.",0,5,5,6,0,3022,
28/10/2018,S.L.P.,"SAN LUIS POTOSI, S.L.P.",1,2,3,3,0,0,
29/10/2018,CHIH.,"JUÁREZ, CHIH.",5,4,9,11,0,244,
29/10/2018,COAH.,"SALTILLO, COAH.",1,0,1,2,0,288,
29/10/2018,MEX.,"XONACATLAN, MEX.",0,0,0,0,0,63,
29/10/2018,COAH.,"RAMOS ARIZPE, COAH.",0,0,0,0,0,57,
29/10/2018,ZAC.,"GUADALUPE, ZAC.",0,0,0,4,0,0,
29/10/2018,ZAC.,"FRESNILLO, ZAC.",0,0,0,9,0,0,
30/10/2018,CHIH.,"JUÁREZ, CHIH.",1,4,5,2,0,495,
30/10/2018,COAH.,"PIEDRAS NEGRAS, COAH.",0,2,2,0,0,0,
30/10/2018,D.F.,"COYOACAN, D.F.",2,0,2,0,0,1087,
30/10/2018,MOR.,"TEPOZTLAN, MOR.",1,0,1,0,0,250,
30/10/2018,MEX.,"TENANCINGO, MEX.",0,1,1,0,3,0,
30/10/2018,ZAC.,"FRESNILLO, ZAC.",1,0,1,11,0,0,
30/10/2018,COAH.,"SALTILLO, COAH.",1,0,1,0,0,0,
30/10/2018,COAH.,"MÚZQUIZ, COAH.",0,1,1,3,0,480,
30/10/2018,ZAC.,"GUADALUPE, ZAC.",0,0,0,6,0,0,
31/10/2018,MEX.,"TECAMAC, MEX.",4,2,6,2,0,11,
31/10/2018,MEX.,"XONACATLAN, MEX.",2,0,2,0,0,0,
31/10/2018,MEX.,"TECAMAC, MEX.",1,0,1,0,0,0,
01/11/2018,CHIH.,"JUÁREZ, CHIH.",1,1,2,1,0,263,
01/11/2018,MEX.,"XONACATLAN, MEX.",0,2,2,0,0,56,
01/11/2018,MEX.,"TECAMAC, MEX.",2,0,2,0,0,0,
01/11/2018,B.C.,"TIJUANA, B.C.",0,1,1,0,0,0,
01/11/2018,MEX.,"CHICONCUAC, MEX.",1,0,1,0,0,0,
01/11/2018,MEX.,"OCOYOACAC, MEX.",0,0,0,0,6,0,
02/11/2018,MEX.,"TECAMAC, MEX.",2,0,2,1,0,50,
02/11/2018,MEX.,"CHICONCUAC, MEX.",0,0,0,0,0,1250,
03/11/2018,MEX.,"OCOYOACAC, MEX.",3,1,4,0,0,0,
03/11/2018,N.L.,"MONTERREY, N.L.",3,0,3,0,0,0,
03/11/2018,DGO.,"GOMEZ PALACIO, DGO.",1,0,1,0,0,0,
03/11/2018,CHIH.,"JUÁREZ, CHIH.",1,0,1,0,0,322,
03/11/2018,MEX.,"XONACATLAN, MEX.",0,0,0,0,8,0,
04/11/2018,B.C.,"MEXICALI, B.C.",1,0,1,0,0,0,
05/11/2018,COAH.,"PIEDRAS NEGRAS, COAH.",3,1,4,0,0,300,
05/11/2018,N.L.,"MONTERREY, N.L.",3,0,3,0,0,0,
05/11/2018,MEX.,"CUAUTITLAN IZCALLI, MEX.",2,1,3,2,0,288,
05/11/2018,CHIH.,"JUÁREZ, CHIH.",1,0,1,0,0,0,
05/11/2018,COAH.,"SALTILLO, COAH.",1,0,1,1,0,0,
05/11/2018,MEX.,"METEPEC, MEX.",1,0,1,0,0,0,
05/11/2018,ZAC.,"GUADALUPE, ZAC.",0,0,0,8,0,2288,
06/11/2018,D.F.,"COYOACAN, D.F.",3,2,5,0,0,2865,
06/11/2018,MEX.,"CUAUTITLAN IZCALLI, MEX.",3,2,5,3,0,60,
06/11/2018,MEX.,"VALLE DE CHALCO SOLIDARIDAD, MEX.",3,0,3,2,1,597,
06/11/2018,B.C.,"TIJUANA, B.C.",1,0,1,0,0,0,
06/11/2018,ZAC.,"GUADALUPE, ZAC.",1,0,1,8,0,0,
06/11/2018,CHIH.,"JUÁREZ, CHIH.",1,0,1,0,0,49,
06/11/2018,COAH.,"RAMOS ARIZPE, COAH.",0,0,0,1,0,11,
07/11/2018,MEX.,"VALLE DE CHALCO SOLIDARIDAD, MEX.",6,0,6,0,0,533,
07/11/2018,MEX.,"METEPEC, MEX.",2,1,3,1,0,4807,
07/11/2018,COAH.,"TORREÓN, COAH.",3,0,3,0,0,0,
07/11/2018,D.F.,"COYOACAN, D.F.",3,0,3,0,0,5120,
07/11/2018,CHIH.,"JUÁREZ, CHIH.",1,1,2,0,0,339,
07/11/2018,MEX.,"AMATEPEC, MEX.",0,1,1,0,0,0,
07/11/2018,COAH.,"PIEDRAS NEGRAS, COAH.",1,0,1,2,0,350,
07/11/2018,COAH.,"RAMOS ARIZPE, COAH.",0,0,0,0,0,200,
08/11/2018,MEX.,"VALLE DE CHALCO SOLIDARIDAD, MEX.",4,1,5,3,0,292,
08/11/2018,COAH.,"RAMOS ARIZPE, COAH.",4,0,4,1,0,7,
08/11/2018,MEX.,"METEPEC, MEX.",2,2,4,0,0,0,
08/11/2018,CHIH.,"JUÁREZ, CHIH.",2,0,2,5,0,240,
08/11/2018,COAH.,"TORREÓN, COAH.",1,1,2,0,0,0,
08/11/2018,MOR.,"TEPOZTLAN, MOR.",1,0,1,11,0,409,
08/11/2018,CHIH.,"JUÁREZ, CHIH.",0,1,1,1,0,28,
08/11/2018,MEX.,"METEPEC, MEX.",1,0,1,0,0,0,
08/11/2018,MEX.,"AMATEPEC, MEX.",1,0,1,0,0,0,
09/11/2018,D.F.,"COYOACAN, D.F.",9,5,14,0,0,7240,
09/11/2018,MEX.,"VALLE DE CHALCO SOLIDARIDAD, MEX.",5,0,5,0,0,0,
09/11/2018,COAH.,"ACUÑA, COAH.",1,0,1,0,0,0,
09/11/2018,MEX.,"CUAUTITLAN IZCALLI, MEX.",1,0,1,0,0,1786,
09/11/2018,COAH.,"RAMOS ARIZPE, COAH.",0,0,0,4,0,0,
09/11/2018,COAH.,"PIEDRAS NEGRAS, COAH.",0,0,0,15,0,0,
10/11/2018,MEX.,"VALLE DE CHALCO SOLIDARIDAD, MEX.",3,0,3,0,0,0,
10/11/2018,COAH.,"MÚZQUIZ, COAH.",2,0,2,0,0,0,
10/11/2018,MEX.,"CUAUTITLAN IZCALLI, MEX.",1,0,1,0,0,0,
10/11/2018,MEX.,"AMATEPEC, MEX.",0,1,1,0,0,11,
10/11/2018,MEX.,"METEPEC, MEX.",0,0,0,0,0,3234,
10/11/2018,CHIH.,"JUÁREZ, CHIH.",0,0,0,17,0,821,
11/11/2018,CHIH.,"JUÁREZ, CHIH.",0,0,0,1,0,242,
12/11/2018,N.L.,"LOS ALDAMAS, N.L.",3,2,5,17,0,0,
12/11/2018,MEX.,"EL ORO, MEX.",0,2,2,0,0,0,
12/11/2018,B.C.,"TIJUANA, B.C.",0,1,1,0,0,0,
12/11/2018,B.C.,"MEXICALI, B.C.",0,1,1,0,0,0,
12/11/2018,MEX.,"TEPETLAOXTOC, MEX.",0,1,1,0,0,1397,
12/11/2018,MEX.,"CUAUTITLAN IZCALLI, MEX.",1,0,1,0,0,0,
12/11/2018,MEX.,"TEPETLAOXTOC, MEX.",0,1,1,0,0,3084,
12/11/2018,MEX.,"ALMOLOYA DE ALQUISIRAS, MEX.",0,0,0,0,17,0,
12/11/2018,CHIH.,"JUÁREZ, CHIH.",0,0,0,8,0,551,
12/11/2018,Q. ROO,"COZUMEL, Q. ROO",0,0,0,0,0,848,
13/11/2018,N.L.,"MONTERREY, N.L.",1,2,3,1,0,0,
13/11/2018,MEX.,"EL ORO, MEX.",1,0,1,0,0,0,
13/11/2018,MEX.,"ALMOLOYA DE ALQUISIRAS, MEX.",0,1,1,0,0,0,
13/11/2018,N.L.,"LOS ALDAMAS, N.L.",0,1,1,25,0,0,
13/11/2018,COAH.,"PIEDRAS NEGRAS, COAH.",0,1,1,0,0,0,
13/11/2018,CHIH.,"JUÁREZ, CHIH.",0,1,1,1,0,28,
13/11/2018,D.F.,"CUAJIMALPA DE MOR., D.F.",1,0,1,0,2,627,
13/11/2018,Q. ROO,"COZUMEL, Q. ROO",0,0,0,0,1,464,
14/11/2018,MEX.,"EL ORO, MEX.",0,2,2,1,0,0,
14/11/2018,MEX.,"TEPETLAOXTOC, MEX.",1,0,1,0,0,0,
14/11/2018,Q. ROO,"COZUMEL, Q. ROO",0,0,0,0,0,490,
15/11/2018,D.F.,"CUAJIMALPA DE MOR., D.F.",2,0,2,0,0,0,
15/11/2018,N.L.,"LOS ALDAMAS, N.L.",0,0,0,20,0,0,
15/11/2018,MEX.,"TEPETLAOXTOC, MEX.",0,0,0,0,0,560,
15/11/2018,MEX.,"CUAUTITLAN IZCALLI, MEX.",0,0,0,0,0,2057,
15/11/2018,Q. ROO,"COZUMEL, Q. ROO",0,0,0,0,1,517,
16/11/2018,D.F.,"CUAJIMALPA DE MOR., D.F.",5,2,7,0,1,1900,
16/11/2018,MEX.,"EL ORO, MEX.",1,2,3,0,4,0,
16/11/2018,MEX.,"TEPETLAOXTOC, MEX.",2,0,2,0,0,1277,
16/11/2018,S.L.P.,"SAN LUIS POTOSI, S.L.P.",2,0,2,0,0,0,
16/11/2018,MEX.,"CUAUTITLAN IZCALLI, MEX.",1,0,1,0,0,0,
16/11/2018,COAH.,"PIEDRAS NEGRAS, COAH.",1,0,1,2,0,221,
16/11/2018,CHIH.,"JUÁREZ, CHIH.",0,1,1,10,0,156,
16/11/2018,Q. ROO,"COZUMEL, Q. ROO",0,0,0,0,0,1750,
17/11/2018,MEX.,"EL ORO, MEX.",3,0,3,0,0,0,
17/11/2018,MEX.,"EL ORO, MEX.",2,0,2,1,0,0,
17/11/2018,TAB.,"TENOSIQUE, TAB.",0,0,0,0,0,10,
19/11/2018,CHIH.,"JUÁREZ, CHIH.",1,1,2,5,0,658,
19/11/2018,S.L.P.,"SAN LUIS POTOSI, S.L.P.",0,0,0,9,0,0,
20/11/2018,MEX.,"TENANGO DEL VALLE, MEX.",2,0,2,0,0,0,
20/11/2018,MEX.,"VALLE DE BRAVO, MEX.",1,0,1,0,0,0,
21/11/2018,D.F.,"CUAJIMALPA DE MOR., D.F.",7,1,8,0,0,277,
21/11/2018,COAH.,"TORREÓN, COAH.",0,3,3,3,0,0,
21/11/2018,MEX.,"TENANGO DEL VALLE, MEX.",2,0,2,0,15,0,
21/11/2018,COAH.,"PIEDRAS NEGRAS, COAH.",1,1,2,0,0,150,
21/11/2018,MEX.,"SAN MARTIN DE LAS PIRAMIDES, MEX.",1,0,1,0,0,6001,
21/11/2018,B.C.,"TIJUANA, B.C.",0,0,0,0,1,0,
22/11/2018,ZAC.,"FRESNILLO, ZAC.",3,0,3,14,0,30,
22/11/2018,MEX.,"SAN MARTIN DE LAS PIRAMIDES, MEX.",2,1,3,0,0,9650,
22/11/2018,COAH.,"PIEDRAS NEGRAS, COAH.",0,1,1,1,0,0,
22/11/2018,ZAC.,"GUADALUPE, ZAC.",0,0,0,10,0,0,
22/11/2018,N.L.,"LOS ALDAMAS, N.L.",0,0,0,20,0,0,
23/11/2018,TAMPS.,"ALTAMIRA, TAMPS.",2,0,2,1,0,0,
23/11/2018,MEX.,"TENANGO DEL VALLE, MEX.",2,0,2,1,0,0,
24/11/2018,MEX.,"SAN MARTIN DE LAS PIRAMIDES, MEX.",4,0,4,0,0,12717,
24/11/2018,COAH.,"PIEDRAS NEGRAS, COAH.",1,1,2,1,0,0,
24/11/2018,B.C.,"ENSENADA, B.C.",0,1,1,0,0,0,
26/11/2018,SIN.,"MAZATLAN, SIN.",4,0,4,0,0,0,
27/11/2018,ZAC.,"GUADALUPE, ZAC.",5,0,5,9,0,0,
27/11/2018,S.L.P.,"CIUDAD VALLES, S.L.P.",1,0,1,0,0,0,
27/11/2018,COAH.,"TORREÓN, COAH.",1,0,1,0,0,0,
27/11/2018,MEX.,"JUCHITEPEC, MEX.",1,0,1,0,2,30,
27/11/2018,D.F.,"IZTACALCO, D.F.",0,0,0,0,0,10000,
27/11/2018,ZAC.,"GUADALUPE, ZAC.",0,0,0,9,0,64,
28/11/2018,SIN.,"AHOME, SIN.",3,2,5,0,1,0,
28/11/2018,SIN.,"MAZATLAN, SIN.",3,0,3,0,0,0,
28/11/2018,D.F.,"IZTACALCO, D.F.",3,0,3,0,0,40500,
28/11/2018,S.L.P.,"CIUDAD VALLES, S.L.P.",1,0,1,0,0,0,
28/11/2018,S.L.P.,"SALINAS, S.L.P.",0,1,1,0,0,0,
29/11/2018,N.L.,"LOS ALDAMAS, N.L.",4,0,4,1,0,0,
29/11/2018,D.F.,"IZTACALCO, D.F.",4,0,4,0,2,33500,
29/11/2018,B.C.,"ENSENADA, B.C.",1,2,3,0,0,0,
29/11/2018,MEX.,"JUCHITEPEC, MEX.",0,1,1,0,5,0,
29/11/2018,COAH.,"TORREÓN, COAH.",0,0,0,0,0,80,
30/11/2018,MEX.,"JUCHITEPEC, MEX.",1,0,1,0,0,14,
30/11/2018,MEX.,"JUCHITEPEC, MEX.",0,1,1,0,0,161,
30/11/2018,COAH.,"SALTILLO, COAH.",0,0,0,0,2,0,
03/12/2018,SIN.,"SIN., SIN.",5,1,6,0,0,0,
03/12/2018,SIN.,"ANGOSTURA, SIN.",2,0,2,0,5,0,
03/12/2018,TAB.,"PARAISO, TAB.",1,0,1,0,0,14,
05/12/2018,SIN.,"ANGOSTURA, SIN.",1,6,7,0,0,0,
05/12/2018,SIN.,"AHOME, SIN.",4,0,4,0,0,0,
05/12/2018,SIN.,"MAZATLAN, SIN.",2,0,2,0,0,0,
07/12/2018,SIN.,"MAZATLAN, SIN.",23,2,25,0,1,0,
07/12/2018,SIN.,"ANGOSTURA, SIN.",2,3,5,0,0,0,
07/12/2018,B.C.,"MEXICALI, B.C.",1,1,2,0,0,0,
07/12/2018,SIN.,"MAZATLAN, SIN.",1,0,1,0,0,0,
07/12/2018,SIN.,"AHOME, SIN.",1,0,1,0,0,0,
10/12/2018,SIN.,"BADIRAGUATO, SIN.",2,1,3,0,0,0,
10/12/2018,SIN.,"CULIACAN, SIN.",1,1,2,0,0,0,
11/12/2018,SIN.,"BADIRAGUATO, SIN.",2,6,8,0,0,0,
11/12/2018,SIN.,"CULIACAN, SIN.",0,7,7,0,0,0,
11/12/2018,SIN.,"GUASAVE, SIN.",1,0,1,0,0,0,
11/12/2018,S.L.P.,"SAN LUIS POTOSI, S.L.P.",0,0,0,5,1,0,
12/12/2018,TAMPS.,"TAMPICO, TAMPS.",1,0,1,3,0,200,
12/12/2018,TAMPS.,"CIUDAD MADERO, TAMPS.",1,0,1,0,0,99,
13/12/2018,SIN.,"CULIACAN, SIN.",4,1,5,0,0,0,
13/12/2018,S.L.P.,"SAN LUIS POTOSI, S.L.P.",1,1,2,0,0,0,
13/12/2018,SIN.,"MAZATLAN, SIN.",2,0,2,0,0,0,
13/12/2018,SIN.,"BADIRAGUATO, SIN.",2,0,2,0,0,0,
13/12/2018,B.C.,"MEXICALI, B.C.",0,1,1,0,0,0,
13/12/2018,SIN.,"GUASAVE, SIN.",0,0,0,0,1,0,
17/12/2018,SIN.,"GUASAVE, SIN.",2,1,3,0,3,0,
17/12/2018,SIN.,"BADIRAGUATO, SIN.",1,1,2,0,1,0,
17/12/2018,SIN.,"NAVOLATO, SIN.",0,1,1,0,0,0,
18/12/2018,SIN.,"GUASAVE, SIN.",5,2,7,0,0,0,
18/12/2018,SIN.,"BADIRAGUATO, SIN.",0,6,6,0,0,0,
18/12/2018,SIN.,"CULIACAN, SIN.",1,3,4,0,0,0,
18/12/2018,SIN.,"MAZATLAN, SIN.",2,0,2,0,0,0,
18/12/2018,TAMPS.,"TAMPICO, TAMPS.",2,0,2,0,0,0,
19/12/2018,SIN.,"GUASAVE, SIN.",3,0,3,0,0,0,
19/12/2018,SIN.,"MAZATLAN, SIN.",1,1,2,0,0,0,
19/12/2018,B.C.,"TIJUANA, B.C.",1,1,2,0,0,0,
19/12/2018,SIN.,"CULIACAN, SIN.",1,0,1,0,0,0,
19/12/2018,SIN.,"NAVOLATO, SIN.",0,0,0,0,3,0,
19/12/2018,SIN.,"BADIRAGUATO, SIN.",0,0,0,0,2,0,
22/12/2018,TAB.,"EMILIANO ZAPATA, TAB.",1,1,2,0,0,0,
23/12/2018,TAB.,"TENOSIQUE, TAB.",0,1,1,0,0,0,
27/12/2018,B.C.,"TIJUANA, B.C.",2,3,5,0,0,0,
30/12/2018,GRO.,"PUNGARABATO, GRO.",0,1,1,0,0,0,
13/01/2019,TAB.,"JONUTA, TAB.",0,1,1,0,0,0,
21/01/2019,CD. MÉX.,"GUSTAVO A. MADERO, CD. MÉX.",9,1,10,0,3,93,
22/01/2019,CD. MÉX.,"GUSTAVO A. MADERO, CD. MÉX.",16,2,18,0,1,10447,
22/01/2019,COAH.,"PIEDRAS NEGRAS, COAH.",1,3,4,4,0,107,
23/01/2019,CD. MÉX.,"GUSTAVO A. MADERO, CD. MÉX.",20,2,22,0,1,22956,
23/01/2019,COAH.,"PIEDRAS NEGRAS, COAH.",0,0,0,0,0,78,
24/01/2019,CD. MÉX.,"GUSTAVO A. MADERO, CD. MÉX.",58,7,65,0,1,16172,
25/01/2019,CD. MÉX.,"GUSTAVO A. MADERO, CD. MÉX.",37,6,43,0,0,24912,
25/01/2019,CAMP.,"ESCÁRCEGA, CAMP.",1,1,2,0,0,0,
25/01/2019,COAH.,"PIEDRAS NEGRAS, COAH.",0,1,1,0,0,100,
27/01/2019,HGO.,"TEZONTEPEC DE ALDAMA, HGO.",0,2,2,0,0,0,
27/01/2019,HGO.,"APAN, HGO.",0,0,0,0,1,220,
28/01/2019,CD. MÉX.,"GUSTAVO A. MADERO, CD. MÉX.",20,8,28,0,5,25872,
28/01/2019,COAH.,"PIEDRAS NEGRAS, COAH.",0,2,2,0,0,67,
29/01/2019,CD. MÉX.,"GUSTAVO A. MADERO, CD. MÉX.",29,9,38,0,1,8468,
29/01/2019,COAH.,"PIEDRAS NEGRAS, COAH.",0,0,0,0,0,100,
30/01/2019,CD. MÉX.,"GUSTAVO A. MADERO, CD. MÉX.",44,8,52,0,0,35270,
30/01/2019,YUC.,"IZAMAL, YUC.",0,1,1,0,0,0,
31/01/2019,CD. MÉX.,"GUSTAVO A. MADERO, CD. MÉX.",44,9,53,0,5,38876,
31/01/2019,GRO.,"COYUCA DE CATALAN, GRO.",1,2,3,0,0,0,
31/01/2019,YUC.,"IZAMAL, YUC.",0,1,1,0,0,0,
31/01/2019,COAH.,"PIEDRAS NEGRAS, COAH.",0,1,1,8,0,124,
01/02/2019,CD. MÉX.,"GUSTAVO A. MADERO, CD. MÉX.",41,12,53,0,1,37601,
01/02/2019,GRO.,"COYUCA DE CATALAN, GRO.",1,2,3,0,0,0,
01/02/2019,COAH.,"PIEDRAS NEGRAS, COAH.",0,2,2,0,0,256,
01/02/2019,GTO.,"DOCTOR MORA, GTO.",1,0,1,0,0,0,
04/02/2019,CD. MÉX.,"IZTAPALAPA, CD. MÉX.",2,1,3,0,0,141,
05/02/2019,CD. MÉX.,"GUSTAVO A. MADERO, CD. MÉX.",11,0,11,0,2,32290,
06/02/2019,CD. MÉX.,"IZTAPALAPA, CD. MÉX.",13,3,16,0,0,69678,
07/02/2019,CD. MÉX.,"IZTAPALAPA, CD. MÉX.",16,1,17,0,0,63152,
08/02/2019,CD. MÉX.,"IZTAPALAPA, CD. MÉX.",6,2,8,0,0,52690,
08/02/2019,CHIH.,"DELICIAS, CHIH.",0,0,0,0,0,77,
11/02/2019,CD. MÉX.,"IZTAPALAPA, CD. MÉX.",19,2,21,0,3,48382,
11/02/2019,GRO.,"COYUCA DE CATALAN, GRO.",0,2,2,0,0,2396,
12/02/2019,CD. MÉX.,"IZTAPALAPA, CD. MÉX.",19,4,23,0,0,36815,
12/02/2019,COAH.,"SALTILLO, COAH.",2,1,3,0,0,160,
13/02/2019,CD. MÉX.,"IZTAPALAPA, CD. MÉX.",18,4,22,0,3,47591,
14/02/2019,CD. MÉX.,"IZTAPALAPA, CD. MÉX.",26,5,31,0,5,31475,
14/02/2019,COAH.,"SALTILLO, COAH.",1,0,1,0,0,0,
15/02/2019,CD. MÉX.,"IZTAPALAPA, CD. MÉX.",25,2,27,0,2,43635,
15/02/2019,COAH.,"SALTILLO, COAH.",0,1,1,5,1,27,
15/02/2019,CHIH.,"CUAUHTÉMOC, CHIH.",0,0,0,0,0,33,
18/02/2019,CD. MÉX.,"CUAUHTEMOC, CD. MÉX.",9,0,9,0,0,17023,
18/02/2019,ZAC.,"ZAC., ZAC.",4,0,4,0,0,0,
18/02/2019,ZAC.,"GUADALUPE, ZAC.",2,1,3,0,0,0,
18/02/2019,ZAC.,"FRESNILLO, ZAC.",0,0,0,1,0,1886,
19/02/2019,CD. MÉX.,"CUAUHTEMOC, CD. MÉX.",13,1,14,0,0,3958,
20/02/2019,CD. MÉX.,"CUAUHTEMOC, CD. MÉX.",20,2,22,0,1,7743,
20/02/2019,ZAC.,"GUADALUPE, ZAC.",2,1,3,0,1,213,
20/02/2019,ZAC.,"ZAC., ZAC.",1,1,2,0,1,0,
20/02/2019,ZAC.,"FRESNILLO, ZAC.",0,0,0,0,0,2632,
21/02/2019,CD. MÉX.,"CUAUHTEMOC, CD. MÉX.",9,2,11,0,1,376,
21/02/2019,ZAC.,"ZAC., ZAC.",1,2,3,5,1,0,
21/02/2019,COAH.,"SALTILLO, COAH.",1,0,1,0,0,23,
21/02/2019,COAH.,"ACUÑA, COAH.",1,0,1,0,0,0,
21/02/2019,ZAC.,"GUADALUPE, ZAC.",0,0,0,0,0,2500,
22/02/2019,CD. MÉX.,"CUAUHTEMOC, CD. MÉX.",14,2,16,0,0,751,
22/02/2019,COAH.,"PIEDRAS NEGRAS, COAH.",2,0,2,0,0,0,
22/02/2019,CHIH.,"CUAUHTÉMOC, CHIH.",1,0,1,1,0,0,
22/02/2019,ZAC.,"FRESNILLO, ZAC.",1,0,1,2,0,44,
23/02/2019,DGO.,"GOMEZ PALACIO, DGO.",0,1,1,0,0,0,
25/02/2019,CD. MÉX.,"CUAUHTEMOC, CD. MÉX.",18,2,20,0,0,4737,
25/02/2019,GTO.,"ACAMBARO, GTO.",3,0,3,0,0,0,
25/02/2019,ZAC.,"ZAC., ZAC.",1,2,3,6,1,100,
25/02/2019,ZAC.,"FRESNILLO, ZAC.",2,1,3,1,0,15,
25/02/2019,ZAC.,"GUADALUPE, ZAC.",2,0,2,16,1,335,
25/02/2019,CHIH.,"CUAUHTÉMOC, CHIH.",0,0,0,1,0,0,
25/02/2019,COAH.,"SALTILLO, COAH.",0,0,0,2,0,41,
26/02/2019,CD. MÉX.,"CUAUHTEMOC, CD. MÉX.",16,3,19,0,0,2469,
26/02/2019,ZAC.,"FRESNILLO, ZAC.",5,0,5,3,0,2147,
26/02/2019,ZAC.,"GUADALUPE, ZAC.",3,0,3,0,0,50,
26/02/2019,ZAC.,"ZAC., ZAC.",0,2,2,0,0,0,
26/02/2019,DGO.,"GOMEZ PALACIO, DGO.",1,0,1,1,0,0,
26/02/2019,GTO.,"ACAMBARO, GTO.",1,0,1,0,0,0,
27/02/2019,CD. MÉX.,"CUAUHTEMOC, CD. MÉX.",11,1,12,0,0,482,
27/02/2019,ZAC.,"FRESNILLO, ZAC.",5,2,7,17,0,1333,
27/02/2019,COAH.,"ACUÑA, COAH.",2,2,4,0,0,0,
27/02/2019,GTO.,"ACAMBARO, GTO.",1,2,3,0,0,0,
27/02/2019,ZAC.,"GUADALUPE, ZAC.",2,0,2,7,0,80,
27/02/2019,COAH.,"PIEDRAS NEGRAS, COAH.",0,2,2,0,0,300,
27/02/2019,DGO.,"GOMEZ PALACIO, DGO.",2,0,2,0,0,0,
27/02/2019,DGO.,"GOMEZ PALACIO, DGO.",0,0,0,4,0,0,
27/02/2019,COAH.,"RAMOS ARIZPE, COAH.",0,0,0,2,0,0,
28/02/2019,CD. MÉX.,"CUAUHTEMOC, CD. MÉX.",12,1,13,0,1,4947,
28/02/2019,GTO.,"ACAMBARO, GTO.",7,1,8,0,0,0,
28/02/2019,GTO.,"SAN LUIS DE LA PAZ, GTO.",1,1,2,0,0,0,
01/03/2019,CD. MÉX.,"CUAUHTEMOC, CD. MÉX.",16,0,16,0,2,7180,
01/03/2019,GTO.,"ACAMBARO, GTO.",2,3,5,0,0,0,
01/03/2019,DGO.,"GOMEZ PALACIO, DGO.",2,0,2,0,0,0,
01/03/2019,COAH.,"RAMOS ARIZPE, COAH.",1,0,1,0,0,0,
02/03/2019,COAH.,"PIEDRAS NEGRAS, COAH.",0,0,0,0,0,525,
03/03/2019,CHIS.,"TAPACHULA, CHIS.",2,0,2,0,0,114,
04/03/2019,CHIS.,"TUXTLA GUTIÉRREZ, CHIS.",2,8,10,3,9,561,
04/03/2019,VER.,"POZA RICA DE HGO., VER.",1,2,3,0,0,0,
04/03/2019,DGO.,"GOMEZ PALACIO, DGO.",1,0,1,0,0,0,
04/03/2019,CHIS.,"SAN CRISTOBAL DE LAS CASAS, CHIS.",0,0,0,0,0,117,
04/03/2019,CHIS.,"TAPACHULA, CHIS.",0,0,0,0,0,1063,
05/03/2019,CD. MÉX.,"BENITO JUAREZ, CD. MÉX.",12,3,15,0,0,448,
05/03/2019,CHIS.,"TUXTLA GUTIÉRREZ, CHIS.",4,6,10,1,4,424,
05/03/2019,CHIS.,"TAPACHULA, CHIS.",2,1,3,1,0,1251,
05/03/2019,COAH.,"TORREÓN, COAH.",0,1,1,0,0,0,
05/03/2019,COAH.,"PIEDRAS NEGRAS, COAH.",0,1,1,6,0,317,
05/03/2019,COAH.,"SALTILLO, COAH.",0,0,0,1,0,10,
05/03/2019,CHIS.,"SAN CRISTOBAL DE LAS CASAS, CHIS.",0,0,0,0,0,146,
06/03/2019,CHIS.,"TUXTLA GUTIÉRREZ, CHIS.",12,2,14,2,4,1960,
06/03/2019,CD. MÉX.,"BENITO JUAREZ, CD. MÉX.",6,1,7,0,0,196,
06/03/2019,CHIS.,"SAN CRISTOBAL DE LAS CASAS, CHIS.",2,1,3,0,0,342,
06/03/2019,GTO.,"SAN LUIS DE LA PAZ, GTO.",2,1,3,0,0,22,
06/03/2019,COAH.,"SALTILLO, COAH.",1,0,1,1,0,128,
06/03/2019,COAH.,"RAMOS ARIZPE, COAH.",0,0,0,1,0,25,
06/03/2019,COAH.,"PIEDRAS NEGRAS, COAH.",0,0,0,6,0,153,
07/03/2019,CD. MÉX.,"BENITO JUAREZ, CD. MÉX.",9,3,12,0,1,1261,
07/03/2019,CHIS.,"TUXTLA GUTIÉRREZ, CHIS.",8,3,11,0,7,2318,
07/03/2019,ZAC.,"FRESNILLO, ZAC.",6,1,7,0,0,2640,
07/03/2019,ZAC.,"ZAC., ZAC.",4,0,4,15,0,125,
07/03/2019,GTO.,"SAN LUIS DE LA PAZ, GTO.",2,0,2,0,0,0,
07/03/2019,COAH.,"MATAMOROS, COAH.",0,1,1,0,0,0,
07/03/2019,CHIS.,"SAN CRISTOBAL DE LAS CASAS, CHIS.",1,0,1,0,0,287,
07/03/2019,CHIS.,"TAPACHULA, CHIS.",1,0,1,11,2,596,
07/03/2019,COAH.,"SALTILLO, COAH.",0,1,1,1,0,0,
08/03/2019,CD. MÉX.,"BENITO JUAREZ, CD. MÉX.",9,1,10,0,0,265,
08/03/2019,ZAC.,"GUADALUPE, ZAC.",2,4,6,3,0,235,
08/03/2019,CHIS.,"TUXTLA GUTIÉRREZ, CHIS.",4,1,5,6,2,5565,
08/03/2019,CHIS.,"SAN CRISTOBAL DE LAS CASAS, CHIS.",1,2,3,3,0,584,
08/03/2019,GTO.,"SAN LUIS DE LA PAZ, GTO.",1,1,2,0,0,0,
08/03/2019,ZAC.,"FRESNILLO, ZAC.",1,1,2,3,0,3000,
08/03/2019,COAH.,"FRANCISCO I. MADERO, COAH.",0,1,1,0,0,0,
08/03/2019,COAH.,"SALTILLO, COAH.",1,0,1,5,0,293,
08/03/2019,COAH.,"MATAMOROS, COAH.",0,0,0,0,0,10,
08/03/2019,COAH.,"PIEDRAS NEGRAS, COAH.",0,0,0,1,0,0,
09/03/2019,CHIS.,"TUXTLA GUTIÉRREZ, CHIS.",2,2,4,0,2,4717,
09/03/2019,CHIS.,"TAPACHULA, CHIS.",2,0,2,0,0,300,
09/03/2019,CHIS.,"SAN CRISTOBAL DE LAS CASAS, CHIS.",0,1,1,0,0,1283,
09/03/2019,COAH.,"PIEDRAS NEGRAS, COAH.",0,0,0,3,0,286,
10/03/2019,CHIS.,"TAPACHULA, CHIS.",1,0,1,1,1,2667,
10/03/2019,CHIS.,"TUXTLA GUTIÉRREZ, CHIS.",1,0,1,0,2,3683,
11/03/2019,CD. MÉX.,"BENITO JUAREZ, CD. MÉX.",7,1,8,0,0,221,
11/03/2019,ZAC.,"FRESNILLO, ZAC.",0,1,1,5,0,50,
11/03/2019,COAH.,"SALTILLO, COAH.",1,0,1,0,0,0,
11/03/2019,CHIS.,"TAPACHULA, CHIS.",0,0,0,0,1,803,
11/03/2019,VER.,"PEROTE, VER.",0,0,0,0,0,65,
11/03/2019,ZAC.,"ZAC., ZAC.",0,0,0,0,1,26,
11/03/2019,COAH.,"MATAMOROS, COAH.",0,0,0,0,3,0,
11/03/2019,COAH.,"PIEDRAS NEGRAS, COAH.",0,0,0,0,0,55,
11/03/2019,DGO.,"GOMEZ PALACIO, DGO.",0,0,0,2,0,0,
12/03/2019,CD. MÉX.,"BENITO JUAREZ, CD. MÉX.",7,6,13,0,0,104,
12/03/2019,ZAC.,"FRESNILLO, ZAC.",3,0,3,8,0,3250,
12/03/2019,COAH.,"MATAMOROS, COAH.",1,1,2,4,0,0,
12/03/2019,COAH.,"TORREÓN, COAH.",2,0,2,0,0,0,
12/03/2019,ZAC.,"GUADALUPE, ZAC.",2,0,2,29,0,960,
12/03/2019,S.L.P.,"CIUDAD VALLES, S.L.P.",0,1,1,0,0,0,
12/03/2019,COAH.,"SAN PEDRO, COAH.",0,0,0,0,0,26,
12/03/2019,COAH.,"SALTILLO, COAH.",0,0,0,1,0,314,
12/03/2019,COAH.,"PIEDRAS NEGRAS, COAH.",0,0,0,2,0,819,
13/03/2019,CD. MÉX.,"BENITO JUAREZ, CD. MÉX.",5,0,5,0,0,262,
13/03/2019,ZAC.,"ZAC., ZAC.",2,0,2,3,0,0,
13/03/2019,ZAC.,"FRESNILLO, ZAC.",1,0,1,0,0,3568,
14/03/2019,CD. MÉX.,"BENITO JUAREZ, CD. MÉX.",21,1,22,0,0,91,
14/03/2019,COAH.,"SALTILLO, COAH.",3,1,4,0,0,16,
14/03/2019,CHIH.,"ALDAMA, CHIH.",1,2,3,0,0,0,
14/03/2019,COAH.,"FRANCISCO I. MADERO, COAH.",2,0,2,0,0,0,
14/03/2019,S.L.P.,"SOLEDAD DE GRACIANO SANCHEZ, S.L.P.",1,0,1,0,0,0,
14/03/2019,COAH.,"PIEDRAS NEGRAS, COAH.",0,0,0,0,0,215,
14/03/2019,ZAC.,"GUADALUPE, ZAC.",0,0,0,3,0,154,
14/03/2019,ZAC.,"ZAC., ZAC.",0,0,0,0,0,1200,
14/03/2019,ZAC.,"FRESNILLO, ZAC.",0,0,0,0,0,3700,
15/03/2019,CD. MÉX.,"BENITO JUAREZ, CD. MÉX.",25,2,27,0,0,2664,
15/03/2019,ZAC.,"ZAC., ZAC.",0,2,2,0,0,0,
15/03/2019,COAH.,"PIEDRAS NEGRAS, COAH.",0,1,1,0,0,370,
15/03/2019,ZAC.,"FRESNILLO, ZAC.",1,0,1,6,0,3599,
15/03/2019,S.L.P.,"SOLEDAD DE GRACIANO SANCHEZ, S.L.P.",1,0,1,0,0,17,
15/03/2019,COAH.,"SALTILLO, COAH.",0,0,0,0,0,1,
15/03/2019,ZAC.,"GUADALUPE, ZAC.",0,0,0,11,0,191,
15/03/2019,DGO.,"GOMEZ PALACIO, DGO.",0,0,0,3,0,0,
16/03/2019,S.L.P.,"CIUDAD VALLES, S.L.P.",1,0,1,0,0,13,
17/03/2019,COAH.,"PIEDRAS NEGRAS, COAH.",0,0,0,10,0,0,
18/03/2019,CD. MÉX.,"BENITO JUAREZ, CD. MÉX.",5,3,8,0,0,727,
18/03/2019,S.L.P.,"SOLEDAD DE GRACIANO SANCHEZ, S.L.P.",0,1,1,0,0,0,
18/03/2019,S.L.P.,"CIUDAD VALLES, S.L.P.",0,0,0,4,0,0,
19/03/2019,CD. MÉX.,"COYOACAN, CD. MÉX.",11,4,15,0,1,228,
19/03/2019,S.L.P.,"SOLEDAD DE GRACIANO SANCHEZ, S.L.P.",2,0,2,4,0,0,
19/03/2019,COAH.,"FRANCISCO I. MADERO, COAH.",1,1,2,0,0,0,
19/03/2019,S.L.P.,"SAN LUIS POTOSI, S.L.P.",1,0,1,0,0,14,
19/03/2019,COAH.,"SALTILLO, COAH.",1,0,1,0,0,0,
20/03/2019,CD. MÉX.,"COYOACAN, CD. MÉX.",8,8,16,0,0,717,
20/03/2019,S.L.P.,"SOLEDAD DE GRACIANO SANCHEZ, S.L.P.",0,2,2,0,0,0,
20/03/2019,S.L.P.,"SAN LUIS POTOSI, S.L.P.",2,0,2,2,9,0,
20/03/2019,COAH.,"TORREÓN, COAH.",1,0,1,0,0,0,
20/03/2019,COAH.,"SAN PEDRO, COAH.",1,0,1,0,0,0,
20/03/2019,COAH.,"PIEDRAS NEGRAS, COAH.",0,1,1,0,0,0,
20/03/2019,Q. ROO.,"COZUMEL, Q. ROO",0,0,0,0,0,198,
20/03/2019,COAH.,"SALTILLO, COAH.",0,0,0,0,0,19,
21/03/2019,CD. MÉX.,"COYOACAN, CD. MÉX.",14,2,16,0,1,2591,
21/03/2019,COAH.,"MATAMOROS, COAH.",0,2,2,0,0,0,
21/03/2019,S.L.P.,"SAN LUIS POTOSI, S.L.P.",1,1,2,4,0,0,
21/03/2019,COAH.,"FRANCISCO I. MADERO, COAH.",0,1,1,0,0,0,
21/03/2019,Q. ROO.,"COZUMEL, Q. ROO",0,0,0,0,1,263,
22/03/2019,CD. MÉX.,"COYOACAN, CD. MÉX.",15,2,17,0,0,1510,
22/03/2019,S.L.P.,"SAN LUIS POTOSI, S.L.P.",1,2,3,0,0,0,
22/03/2019,S.L.P.,"SOLEDAD DE GRACIANO SANCHEZ, S.L.P.",1,1,2,0,4,0,
22/03/2019,COAH.,"SAN PEDRO, COAH.",1,0,1,0,0,0,
22/03/2019,Q. ROO.,"COZUMEL, Q. ROO",0,0,0,0,0,100,
22/03/2019,COAH.,"SALTILLO, COAH.",0,0,0,1,1,328,
22/03/2019,COAH.,"PIEDRAS NEGRAS, COAH.",0,0,0,0,0,507,
23/03/2019,CHIH.,"JUÁREZ, CHIH.",48,12,60,10,0,710,
23/03/2019,COAH.,"ACUÑA, COAH.",0,2,2,0,0,150,
23/03/2019,Q. ROO.,"COZUMEL, Q. ROO",0,1,1,0,0,332,
23/03/2019,COAH.,"PIEDRAS NEGRAS, COAH.",1,0,1,5,0,0,
24/03/2019,S.L.P.,"SOLEDAD DE GRACIANO SANCHEZ, S.L.P.",0,0,0,4,0,0,
24/03/2019,TAB.,"TENOSIQUE, TAB.",0,0,0,0,1,0,
25/03/2019,CD. MÉX.,"COYOACAN, CD. MÉX.",6,1,7,0,0,242,
25/03/2019,S.L.P.,"CIUDAD VALLES, S.L.P.",0,1,1,0,0,0,
25/03/2019,S.L.P.,"SAN LUIS POTOSI, S.L.P.",0,1,1,0,0,0,
25/03/2019,S.L.P.,"SOLEDAD DE GRACIANO SANCHEZ, S.L.P.",0,0,0,4,0,0,
25/03/2019,COAH.,"SALTILLO, COAH.",0,0,0,1,0,2,
26/03/2019,CD. MÉX.,"COYOACAN, CD. MÉX.",15,5,20,0,1,2119,
26/03/2019,S.L.P.,"SAN LUIS POTOSI, S.L.P.",1,1,2,0,1,0,
26/03/2019,VER.,"COATZINTLA, VER.",1,0,1,0,0,0,
26/03/2019,S.L.P.,"SOLEDAD DE GRACIANO SANCHEZ, S.L.P.",1,0,1,0,0,0,
26/03/2019,S.L.P.,"CIUDAD VALLES, S.L.P.",0,1,1,0,0,0,
26/03/2019,COAH.,"FRANCISCO I. MADERO, COAH.",1,0,1,0,0,0,
26/03/2019,COAH.,"MONCLOVA, COAH.",1,0,1,0,0,5,
27/03/2019,CD. MÉX.,"COYOACAN, CD. MÉX.",21,3,24,0,0,1199,
27/03/2019,S.L.P.,"CIUDAD VALLES, S.L.P.",2,0,2,4,0,0,
27/03/2019,COAH.,"PIEDRAS NEGRAS, COAH.",0,1,1,0,0,219,
27/03/2019,Q. ROO.,"BENITO JUAREZ, Q. ROO",1,0,1,0,0,55,
27/03/2019,S.L.P.,"RIOVERDE, S.L.P.",1,0,1,0,0,0,
27/03/2019,ZAC.,"GUADALUPE, ZAC.",0,0,0,7,0,165,
27/03/2019,ZAC.,"ZAC., ZAC.",0,0,0,3,0,30,
27/03/2019,ZAC.,"FRESNILLO, ZAC.",0,0,0,0,0,2113,
27/03/2019,VER.,"COATZINTLA, VER.",0,0,0,0,0,179,
28/03/2019,CD. MÉX.,"COYOACAN, CD. MÉX.",17,4,21,0,0,1918,
28/03/2019,COAH.,"SALTILLO, COAH.",1,1,2,0,0,253,
28/03/2019,COAH.,"MONCLOVA, COAH.",1,1,2,0,0,88,
28/03/2019,COAH.,"FRANCISCO I. MADERO, COAH.",0,1,1,0,0,0,
28/03/2019,S.L.P.,"SAN LUIS POTOSI, S.L.P.",0,0,0,0,0,124,
28/03/2019,ZAC.,"FRESNILLO, ZAC.",0,0,0,0,0,3110,
28/03/2019,COAH.,"SAN PEDRO, COAH.",0,0,0,0,0,14,
29/03/2019,CD. MÉX.,"COYOACAN, CD. MÉX.",538,5,543,0,0,1154,
29/03/2019,ZAC.,"FRESNILLO, ZAC.",5,1,6,0,0,3,
29/03/2019,JAL.,"CIHUATLAN, JAL.",1,1,2,0,1,0,
29/03/2019,DGO.,"GOMEZ PALACIO, DGO.",1,0,1,0,0,0,
29/03/2019,S.L.P.,"SAN LUIS POTOSI, S.L.P.",0,1,1,0,0,0,
29/03/2019,ZAC.,"GUADALUPE, ZAC.",1,0,1,8,0,93,
29/03/2019,COAH.,"TORREÓN, COAH.",1,0,1,0,0,0,
29/03/2019,COAH.,"FRANCISCO I. MADERO, COAH.",0,1,1,0,0,0,
30/03/2019,COAH.,"ACUÑA, COAH.",1,2,3,0,0,0,
30/03/2019,COAH.,"PIEDRAS NEGRAS, COAH.",0,0,0,7,0,598,
30/03/2019,COAH.,"MONCLOVA, COAH.",0,0,0,0,1,0,
30/03/2019,TAB.,"TENOSIQUE, TAB.",0,0,0,0,1,0,
30/03/2019,VER.,"COATZINTLA, VER.",0,0,0,0,0,39,
31/03/2019,S.L.P.,"SAN LUIS POTOSI, S.L.P.",1,1,2,0,3,0,
01/04/2019,CD. MÉX.,"GUSTAVO A. MADERO, CD. MÉX.",5,0,5,0,0,6,
01/04/2019,S.L.P.,"SAN LUIS POTOSI, S.L.P.",2,0,2,5,0,0,
01/04/2019,S.L.P.,"MATEHUALA, S.L.P.",0,1,1,0,0,0,
01/04/2019,ZAC.,"ZAC., ZAC.",1,0,1,0,0,0,
01/04/2019,ZAC.,"FRESNILLO, ZAC.",0,1,1,0,0,3500,
01/04/2019,COAH.,"SAN PEDRO, COAH.",1,0,1,7,0,0,
01/04/2019,COAH.,"MONCLOVA, COAH.",1,0,1,0,1,12,
01/04/2019,ZAC.,"GUADALUPE, ZAC.",0,0,0,5,0,200,
02/04/2019,CD. MÉX.,"MIGUEL HGO., CD. MÉX.",8,3,11,0,0,62,
02/04/2019,CD. MÉX.,"XOCHIMILCO, CD. MÉX.",1,1,2,0,0,32,
02/04/2019,COAH.,"FRANCISCO I. MADERO, COAH.",0,1,1,0,0,0,
02/04/2019,COAH.,"SALTILLO, COAH.",0,1,1,0,0,280,
02/04/2019,VER.,"MALTRATA, VER.",1,0,1,0,0,0,
02/04/2019,ZAC.,"ZAC., ZAC.",1,0,1,6,0,0,
02/04/2019,S.L.P.,"SAN LUIS POTOSI, S.L.P.",0,1,1,0,0,0,
02/04/2019,Q. ROO.,"BENITO JUAREZ, Q. ROO",0,0,0,0,0,58,
02/04/2019,ZAC.,"FRESNILLO, ZAC.",0,0,0,3,0,9493,
02/04/2019,ZAC.,"GUADALUPE, ZAC.",0,0,0,5,0,0,
03/04/2019,CD. MÉX.,"MIGUEL HGO., CD. MÉX.",8,1,9,0,0,1814,
03/04/2019,CD. MÉX.,"XOCHIMILCO, CD. MÉX.",5,4,9,0,0,112,
03/04/2019,CD. MÉX.,"IZTAPALAPA, CD. MÉX.",2,0,2,0,0,23,
03/04/2019,S.L.P.,"SAN LUIS POTOSI, S.L.P.",0,1,1,0,0,0,
03/04/2019,S.L.P.,"CIUDAD VALLES, S.L.P.",1,0,1,4,0,0,
03/04/2019,CHIH.,"OJINAGA, CHIH.",1,0,1,2,0,7,
03/04/2019,ZAC.,"GUADALUPE, ZAC.",0,0,0,18,0,244,
03/04/2019,ZAC.,"ZAC., ZAC.",0,0,0,8,0,0,
03/04/2019,ZAC.,"FRESNILLO, ZAC.",0,0,0,0,0,4227,
03/04/2019,COAH.,"PIEDRAS NEGRAS, COAH.",0,0,0,10,0,495,
04/04/2019,CD. MÉX.,"MIGUEL HGO., CD. MÉX.",4,4,8,0,0,613,
04/04/2019,CD. MÉX.,"XOCHIMILCO, CD. MÉX.",1,4,5,0,0,0,
04/04/2019,S.L.P.,"SAN LUIS POTOSI, S.L.P.",4,1,5,2,0,0,
04/04/2019,CD. MÉX.,"IZTAPALAPA, CD. MÉX.",4,0,4,0,3,217,
04/04/2019,COAH.,"SALTILLO, COAH.",0,1,1,0,0,0,
04/04/2019,COAH.,"MONCLOVA, COAH.",1,0,1,0,2,0,
04/04/2019,COAH.,"PIEDRAS NEGRAS, COAH.",0,1,1,2,0,60,
04/04/2019,S.L.P.,"CIUDAD VALLES, S.L.P.",1,0,1,0,0,0,
04/04/2019,COAH.,"RAMOS ARIZPE, COAH.",0,0,0,6,0,173,
04/04/2019,ZAC.,"FRESNILLO, ZAC.",0,0,0,2,0,2002,
04/04/2019,ZAC.,"GUADALUPE, ZAC.",0,0,0,4,0,0,
04/04/2019,ZAC.,"ZAC., ZAC.",0,0,0,0,0,4090,
05/04/2019,CD. MÉX.,"MIGUEL HGO., CD. MÉX.",4,0,4,0,0,335,
05/04/2019,ZAC.,"FRESNILLO, ZAC.",3,1,4,0,0,0,
05/04/2019,CD. MÉX.,"XOCHIMILCO, CD. MÉX.",2,2,4,0,0,17,
05/04/2019,CD. MÉX.,"IZTAPALAPA, CD. MÉX.",1,0,1,0,0,2441,
05/04/2019,COAH.,"SALTILLO, COAH.",1,0,1,0,0,0,
05/04/2019,COAH.,"MONCLOVA, COAH.",0,1,1,0,0,1,
05/04/2019,S.L.P.,"RIOVERDE, S.L.P.",1,0,1,0,0,0,
05/04/2019,S.L.P.,"SOLEDAD DE GRACIANO SANCHEZ, S.L.P.",1,0,1,0,0,0,
05/04/2019,S.L.P.,"MATEHUALA, S.L.P.",1,0,1,0,0,0,
05/04/2019,ZAC.,"ZAC., ZAC.",0,0,0,0,0,90,
05/04/2019,ZAC.,"GUADALUPE, ZAC.",0,0,0,21,0,28,
06/04/2019,S.L.P.,"SOLEDAD DE GRACIANO SANCHEZ, S.L.P.",1,0,1,2,0,0,
08/04/2019,CD. MÉX.,"MIGUEL HGO., CD. MÉX.",12,4,16,0,1,558,
08/04/2019,ZAC.,"FRESNILLO, ZAC.",0,11,11,0,0,0,
08/04/2019,CD. MÉX.,"XOCHIMILCO, CD. MÉX.",2,1,3,0,0,44,
08/04/2019,CD. MÉX.,"IZTAPALAPA, CD. MÉX.",1,1,2,0,0,100,
08/04/2019,S.L.P.,"SOLEDAD DE GRACIANO SANCHEZ, S.L.P.",0,0,0,5,0,0,
08/04/2019,Q. ROO.,"SOLIDARIDAD, Q. ROO",0,0,0,0,0,24,
09/04/2019,CD. MÉX.,"MIGUEL HGO., CD. MÉX.",11,2,13,0,1,1579,
09/04/2019,CD. MÉX.,"XOCHIMILCO, CD. MÉX.",3,3,6,0,0,51,
09/04/2019,CD. MÉX.,"IZTAPALAPA, CD. MÉX.",3,0,3,0,15,26,
09/04/2019,ZAC.,"ZAC., ZAC.",0,1,1,0,0,0,
09/04/2019,S.L.P.,"CIUDAD VALLES, S.L.P.",1,0,1,4,0,110,
09/04/2019,COAH.,"MONCLOVA, COAH.",0,0,0,0,1,0,
09/04/2019,ZAC.,"GUADALUPE, ZAC.",0,0,0,4,0,0,
09/04/2019,ZAC.,"FRESNILLO, ZAC.",0,0,0,0,0,5,
09/04/2019,S.L.P.,"SAN LUIS POTOSI, S.L.P.",0,0,0,9,0,0,
10/04/2019,CD. MÉX.,"MIGUEL HGO., CD. MÉX.",10,1,11,0,0,330,
10/04/2019,ZAC.,"FRESNILLO, ZAC.",6,2,8,5,0,65,
10/04/2019,CD. MÉX.,"XOCHIMILCO, CD. MÉX.",4,3,7,0,0,255,
10/04/2019,CD. MÉX.,"IZTAPALAPA, CD. MÉX.",3,0,3,0,15,21,
10/04/2019,ZAC.,"GUADALUPE, ZAC.",1,1,2,0,0,0,
10/04/2019,S.L.P.,"SAN LUIS POTOSI, S.L.P.",1,0,1,0,1,0,
10/04/2019,COAH.,"SALTILLO, COAH.",0,0,0,0,0,23,
10/04/2019,COAH.,"PIEDRAS NEGRAS, COAH.",0,0,0,0,0,113,
11/04/2019,CD. MÉX.,"MIGUEL HGO., CD. MÉX.",13,7,20,0,0,1254,
11/04/2019,CD. MÉX.,"XOCHIMILCO, CD. MÉX.",3,1,4,0,0,871,
11/04/2019,CD. MÉX.,"IZTAPALAPA, CD. MÉX.",2,0,2,0,0,50,
11/04/2019,ZAC.,"GUADALUPE, ZAC.",1,0,1,4,0,0,
11/04/2019,ZAC.,"FRESNILLO, ZAC.",1,0,1,1,0,0,
11/04/2019,S.L.P.,"SOLEDAD DE GRACIANO SANCHEZ, S.L.P.",0,1,1,0,0,0,
11/04/2019,ZAC.,"ZAC., ZAC.",0,0,0,4,0,0,
11/04/2019,Q. ROO.,"BENITO JUAREZ, Q. ROO",0,0,0,0,0,940,
11/04/2019,COAH.,"RAMOS ARIZPE, COAH.",0,0,0,0,0,120,
12/04/2019,CD. MÉX.,"MIGUEL HGO., CD. MÉX.",24,6,30,0,0,1014,
12/04/2019,CD. MÉX.,"IZTAPALAPA, CD. MÉX.",7,0,7,0,26,85,
12/04/2019,CD. MÉX.,"XOCHIMILCO, CD. MÉX.",3,3,6,0,0,25,
12/04/2019,ZAC.,"FRESNILLO, ZAC.",3,0,3,0,0,0,
12/04/2019,ZAC.,"GUADALUPE, ZAC.",0,1,1,0,2,0,
12/04/2019,COAH.,"RAMOS ARIZPE, COAH.",1,0,1,0,0,0,
12/04/2019,ZAC.,"ZAC., ZAC.",0,0,0,6,0,0,
12/04/2019,S.L.P.,"SAN LUIS POTOSI, S.L.P.",0,0,0,2,1,0,
13/04/2019,COAH.,"SAN PEDRO, COAH.",1,0,1,1,0,110,
13/04/2019,Q. ROO.,"BENITO JUAREZ, Q. ROO",0,0,0,0,0,290,
15/04/2019,CD. MÉX.,"XOCHIMILCO, CD. MÉX.",6,3,9,0,0,2873,
15/04/2019,CD. MÉX.,"IZTAPALAPA, CD. MÉX.",4,2,6,0,1,890,
15/04/2019,CD. MÉX.,"ALVARO OBREGON, CD. MÉX.",1,1,2,0,0,89,
15/04/2019,COAH.,"FRANCISCO I. MADERO, COAH.",1,0,1,0,0,0,
15/04/2019,S.L.P.,"CIUDAD VALLES, S.L.P.",0,1,1,0,0,0,
16/04/2019,CD. MÉX.,"ALVARO OBREGON, CD. MÉX.",8,3,11,0,0,373,
16/04/2019,CD. MÉX.,"IZTAPALAPA, CD. MÉX.",6,2,8,0,0,559,
16/04/2019,CD. MÉX.,"VENUSTIANO CARRANZA, CD. MÉX.",3,0,3,0,0,61,
16/04/2019,S.L.P.,"CIUDAD VALLES, S.L.P.",1,0,1,1,0,0,
16/04/2019,COAH.,"PIEDRAS NEGRAS, COAH.",0,0,0,0,0,9,
17/04/2019,S.L.P.,"SAN LUIS POTOSI, S.L.P.",1,0,1,3,0,0,
19/04/2019,S.L.P.,"CIUDAD VALLES, S.L.P.",1,0,1,0,0,0,
19/04/2019,VER.,"TLAPACOYAN, VER.",0,0,0,0,0,212,
20/04/2019,S.L.P.,"CIUDAD VALLES, S.L.P.",0,1,1,1,0,40,
22/04/2019,CD. MÉX.,"ALVARO OBREGON, CD. MÉX.",7,3,10,0,0,108,
22/04/2019,CD. MÉX.,"VENUSTIANO CARRANZA, CD. MÉX.",4,2,6,0,0,60,
22/04/2019,CD. MÉX.,"IZTAPALAPA, CD. MÉX.",1,2,3,0,0,0,
22/04/2019,S.L.P.,"CIUDAD VALLES, S.L.P.",2,0,2,3,0,0,
22/04/2019,COAH.,"FRANCISCO I. MADERO, COAH.",0,0,0,0,0,438,
23/04/2019,CD. MÉX.,"ALVARO OBREGON, CD. MÉX.",14,4,18,0,0,596,
23/04/2019,CD. MÉX.,"VENUSTIANO CARRANZA, CD. MÉX.",1,0,1,0,0,30,
23/04/2019,COAH.,"MATAMOROS, COAH.",0,1,1,0,0,0,
23/04/2019,VER.,"LAS VIGAS DE RAMIREZ, VER.",0,1,1,2,0,9,
23/04/2019,CD. MÉX.,"IZTAPALAPA, CD. MÉX.",0,0,0,0,3,18,
23/04/2019,COAH.,"SALTILLO, COAH.",0,0,0,0,0,38,
23/04/2019,VER.,"TANTOYUCA, VER.",0,0,0,0,1,0,
24/04/2019,CD. MÉX.,"ALVARO OBREGON, CD. MÉX.",7,6,13,0,0,963,
24/04/2019,CD. MÉX.,"VENUSTIANO CARRANZA, CD. MÉX.",1,0,1,0,0,38,
24/04/2019,CD. MÉX.,"IZTAPALAPA, CD. MÉX.",1,0,1,0,0,0,
25/04/2019,CD. MÉX.,"VENUSTIANO CARRANZA, CD. MÉX.",8,2,10,0,0,956,
25/04/2019,CD. MÉX.,"ALVARO OBREGON, CD. MÉX.",6,3,9,0,0,333,
25/04/2019,CHIH.,"JUÁREZ, CHIH.",1,0,1,7,0,0,
25/04/2019,VER.,"LAS VIGAS DE RAMIREZ, VER.",0,0,0,1,0,0,
25/04/2019,COAH.,"RAMOS ARIZPE, COAH.",0,0,0,0,0,45,
25/04/2019,COAH.,"MONCLOVA, COAH.",0,0,0,3,0,0,
25/04/2019,COAH.,"PIEDRAS NEGRAS, COAH.",0,0,0,0,0,12,
26/04/2019,CHIH.,"JUÁREZ, CHIH.",21,9,30,12,0,590,
26/04/2019,CD. MÉX.,"VENUSTIANO CARRANZA, CD. MÉX.",8,0,8,0,0,839,
26/04/2019,CD. MÉX.,"ALVARO OBREGON, CD. MÉX.",5,2,7,0,3,217,
26/04/2019,CD. MÉX.,"IZTAPALAPA, CD. MÉX.",1,0,1,0,0,0,
29/04/2019,CHIH.,"JUÁREZ, CHIH.",9,11,20,10,0,299,
29/04/2019,CD. MÉX.,"VENUSTIANO CARRANZA, CD. MÉX.",11,3,14,0,2,1465,
29/04/2019,CD. MÉX.,"ALVARO OBREGON, CD. MÉX.",4,0,4,0,0,810,
29/04/2019,CD. MÉX.,"IZTAPALAPA, CD. MÉX.",3,0,3,0,0,97,
29/04/2019,COAH.,"SALTILLO, COAH.",0,0,0,41,0,0,
30/04/2019,CHIH.,"JUÁREZ, CHIH.",4,8,12,0,0,474,
30/04/2019,CD. MÉX.,"IZTAPALAPA, CD. MÉX.",6,2,8,0,1,191,
30/04/2019,CD. MÉX.,"VENUSTIANO CARRANZA, CD. MÉX.",6,1,7,0,0,811,
30/04/2019,CD. MÉX.,"ALVARO OBREGON, CD. MÉX.",1,1,2,0,1,47,
30/04/2019,COAH.,"ACUÑA, COAH.",0,2,2,0,0,0,
30/04/2019,COAH.,"RAMOS ARIZPE, COAH.",0,0,0,0,0,210,
02/05/2019,CHIH.,"JUÁREZ, CHIH.",15,22,37,37,0,561,
02/05/2019,CD. MÉX.,"VENUSTIANO CARRANZA, CD. MÉX.",7,0,7,0,3,1366,
02/05/2019,CD. MÉX.,"IZTAPALAPA, CD. MÉX.",6,0,6,0,0,167,
02/05/2019,VER.,"PLATON SANCHEZ, VER.",1,0,1,0,0,0,
02/05/2019,VER.,"LAS VIGAS DE RAMIREZ, VER.",0,0,0,1,0,1,
02/05/2019,COAH.,"SALTILLO, COAH.",0,0,0,0,0,331,
02/05/2019,CD. MÉX.,"TLALPAN, CD. MÉX.",0,0,0,0,0,174,
03/05/2019,CHIH.,"JUÁREZ, CHIH.",5,2,7,11,0,298,
03/05/2019,CD. MÉX.,"IZTAPALAPA, CD. MÉX.",7,0,7,0,0,591,
03/05/2019,CD. MÉX.,"TLALPAN, CD. MÉX.",4,2,6,0,0,100,
03/05/2019,CD. MÉX.,"VENUSTIANO CARRANZA, CD. MÉX.",1,0,1,0,0,0,
06/05/2019,CHIH.,"JUÁREZ, CHIH.",4,2,6,19,0,495,
06/05/2019,CD. MÉX.,"IZTAPALAPA, CD. MÉX.",3,2,5,0,0,402,
06/05/2019,CD. MÉX.,"TLALPAN, CD. MÉX.",2,2,4,0,4,28,
06/05/2019,COAH.,"PIEDRAS NEGRAS, COAH.",1,0,1,0,0,0,
07/05/2019,CD. MÉX.,"AZCAPOTZALCO, CD. MÉX.",705,3,708,0,0,16,
07/05/2019,CD. MÉX.,"TLALPAN, CD. MÉX.",9,1,10,0,0,372,
07/05/2019,CD. MÉX.,"IZTAPALAPA, CD. MÉX.",5,0,5,0,1,808,
07/05/2019,COAH.,"MONCLOVA, COAH.",1,0,1,0,0,0,
07/05/2019,COAH.,"PIEDRAS NEGRAS, COAH.",1,0,1,0,0,0,
07/05/2019,COAH.,"SALTILLO, COAH.",0,0,0,0,0,236,
07/05/2019,COAH.,"RAMOS ARIZPE, COAH.",0,0,0,1,0,94,
08/05/2019,CD. MÉX.,"IZTAPALAPA, CD. MÉX.",3,3,6,0,0,35,
08/05/2019,CD. MÉX.,"TLALPAN, CD. MÉX.",2,4,6,0,0,302,
08/05/2019,CD. MÉX.,"AZCAPOTZALCO, CD. MÉX.",3,3,6,0,0,1484,
08/05/2019,COAH.,"PIEDRAS NEGRAS, COAH.",0,0,0,0,0,42,
09/05/2019,CHIH.,"JUÁREZ, CHIH.",3,2,5,16,0,1020,
09/05/2019,CD. MÉX.,"TLALPAN, CD. MÉX.",3,1,4,0,0,154,
09/05/2019,CD. MÉX.,"IZTAPALAPA, CD. MÉX.",3,0,3,0,0,69,
09/05/2019,CD. MÉX.,"AZCAPOTZALCO, CD. MÉX.",1,1,2,0,0,158,
09/05/2019,COAH.,"MONCLOVA, COAH.",1,0,1,0,0,49,
09/05/2019,TAB.,"TEAPA, TAB.",1,0,1,0,0,0,
09/05/2019,COAH.,"SALTILLO, COAH.",0,0,0,0,0,278,
10/05/2019,CHIH.,"JUÁREZ, CHIH.",8,1,9,8,2,67,
10/05/2019,CD. MÉX.,"AZCAPOTZALCO, CD. MÉX.",2,3,5,0,0,75,
10/05/2019,CD. MÉX.,"IZTAPALAPA, CD. MÉX.",4,0,4,0,0,96,
10/05/2019,CD. MÉX.,"TLALPAN, CD. MÉX.",2,0,2,0,0,672,
10/05/2019,COAH.,"SALTILLO, COAH.",0,0,0,4,0,250,
13/05/2019,CD. MÉX.,"TLALPAN, CD. MÉX.",5,2,7,0,0,512,
13/05/2019,CHIH.,"JUÁREZ, CHIH.",4,0,4,14,0,630,
13/05/2019,COAH.,"FRANCISCO I. MADERO, COAH.",3,0,3,0,0,0,
13/05/2019,COAH.,"PIEDRAS NEGRAS, COAH.",3,0,3,1,0,62,
13/05/2019,CD. MÉX.,"IZTAPALAPA, CD. MÉX.",2,0,2,0,0,84,
13/05/2019,COAH.,"TORREÓN, COAH.",0,0,0,3,0,0,
13/05/2019,COAH.,"SALTILLO, COAH.",0,0,0,170,0,0,
14/05/2019,CD. MÉX.,"TLALPAN, CD. MÉX.",8,0,8,0,0,478,
14/05/2019,CHIH.,"JUÁREZ, CHIH.",4,3,7,6,0,982,
14/05/2019,CD. MÉX.,"IZTAPALAPA, CD. MÉX.",3,1,4,0,0,0,
14/05/2019,CD. MÉX.,"AZCAPOTZALCO, CD. MÉX.",0,2,2,0,0,1113,
14/05/2019,COAH.,"SALTILLO, COAH.",0,0,0,1,0,0,
14/05/2019,COAH.,"RAMOS ARIZPE, COAH.",0,0,0,0,0,102,
14/05/2019,COAH.,"PIEDRAS NEGRAS, COAH.",0,0,0,0,0,41,
15/05/2019,CD. MÉX.,"AZCAPOTZALCO, CD. MÉX.",8,1,9,0,0,956,
15/05/2019,CD. MÉX.,"IZTAPALAPA, CD. MÉX.",7,0,7,0,0,48,
15/05/2019,ZAC.,"FRESNILLO, ZAC.",3,3,6,11,0,0,
15/05/2019,CHIH.,"JUÁREZ, CHIH.",0,4,4,7,0,267,
15/05/2019,CD. MÉX.,"TLALPAN, CD. MÉX.",2,1,3,0,0,667,
15/05/2019,ZAC.,"GUADALUPE, ZAC.",2,0,2,3,0,33,
15/05/2019,CHIH.,"OJINAGA, CHIH.",1,0,1,0,0,0,
15/05/2019,ZAC.,"GUADALUPE, ZAC.",0,0,0,3,0,350,
15/05/2019,COAH.,"SALTILLO, COAH.",0,0,0,0,0,150,
15/05/2019,COAH.,"PIEDRAS NEGRAS, COAH.",0,0,0,8,0,0,
16/05/2019,CD. MÉX.,"VENUSTIANO CARRANZA, CD. MÉX.",3,1,4,0,0,48,
16/05/2019,CHIH.,"JUÁREZ, CHIH.",2,0,2,23,0,270,
16/05/2019,CD. MÉX.,"AZCAPOTZALCO, CD. MÉX.",1,0,1,0,0,0,
16/05/2019,COAH.,"PIEDRAS NEGRAS, COAH.",1,0,1,0,0,0,
16/05/2019,ZAC.,"GUADALUPE, ZAC.",0,1,1,0,0,0,
16/05/2019,CD. MÉX.,"IZTAPALAPA, CD. MÉX.",0,0,0,3,30,0,
16/05/2019,ZAC.,"ZAC., ZAC.",0,0,0,16,0,80,
17/05/2019,CHIH.,"JUÁREZ, CHIH.",6,0,6,48,0,713,
17/05/2019,CD. MÉX.,"VENUSTIANO CARRANZA, CD. MÉX.",3,1,4,0,0,185,
17/05/2019,CD. MÉX.,"IZTAPALAPA, CD. MÉX.",3,0,3,0,3,5,
17/05/2019,CD. MÉX.,"AZCAPOTZALCO, CD. MÉX.",2,0,2,0,0,375,
17/05/2019,COAH.,"PIEDRAS NEGRAS, COAH.",1,0,1,0,0,11,
17/05/2019,ZAC.,"ZAC., ZAC.",1,0,1,1,0,0,
17/05/2019,ZAC.,"FRESNILLO, ZAC.",1,0,1,1,0,0,
17/05/2019,ZAC.,"GUADALUPE, ZAC.",0,0,0,0,0,200,
20/05/2019,CD. MÉX.,"VENUSTIANO CARRANZA, CD. MÉX.",5,3,8,0,0,491,
20/05/2019,CD. MÉX.,"MILPA ALTA, CD. MÉX.",3,1,4,0,0,48,
20/05/2019,CHIH.,"JUÁREZ, CHIH.",3,1,4,3,0,176,
20/05/2019,COAH.,"PIEDRAS NEGRAS, COAH.",0,1,1,0,0,0,
20/05/2019,ZAC.,"GUADALUPE, ZAC.",0,0,0,4,0,250,
20/05/2019,ZAC.,"FRESNILLO, ZAC.",0,0,0,0,0,18,
21/05/2019,CD. MÉX.,"VENUSTIANO CARRANZA, CD. MÉX.",11,1,12,0,0,236,
21/05/2019,CD. MÉX.,"IZTAPALAPA, CD. MÉX.",9,3,12,0,0,42,
21/05/2019,CHIH.,"JUÁREZ, CHIH.",1,4,5,33,0,350,
21/05/2019,CD. MÉX.,"MILPA ALTA, CD. MÉX.",3,1,4,0,0,32,
21/05/2019,ZAC.,"FRESNILLO, ZAC.",2,0,2,2,0,0,
22/05/2019,CHIH.,"JUÁREZ, CHIH.",6,5,11,29,0,1578,
22/05/2019,CD. MÉX.,"VENUSTIANO CARRANZA, CD. MÉX.",5,4,9,0,2,331,
22/05/2019,CD. MÉX.,"IZTAPALAPA, CD. MÉX.",6,0,6,0,1,5,
22/05/2019,CD. MÉX.,"MILPA ALTA, CD. MÉX.",2,3,5,0,0,44,
22/05/2019,COAH.,"PIEDRAS NEGRAS, COAH.",0,1,1,0,0,4,
22/05/2019,COAH.,"ACUÑA, COAH.",1,0,1,0,0,0,
23/05/2019,CHIH.,"JUÁREZ, CHIH.",3,5,8,19,0,547,
23/05/2019,CD. MÉX.,"IZTAPALAPA, CD. MÉX.",1,5,6,0,0,31,
23/05/2019,CD. MÉX.,"VENUSTIANO CARRANZA, CD. MÉX.",5,0,5,0,0,142,
23/05/2019,CD. MÉX.,"MILPA ALTA, CD. MÉX.",3,0,3,0,0,59,
23/05/2019,ZAC.,"FRESNILLO, ZAC.",1,0,1,1,0,65,
23/05/2019,ZAC.,"GUADALUPE, ZAC.",0,0,0,6,0,313,
24/05/2019,CD. MÉX.,"VENUSTIANO CARRANZA, CD. MÉX.",10,2,12,0,0,123,
24/05/2019,CD. MÉX.,"IZTAPALAPA, CD. MÉX.",8,1,9,0,3,403,
24/05/2019,ZAC.,"FRESNILLO, ZAC.",3,0,3,0,0,0,
24/05/2019,CD. MÉX.,"MILPA ALTA, CD. MÉX.",2,0,2,0,1,25,
24/05/2019,ZAC.,"GUADALUPE, ZAC.",1,0,1,4,0,220,
24/05/2019,ZAC.,"ZAC., ZAC.",0,0,0,0,0,26,
27/05/2019,CD. MÉX.,"VENUSTIANO CARRANZA, CD. MÉX.",16,5,21,0,0,1168,
27/05/2019,CD. MÉX.,"IZTAPALAPA, CD. MÉX.",7,3,10,0,0,507,
27/05/2019,CD. MÉX.,"MILPA ALTA, CD. MÉX.",0,2,2,0,0,70,
27/05/2019,COAH.,"SALTILLO, COAH.",0,2,2,4,0,397,
27/05/2019,COAH.,"RAMOS ARIZPE, COAH.",1,1,2,1,0,18,
27/05/2019,COAH.,"ACUÑA, COAH.",0,1,1,0,0,0,
27/05/2019,ZAC.,"GUADALUPE, ZAC.",0,0,0,3,0,300,
28/05/2019,CD. MÉX.,"VENUSTIANO CARRANZA, CD. MÉX.",8,2,10,0,0,432,
28/05/2019,CD. MÉX.,"IZTAPALAPA, CD. MÉX.",6,2,8,0,3,2950,
28/05/2019,CHIH.,"JUÁREZ, CHIH.",3,2,5,10,0,371,
28/05/2019,COAH.,"PIEDRAS NEGRAS, COAH.",0,2,2,0,0,0,
28/05/2019,VER.,"NOGALES, VER.",1,0,1,0,0,0,
28/05/2019,COAH.,"SALTILLO, COAH.",1,0,1,0,0,10,
28/05/2019,ZAC.,"FRESNILLO, ZAC.",1,0,1,0,0,0,
28/05/2019,ZAC.,"GUADALUPE, ZAC.",0,0,0,2,0,2154,
28/05/2019,CD. MÉX.,"MILPA ALTA, CD. MÉX.",0,0,0,0,0,16,
29/05/2019,CD. MÉX.,"VENUSTIANO CARRANZA, CD. MÉX.",28,2,30,0,0,2047,
29/05/2019,CD. MÉX.,"IZTAPALAPA, CD. MÉX.",11,5,16,0,0,536,
29/05/2019,CD. MÉX.,"MILPA ALTA, CD. MÉX.",3,2,5,0,0,106,
29/05/2019,CHIH.,"JUÁREZ, CHIH.",5,0,5,53,0,57,
29/05/2019,COAH.,"PIEDRAS NEGRAS, COAH.",0,0,0,5,0,86,
29/05/2019,ZAC.,"GUADALUPE, ZAC.",0,0,0,0,0,1500,
29/05/2019,VER.,"NOGALES, VER.",0,0,0,0,1,0,
30/05/2019,CD. MÉX.,"IZTAPALAPA, CD. MÉX.",6,2,8,0,0,485,
30/05/2019,MÉX.,"ECATEPEC DE MOR., MEX.",4,0,4,0,0,0,
30/05/2019,QRO.,"CORREGIDORA, QRO.",2,1,3,0,0,0,
30/05/2019,ZAC.,"FRESNILLO, ZAC.",1,2,3,0,0,0,
30/05/2019,CD. MÉX.,"MILPA ALTA, CD. MÉX.",2,0,2,0,0,45,
30/05/2019,VER.,"NOGALES, VER.",0,1,1,0,0,0,
30/05/2019,ZAC.,"GUADALUPE, ZAC.",1,0,1,4,0,250,
30/05/2019,CD. MÉX.,"AZCAPOTZALCO, CD. MÉX.",1,0,1,0,0,922,
31/05/2019,CD. MÉX.,"IZTAPALAPA, CD. MÉX.",6,0,6,0,0,330,
31/05/2019,CD. MÉX.,"MILPA ALTA, CD. MÉX.",5,0,5,0,0,32,
31/05/2019,ZAC.,"FRESNILLO, ZAC.",1,3,4,0,0,0,
31/05/2019,QRO.,"CORREGIDORA, QRO.",3,1,4,0,0,0,
31/05/2019,CD. MÉX.,"AZCAPOTZALCO, CD. MÉX.",3,0,3,0,0,135,
31/05/2019,QRO.,"CORREGIDORA, QRO.",2,1,3,0,0,0,
31/05/2019,MÉX.,"ECATEPEC DE MOR., MEX.",2,0,2,0,0,0,
31/05/2019,ZAC.,"GUADALUPE, ZAC.",0,0,0,4,2,107,
01/06/2019,MÉX.,"ECATEPEC DE MOR., MEX.",6,3,9,0,1,0,
01/06/2019,COL.,"COL., COL.",1,0,1,0,0,0,
02/06/2019,MÉX.,"ECATEPEC DE MOR., MEX.",3,0,3,0,0,0,
03/06/2019,MÉX.,"ECATEPEC DE MOR., MEX.",2,2,4,0,1,0,
03/06/2019,CD. MÉX.,"AZCAPOTZALCO, CD. MÉX.",3,0,3,0,0,0,
03/06/2019,CD. MÉX.,"IZTAPALAPA, CD. MÉX.",1,1,2,0,0,60,
03/06/2019,CD. MÉX.,"LA MAGDALENA CONTRERAS, CD. MÉX.",0,1,1,0,0,3,
03/06/2019,ZAC.,"GUADALUPE, ZAC.",0,0,0,3,0,309,
04/06/2019,CD. MÉX.,"AZCAPOTZALCO, CD. MÉX.",8,1,9,0,0,231,
04/06/2019,MÉX.,"ECATEPEC DE MOR., MEX.",5,0,5,0,2,190,
04/06/2019,CD. MÉX.,"IZTAPALAPA, CD. MÉX.",4,0,4,0,0,213,
04/06/2019,CD. MÉX.,"LA MAGDALENA CONTRERAS, CD. MÉX.",1,2,3,0,0,0,
04/06/2019,ZAC.,"ZAC., ZAC.",1,0,1,0,0,1100,
04/06/2019,COAH.,"PIEDRAS NEGRAS, COAH.",1,0,1,0,0,0,
04/06/2019,COAH.,"ACUÑA, COAH.",1,0,1,0,0,0,
05/06/2019,CD. MÉX.,"AZCAPOTZALCO, CD. MÉX.",4,2,6,0,0,101,
05/06/2019,CD. MÉX.,"IZTAPALAPA, CD. MÉX.",3,0,3,0,0,46,
05/06/2019,ZAC.,"FRESNILLO, ZAC.",3,0,3,1,0,7,
05/06/2019,ZAC.,"GUADALUPE, ZAC.",1,0,1,0,0,800,
05/06/2019,COAH.,"PIEDRAS NEGRAS, COAH.",0,0,0,0,0,91,
05/06/2019,COAH.,"ACUÑA, COAH.",0,0,0,0,0,45,
06/06/2019,CD. MÉX.,"AZCAPOTZALCO, CD. MÉX.",3,5,8,0,0,450,
06/06/2019,CD. MÉX.,"IZTAPALAPA, CD. MÉX.",4,2,6,0,0,123,
06/06/2019,CD. MÉX.,"LA MAGDALENA CONTRERAS, CD. MÉX.",0,1,1,0,0,0,
06/06/2019,QRO.,"CORREGIDORA, QRO.",0,1,1,0,0,0,
06/06/2019,MÉX.,"COACALCO DE BERRIOZABAL, MEX.",0,1,1,0,0,0,
06/06/2019,ZAC.,"GUADALUPE, ZAC.",0,0,0,1,0,19,
06/06/2019,MÉX.,"SAN MARTIN DE LAS PIRAMIDES, MEX.",0,0,0,0,7,878,
07/06/2019,MÉX.,"ECATEPEC DE MOR., MEX.",6,5,11,4,4,4916,
07/06/2019,CD. MÉX.,"AZCAPOTZALCO, CD. MÉX.",10,0,10,0,0,345,
07/06/2019,CD. MÉX.,"LA MAGDALENA CONTRERAS, CD. MÉX.",4,1,5,0,13,0,
07/06/2019,QRO.,"SAN JUAN DEL RIO, QRO.",2,3,5,0,3,0,
07/06/2019,CD. MÉX.,"IZTAPALAPA, CD. MÉX.",4,0,4,0,0,438,
07/06/2019,ZAC.,"FRESNILLO, ZAC.",2,0,2,0,0,0,
07/06/2019,DGO.,"GOMEZ PALACIO, DGO.",2,0,2,0,0,0,
07/06/2019,COAH.,"RAMOS ARIZPE, COAH.",0,0,0,30,0,17,
07/06/2019,COAH.,"ACUÑA, COAH.",0,0,0,1,0,570,
08/06/2019,QRO.,"SAN JUAN DEL RIO, QRO.",0,2,2,0,0,0,
09/06/2019,QRO.,"SAN JUAN DEL RIO, QRO.",2,1,3,0,0,0,
10/06/2019,CD. MÉX.,"AZCAPOTZALCO, CD. MÉX.",7,2,9,0,1,160,
10/06/2019,CD. MÉX.,"IZTAPALAPA, CD. MÉX.",3,1,4,0,0,95,
10/06/2019,ZAC.,"FRESNILLO, ZAC.",1,1,2,1,0,6,
10/06/2019,ZAC.,"ZAC., ZAC.",0,0,0,4,0,0,
10/06/2019,Q. ROO.,"OTHON P. BLANCO, Q. ROO",0,0,0,0,5,105,
11/06/2019,CD. MÉX.,"AZCAPOTZALCO, CD. MÉX.",4,11,15,0,0,1267,
11/06/2019,DGO.,"DGO., DGO.",1,3,4,0,0,0,
11/06/2019,CD. MÉX.,"LA MAGDALENA CONTRERAS, CD. MÉX.",4,0,4,0,0,114,
11/06/2019,CD. MÉX.,"IZTAPALAPA, CD. MÉX.",3,0,3,0,0,84,
11/06/2019,ZAC.,"FRESNILLO, ZAC.",1,0,1,0,0,0,
11/06/2019,Q. ROO.,"OTHON P. BLANCO, Q. ROO",1,0,1,0,23,0,
11/06/2019,ZAC.,"ZAC., ZAC.",0,0,0,5,0,38,
12/06/2019,CD. MÉX.,"AZCAPOTZALCO, CD. MÉX.",6,1,7,0,0,792,
12/06/2019,CD. MÉX.,"IZTAPALAPA, CD. MÉX.",3,3,6,0,1,57,
12/06/2019,DGO.,"DGO., DGO.",1,3,4,20,0,0,
12/06/2019,CD. MÉX.,"LA MAGDALENA CONTRERAS, CD. MÉX.",2,1,3,0,0,0,
12/06/2019,QRO.,"AMEALCO DE BONFIL, QRO.",0,1,1,0,0,0,
12/06/2019,ZAC.,"FRESNILLO, ZAC.",0,1,1,0,0,75,
12/06/2019,ZAC.,"GUADALUPE, ZAC.",0,0,0,0,0,160,
12/06/2019,ZAC.,"ZAC., ZAC.",0,0,0,0,0,82,
13/06/2019,QRO.,"CORREGIDORA, QRO.",3,0,3,0,2,0,
13/06/2019,CD. MÉX.,"IZTACALCO, CD. MÉX.",2,1,3,0,1,0,
13/06/2019,CD. MÉX.,"IZTAPALAPA, CD. MÉX.",0,3,3,0,0,225,
13/06/2019,CD. MÉX.,"LA MAGDALENA CONTRERAS, CD. MÉX.",3,0,3,0,16,7,
13/06/2019,DGO.,"DGO., DGO.",2,0,2,0,0,0,
13/06/2019,VER.,"NAUTLA, VER.",1,0,1,0,0,0,
13/06/2019,ZAC.,"GUADALUPE, ZAC.",1,0,1,7,0,100,
13/06/2019,ZAC.,"FRESNILLO, ZAC.",1,0,1,0,0,0,
13/06/2019,ZAC.,"ZAC., ZAC.",0,0,0,0,0,106,
13/06/2019,COAH.,"SALTILLO, COAH.",0,0,0,0,2,13,
14/06/2019,CD. MÉX.,"IZTACALCO, CD. MÉX.",5,0,5,0,1,56,
14/06/2019,CD. MÉX.,"IZTAPALAPA, CD. MÉX.",3,1,4,0,0,0,
14/06/2019,QRO.,"CORREGIDORA, QRO.",3,1,4,0,0,0,
14/06/2019,COAH.,"SALTILLO, COAH.",0,1,1,0,1,309,
14/06/2019,Q. ROO.,"BENITO JUAREZ, Q. ROO",0,1,1,0,0,8,
14/06/2019,DGO.,"DGO., DGO.",0,1,1,0,0,0,
15/06/2019,QRO.,"JALPAN DE SERRA, QRO.",1,1,2,0,0,0,
17/06/2019,CD. MÉX.,"IZTAPALAPA, CD. MÉX.",4,0,4,0,0,52,
17/06/2019,CD. MÉX.,"IZTACALCO, CD. MÉX.",3,0,3,0,1,0,
17/06/2019,CHIH.,"IGNACIO ZARAGOZA, CHIH.",0,1,1,0,0,0,
17/06/2019,CD. MÉX.,"TLAHUAC, CD. MÉX.",0,1,1,0,1,387,
17/06/2019,ZAC.,"FRESNILLO, ZAC.",0,1,1,0,0,0,
18/06/2019,CD. MÉX.,"IZTACALCO, CD. MÉX.",5,3,8,0,0,366,
18/06/2019,CD. MÉX.,"IZTAPALAPA, CD. MÉX.",2,1,3,0,0,6,
18/06/2019,CHIH.,"IGNACIO ZARAGOZA, CHIH.",1,0,1,0,1,0,
18/06/2019,ZAC.,"ZAC., ZAC.",1,0,1,0,0,2,
18/06/2019,Q. ROO.,"BENITO JUAREZ, Q. ROO",0,0,0,0,0,38,
19/06/2019,CD. MÉX.,"TLAHUAC, CD. MÉX.",8,1,9,0,0,48,
19/06/2019,CD. MÉX.,"IZTACALCO, CD. MÉX.",7,1,8,0,0,236,
19/06/2019,CD. MÉX.,"IZTAPALAPA, CD. MÉX.",6,1,7,0,1,84,
19/06/2019,DGO.,"DGO., DGO.",1,1,2,0,0,0,
19/06/2019,ZAC.,"GUADALUPE, ZAC.",1,0,1,2,0,100,
19/06/2019,ZAC.,"ZAC., ZAC.",0,1,1,4,0,0,
19/06/2019,Q. ROO.,"BENITO JUAREZ, Q. ROO",1,0,1,0,0,0,
19/06/2019,VER.,"MINATITLAN, VER.",1,0,1,1,0,24,
19/06/2019,COAH.,"PIEDRAS NEGRAS, COAH.",0,0,0,0,0,28,
19/06/2019,VER.,"NAUTLA, VER.",0,0,0,1,0,28,
20/06/2019,CD. MÉX.,"IZTACALCO, CD. MÉX.",5,1,6,0,3,353,
20/06/2019,CD. MÉX.,"IZTAPALAPA, CD. MÉX.",2,1,3,0,0,3,
20/06/2019,VER.,"MINATITLAN, VER.",1,1,2,1,0,24,
20/06/2019,VER.,"PUEBLO VIEJO, VER.",0,1,1,0,0,0,
20/06/2019,ZAC.,"GUADALUPE, ZAC.",0,0,0,4,0,0,
20/06/2019,ZAC.,"ZAC., ZAC.",0,0,0,1,0,0,
21/06/2019,CD. MÉX.,"TLAHUAC, CD. MÉX.",4,0,4,0,0,52,
21/06/2019,CD. MÉX.,"IZTACALCO, CD. MÉX.",3,0,3,0,0,193,
21/06/2019,CD. MÉX.,"IZTAPALAPA, CD. MÉX.",3,0,3,0,0,24,
21/06/2019,VER.,"MINATITLAN, VER.",3,0,3,2,0,25,
21/06/2019,COAH.,"PIEDRAS NEGRAS, COAH.",2,0,2,0,0,0,
21/06/2019,VER.,"PUEBLO VIEJO, VER.",0,1,1,0,0,0,
21/06/2019,VER.,"NAUTLA, VER.",1,0,1,0,0,0,
21/06/2019,DGO.,"DGO., DGO.",1,0,1,1,0,0,
22/06/2019,QRO.,"PINAL DE AMOLES, QRO.",1,0,1,0,0,0,
23/06/2019,QRO.,"PINAL DE AMOLES, QRO.",2,0,2,0,0,0,
24/06/2019,CD. MÉX.,"IZTACALCO, CD. MÉX.",12,2,14,0,0,420,
24/06/2019,CD. MÉX.,"IZTAPALAPA, CD. MÉX.",4,1,5,0,0,57,
24/06/2019,COAH.,"SALTILLO, COAH.",0,0,0,3,0,133,
25/06/2019,CD. MÉX.,"IZTACALCO, CD. MÉX.",5,2,7,0,12,1910,
25/06/2019,CD. MÉX.,"TLAHUAC, CD. MÉX.",0,3,3,0,0,1,
25/06/2019,CD. MÉX.,"IZTAPALAPA, CD. MÉX.",2,0,2,0,0,682,
26/06/2019,CD. MÉX.,"IZTACALCO, CD. MÉX.",6,0,6,0,0,587,
26/06/2019,COAH.,"ACUÑA, COAH.",3,0,3,1,0,0,
26/06/2019,CD. MÉX.,"IZTAPALAPA, CD. MÉX.",0,2,2,0,0,11,
26/06/2019,CD. MÉX.,"TLAHUAC, CD. MÉX.",1,1,2,0,0,1631,
26/06/2019,Q. ROO.,"SOLIDARIDAD, Q. ROO",1,0,1,0,0,57,
26/06/2019,DGO.,"DGO., DGO.",1,0,1,0,0,0,
27/06/2019,CD. MÉX.,"IZTAPALAPA, CD. MÉX.",6,1,7,0,0,4,
27/06/2019,CD. MÉX.,"TLAHUAC, CD. MÉX.",2,1,3,0,0,259,
27/06/2019,CD. MÉX.,"XOCHIMILCO, CD. MÉX.",1,1,2,0,0,0,
27/06/2019,COAH.,"SALTILLO, COAH.",1,0,1,0,0,9,
27/06/2019,Q. ROO.,"BENITO JUAREZ, Q. ROO",0,0,0,0,0,50,
28/06/2019,CHIH.,"NUEVO CASAS GRANDES, CHIH.",4,2,6,0,3,959,
28/06/2019,COAH.,"ACUÑA, COAH.",0,3,3,0,0,0,
28/06/2019,CD. MÉX.,"XOCHIMILCO, CD. MÉX.",3,0,3,0,0,447,
28/06/2019,CD. MÉX.,"TLAHUAC, CD. MÉX.",3,0,3,0,0,53,
29/06/2019,QRO.,"ARROYO SECO, QRO.",1,0,1,0,0,0,
30/06/2019,CHIS.,"BENEMÉRITO DE LAS AMÉRICAS, CHIS.",0,1,1,0,0,0,
30/06/2019,ZAC.,"GUADALUPE, ZAC.",0,0,0,5,0,100,
30/06/2019,ZAC.,"FRESNILLO, ZAC.",0,0,0,1,0,0,
01/07/2019,CD. MÉX.,"TLAHUAC, CD. MÉX.",3,0,3,0,0,0,
01/07/2019,CD. MÉX.,"XOCHIMILCO, CD. MÉX.",1,1,2,0,0,177,
01/07/2019,CD. MÉX.,"IZTAPALAPA, CD. MÉX.",1,0,1,0,0,73,
01/07/2019,AGS.,"AGS., AGS.",1,0,1,4,0,281,
02/07/2019,AGS.,"AGS., AGS.",1,2,3,5,0,166,
02/07/2019,CD. MÉX.,"MILPA ALTA, CD. MÉX.",0,2,2,0,0,1272,
02/07/2019,COAH.,"SAN PEDRO, COAH.",0,2,2,1,0,6,
02/07/2019,CD. MÉX.,"XOCHIMILCO, CD. MÉX.",1,0,1,0,0,0,
02/07/2019,CD. MÉX.,"IZTAPALAPA, CD. MÉX.",1,0,1,0,0,669,
02/07/2019,COAH.,"MATAMOROS, COAH.",0,0,0,0,4,0,
02/07/2019,ZAC.,"GUADALUPE, ZAC.",0,0,0,7,0,295,
03/07/2019,COAH.,"MATAMOROS, COAH.",7,0,7,1,0,0,
03/07/2019,CD. MÉX.,"IZTAPALAPA, CD. MÉX.",3,1,4,0,1,344,
03/07/2019,COAH.,"ACUÑA, COAH.",0,3,3,0,0,0,
03/07/2019,CD. MÉX.,"XOCHIMILCO, CD. MÉX.",2,0,2,0,1,68,
03/07/2019,CD. MÉX.,"MILPA ALTA, CD. MÉX.",0,2,2,0,0,0,
03/07/2019,DGO.,"DGO., DGO.",1,1,2,0,0,0,
03/07/2019,ZAC.,"FRESNILLO, ZAC.",0,1,1,0,0,0,
03/07/2019,AGS.,"AGS., AGS.",1,0,1,0,0,59,
04/07/2019,CD. MÉX.,"XOCHIMILCO, CD. MÉX.",3,1,4,0,0,4,
04/07/2019,DGO.,"DGO., DGO.",4,0,4,0,0,0,
04/07/2019,CD. MÉX.,"IZTAPALAPA, CD. MÉX.",3,0,3,0,0,22,
04/07/2019,AGS.,"AGS., AGS.",2,0,2,3,0,39,
04/07/2019,ZAC.,"FRESNILLO, ZAC.",0,2,2,0,0,0,
04/07/2019,CD. MÉX.,"MILPA ALTA, CD. MÉX.",0,1,1,0,0,0,
04/07/2019,ZAC.,"GUADALUPE, ZAC.",0,0,0,4,0,236,
04/07/2019,ZAC.,"ZAC., ZAC.",0,0,0,0,0,16,
05/07/2019,ZAC.,"FRESNILLO, ZAC.",2,0,2,0,0,0,
05/07/2019,CD. MÉX.,"IZTAPALAPA, CD. MÉX.",2,0,2,0,0,118,
05/07/2019,CD. MÉX.,"MILPA ALTA, CD. MÉX.",1,1,2,0,0,0,
05/07/2019,Q. ROO.,"BENITO JUAREZ, Q. ROO",1,0,1,0,0,7,
05/07/2019,CD. MÉX.,"XOCHIMILCO, CD. MÉX.",1,0,1,0,0,6,
05/07/2019,AGS.,"AGS., AGS.",1,0,1,3,0,106,
08/07/2019,CD. MÉX.,"XOCHIMILCO, CD. MÉX.",4,1,5,0,0,903,
08/07/2019,CD. MÉX.,"IZTAPALAPA, CD. MÉX.",4,1,5,0,0,15,
08/07/2019,AGS.,"AGS., AGS.",1,1,2,3,0,178,
08/07/2019,ZAC.,"ZAC., ZAC.",1,0,1,0,0,1,
08/07/2019,CD. MÉX.,"MILPA ALTA, CD. MÉX.",0,0,0,0,0,50,
08/07/2019,ZAC.,"GUADALUPE, ZAC.",0,0,0,3,0,248,
09/07/2019,CD. MÉX.,"XOCHIMILCO, CD. MÉX.",6,1,7,0,0,29,
09/07/2019,CD. MÉX.,"MILPA ALTA, CD. MÉX.",0,3,3,0,0,204,
09/07/2019,ZAC.,"FRESNILLO, ZAC.",2,0,2,0,0,0,
09/07/2019,CD. MÉX.,"IZTAPALAPA, CD. MÉX.",2,0,2,0,0,0,
09/07/2019,VER.,"TAMPICO ALTO, VER.",0,1,1,0,0,0,
09/07/2019,AGS.,"AGS., AGS.",1,0,1,3,1,62,
09/07/2019,ZAC.,"GUADALUPE, ZAC.",0,0,0,2,0,200,
10/07/2019,JAL.,"LA HUERTA, JAL.",1,3,4,0,0,54,
10/07/2019,COAH.,"FRANCISCO I. MADERO, COAH.",1,1,2,0,0,0,
10/07/2019,AGS.,"AGS., AGS.",2,0,2,0,0,0,
10/07/2019,ZAC.,"ZAC., ZAC.",1,0,1,0,0,0,
10/07/2019,VER.,"SAN ANDRES TUXTLA, VER.",1,0,1,0,0,0,
11/07/2019,ZAC.,"FRESNILLO, ZAC.",2,0,2,1,0,161,
11/07/2019,CD. MÉX.,"TLAHUAC, CD. MÉX.",2,0,2,0,0,0,
11/07/2019,VER.,"MINATITLAN, VER.",0,1,1,0,0,0,
11/07/2019,CD. MÉX.,"IZTAPALAPA, CD. MÉX.",0,1,1,0,0,50,
11/07/2019,AGS.,"AGS., AGS.",0,0,0,1,0,0,
11/07/2019,CD. MÉX.,"MILPA ALTA, CD. MÉX.",0,0,0,0,0,150,
12/07/2019,ZAC.,"FRESNILLO, ZAC.",1,3,4,1,0,21,
12/07/2019,AGS.,"AGS., AGS.",2,1,3,0,0,234,
12/07/2019,ZAC.,"GUADALUPE, ZAC.",0,0,0,0,0,565,
14/07/2019,ZAC.,"FRESNILLO, ZAC.",1,0,1,6,1,0,
14/07/2019,ZAC.,"FRESNILLO, ZAC.",0,0,0,0,0,83,
15/07/2019,AGS.,"AGS., AGS.",0,2,2,0,0,0,
15/07/2019,CD. MÉX.,"IZTAPALAPA, CD. MÉX.",2,0,2,0,0,0,
15/07/2019,CD. MÉX.,"CUAJIMALPA DE MOR., CD. MÉX.",2,0,2,0,1,7,
15/07/2019,CD. MÉX.,"TLAHUAC, CD. MÉX.",1,0,1,0,0,77,
16/07/2019,NAY.,"TEPIC, NAY.",2,0,2,0,0,0,
16/07/2019,VER.,"COATZINTLA, VER.",1,0,1,0,0,161,
16/07/2019,AGS.,"AGS., AGS.",1,0,1,1,0,255,
16/07/2019,NAY.,"ACAPONETA, NAY.",1,0,1,0,0,0,
16/07/2019,ZAC.,"GUADALUPE, ZAC.",0,0,0,3,0,337,
16/07/2019,ZAC.,"FRESNILLO, ZAC.",0,0,0,2,0,0,
17/07/2019,NAY.,"TEPIC, NAY.",4,0,4,0,0,0,
17/07/2019,CD. MÉX.,"CUAJIMALPA DE MOR., CD. MÉX.",3,0,3,0,0,5160,
17/07/2019,CD. MÉX.,"IZTAPALAPA, CD. MÉX.",2,0,2,0,0,64,
17/07/2019,VER.,"COATZINTLA, VER.",0,1,1,0,0,40,
17/07/2019,COAH.,"ACUÑA, COAH.",0,1,1,0,0,0,
17/07/2019,AGS.,"AGS., AGS.",1,0,1,1,0,0,
17/07/2019,ZAC.,"ZAC., ZAC.",0,0,0,3,0,0,
17/07/2019,CD. MÉX.,"TLAHUAC, CD. MÉX.",0,0,0,0,0,8,
18/07/2019,NAY.,"TEPIC, NAY.",4,0,4,4,0,0,
18/07/2019,CD. MÉX.,"CUAJIMALPA DE MOR., CD. MÉX.",3,1,4,0,0,6914,
18/07/2019,ZAC.,"GUADALUPE, ZAC.",2,0,2,5,0,140,
18/07/2019,CD. MÉX.,"TLAHUAC, CD. MÉX.",1,1,2,0,0,0,
18/07/2019,AGS.,"AGS., AGS.",1,0,1,1,0,0,
18/07/2019,ZAC.,"FRESNILLO, ZAC.",1,0,1,0,0,43,
18/07/2019,NAY.,"ACAPONETA, NAY.",1,0,1,0,0,0,
18/07/2019,VER.,"COATZINTLA, VER.",1,0,1,0,0,111,
18/07/2019,CHIH.,"IGNACIO ZARAGOZA, CHIH.",1,0,1,2,0,52,
18/07/2019,ZAC.,"ZAC., ZAC.",0,0,0,0,0,354,
19/07/2019,NAY.,"TEPIC, NAY.",5,0,5,0,0,0,
19/07/2019,CD. MÉX.,"IZTAPALAPA, CD. MÉX.",4,0,4,0,0,237,
19/07/2019,ZAC.,"FRESNILLO, ZAC.",1,0,1,0,0,0,
19/07/2019,CD. MÉX.,"TLAHUAC, CD. MÉX.",1,0,1,0,0,274,
19/07/2019,CD. MÉX.,"CUAJIMALPA DE MOR., CD. MÉX.",1,0,1,0,0,0,
19/07/2019,ZAC.,"GUADALUPE, ZAC.",0,0,0,6,0,160,
19/07/2019,VER.,"COATZINTLA, VER.",0,0,0,0,0,228,
19/07/2019,AGS.,"AGS., AGS.",0,0,0,1,0,0,
22/07/2019,CD. MÉX.,"IZTAPALAPA, CD. MÉX.",6,2,8,0,0,94,
22/07/2019,CD. MÉX.,"TLAHUAC, CD. MÉX.",4,0,4,0,0,20,
22/07/2019,CD. MÉX.,"CUAJIMALPA DE MOR., CD. MÉX.",2,0,2,0,0,0,
22/07/2019,CHIH.,"IGNACIO ZARAGOZA, CHIH.",0,0,0,0,0,49,
22/07/2019,VER.,"COATZINTLA, VER.",0,0,0,0,1,0,
23/07/2019,CHIH.,"DELICIAS, CHIH.",11,2,13,5,0,200,
23/07/2019,CD. MÉX.,"IZTAPALAPA, CD. MÉX.",6,4,10,0,0,30,
23/07/2019,NAY.,"XALISCO, NAY.",4,0,4,0,0,0,
23/07/2019,CD. MÉX.,"TLAHUAC, CD. MÉX.",2,0,2,0,0,20,
23/07/2019,JAL.,"SAYULA, JAL.",1,0,1,0,0,0,
23/07/2019,CD. MÉX.,"TLAHUAC, CD. MÉX.",0,1,1,0,0,0,
23/07/2019,COAH.,"SALTILLO, COAH.",0,0,0,0,1,0,
24/07/2019,CHIH.,"DELICIAS, CHIH.",6,1,7,5,0,109,
24/07/2019,CD. MÉX.,"TLAHUAC, CD. MÉX.",3,1,4,0,0,243,
24/07/2019,VER.,"VER., VER.",2,1,3,0,0,0,
24/07/2019,CD. MÉX.,"IZTAPALAPA, CD. MÉX.",1,1,2,0,0,2,
24/07/2019,JAL.,"SAYULA, JAL.",2,0,2,0,0,0,
24/07/2019,NAY.,"XALISCO, NAY.",0,1,1,0,0,0,
24/07/2019,NAY.,"HUAJICORI, NAY.",1,0,1,1,0,0,
25/07/2019,COAH.,"FRANCISCO I. MADERO, COAH.",5,0,5,0,0,0,
25/07/2019,CHIH.,"DELICIAS, CHIH.",2,1,3,0,0,108,
25/07/2019,NAY.,"XALISCO, NAY.",2,0,2,0,0,0,
25/07/2019,CD. MÉX.,"BENITO JUAREZ, CD. MÉX.",1,0,1,0,0,0,
25/07/2019,CD. MÉX.,"IZTAPALAPA, CD. MÉX.",1,0,1,0,0,38,
25/07/2019,VER.,"COATZINTLA, VER.",1,0,1,0,0,0,
25/07/2019,CD. MÉX.,"CUAJIMALPA DE MOR., CD. MÉX.",0,0,0,0,0,546,
26/07/2019,CHIH.,"DELICIAS, CHIH.",8,4,12,7,0,254,
26/07/2019,NAY.,"XALISCO, NAY.",4,4,8,0,0,0,
26/07/2019,CD. MÉX.,"CUAJIMALPA DE MOR., CD. MÉX.",4,0,4,0,0,7049,
26/07/2019,CD. MÉX.,"BENITO JUAREZ, CD. MÉX.",2,1,3,0,0,47,
26/07/2019,CD. MÉX.,"IZTAPALAPA, CD. MÉX.",2,0,2,0,0,100,
26/07/2019,AGS.,"COSÍO, AGS.",1,0,1,11,0,0,
27/07/2019,CHIH.,"DELICIAS, CHIH.",3,2,5,0,0,0,
29/07/2019,MOR.,"CUERNAVACA, MOR.",4,0,4,4,0,169,
29/07/2019,NAY.,"TECUALA, NAY.",3,0,3,0,0,0,
29/07/2019,CHIH.,"NUEVO CASAS GRANDES, CHIH.",3,0,3,0,0,580,
29/07/2019,CD. MÉX.,"BENITO JUAREZ, CD. MÉX.",1,1,2,0,0,50,
29/07/2019,VER.,"SAYULA DE ALEMAN, VER.",0,0,0,0,0,7,
30/07/2019,CHIH.,"NUEVO CASAS GRANDES, CHIH.",9,1,10,4,1,555,
30/07/2019,CD. MÉX.,"CUAUHTEMOC, CD. MÉX.",6,1,7,0,0,1048,
30/07/2019,NAY.,"TECUALA, NAY.",5,0,5,0,0,0,
30/07/2019,CD. MÉX.,"BENITO JUAREZ, CD. MÉX.",3,0,3,0,0,95,
30/07/2019,JAL.,"SAYULA, JAL.",3,0,3,0,0,0,
30/07/2019,COAH.,"FRANCISCO I. MADERO, COAH.",2,0,2,0,0,0,
30/07/2019,MOR.,"CUERNAVACA, MOR.",1,1,2,0,0,364,
30/07/2019,CHIH.,"NUEVO CASAS GRANDES, CHIH.",2,0,2,0,0,707,
30/07/2019,Q. ROO.,"BENITO JUAREZ, Q. ROO",1,0,1,0,0,95,
30/07/2019,NAY.,"COMPOSTELA, NAY.",1,0,1,2,0,0,
30/07/2019,VER.,"SAYULA DE ALEMAN, VER.",1,0,1,0,0,47,
30/07/2019,COAH.,"TORREÓN, COAH.",0,0,0,8,0,0,
31/07/2019,NAY.,"TECUALA, NAY.",3,4,7,0,0,0,
31/07/2019,CD. MÉX.,"BENITO JUAREZ, CD. MÉX.",5,1,6,0,0,1271,
31/07/2019,CD. MÉX.,"IZTAPALAPA, CD. MÉX.",4,0,4,0,0,32,
31/07/2019,MOR.,"CUERNAVACA, MOR.",4,0,4,1,1,556,
31/07/2019,CD. MÉX.,"CUAUHTEMOC, CD. MÉX.",1,0,1,0,0,6,
31/07/2019,JAL.,"SAYULA, JAL.",1,0,1,1,0,0,
01/08/2019,MOR.,"CUERNAVACA, MOR.",8,4,12,1,0,711,
01/08/2019,CD. MÉX.,"CUAUHTEMOC, CD. MÉX.",4,5,9,0,0,1693,
01/08/2019,QRO.,"PEDRO ESCOBEDO, QRO.",1,4,5,0,0,0,
01/08/2019,CD. MÉX.,"IZTAPALAPA, CD. MÉX.",1,2,3,0,0,32,
01/08/2019,NAY.,"TECUALA, NAY.",2,1,3,0,0,0,
01/08/2019,COAH.,"FRANCISCO I. MADERO, COAH.",2,0,2,0,0,0,
01/08/2019,CD. MÉX.,"BENITO JUAREZ, CD. MÉX.",1,1,2,0,0,1000,
01/08/2019,NAY.,"COMPOSTELA, NAY.",2,0,2,0,0,0,
01/08/2019,VER.,"MISANTLA, VER.",0,0,0,0,0,62,
02/08/2019,CD. MÉX.,"CUAUHTEMOC, CD. MÉX.",6,0,6,0,0,7835,
02/08/2019,MOR.,"CUERNAVACA, MOR.",4,2,6,8,0,13,
02/08/2019,AGS.,"EL LLANO, AGS.",5,0,5,10,1,40,
02/08/2019,QRO.,"PEDRO ESCOBEDO, QRO.",3,2,5,0,0,0,
02/08/2019,CD. MÉX.,"BENITO JUAREZ, CD. MÉX.",2,1,3,0,0,192,
02/08/2019,CD. MÉX.,"IZTAPALAPA, CD. MÉX.",3,0,3,0,0,236,
02/08/2019,QRO.,"QUERETARO, QRO.",2,1,3,0,0,0,
02/08/2019,JAL.,"SAYULA, JAL.",2,0,2,0,0,0,
02/08/2019,COAH.,"SALTILLO, COAH.",0,0,0,1,0,914,
03/08/2019,AGS.,"EL LLANO, AGS.",1,2,3,22,0,50,
03/08/2019,JAL.,"SAYULA, JAL.",1,0,1,0,0,0,
04/08/2019,NAY.,"ACAPONETA, NAY.",4,1,5,0,0,0,
05/08/2019,CD. MÉX.,"BENITO JUAREZ, CD. MÉX.",11,1,12,0,0,197,
05/08/2019,CD. MÉX.,"IZTAPALAPA, CD. MÉX.",6,0,6,0,0,27,
05/08/2019,CD. MÉX.,"CUAUHTEMOC, CD. MÉX.",3,0,3,0,0,257,
05/08/2019,QRO.,"QUERETARO, QRO.",3,0,3,0,1,0,
05/08/2019,MOR.,"CUERNAVACA, MOR.",0,1,1,2,0,871,
05/08/2019,NAY.,"SANTIAGO IXCUINTLA, NAY.",1,0,1,0,0,0,
05/08/2019,COAH.,"MATAMOROS, COAH.",0,0,0,0,0,5,
05/08/2019,COAH.,"FRANCISCO I. MADERO, COAH.",0,0,0,0,0,4,
05/08/2019,VER.,"IXTACZOQUITLAN, VER.",0,0,0,0,0,50,
06/08/2019,CD. MÉX.,"BENITO JUAREZ, CD. MÉX.",10,1,11,0,0,820,
06/08/2019,MÉX.,"ATIZAPAN, MEX.",8,3,11,2,0,104,
06/08/2019,CD. MÉX.,"CUAUHTEMOC, CD. MÉX.",5,0,5,0,0,36,
06/08/2019,MÉX.,"OCOYOACAC, MEX.",2,2,4,4,32,150,
06/08/2019,CD. MÉX.,"IZTAPALAPA, CD. MÉX.",2,1,3,0,1,352,
06/08/2019,QRO.,"QUERETARO, QRO.",2,0,2,0,1,0,
06/08/2019,NAY.,"SANTIAGO IXCUINTLA, NAY.",1,0,1,0,0,0,
06/08/2019,MÉX.,"COACALCO DE BERRIOZABAL, MEX.",0,1,1,0,0,0,
06/08/2019,MOR.,"CUERNAVACA, MOR.",0,0,0,4,0,3730,
06/08/2019,MÉX.,"SAN MARTIN DE LAS PIRAMIDES, MEX.",0,0,0,0,7,878,
07/08/2019,CD. MÉX.,"BENITO JUAREZ, CD. MÉX.",12,3,15,0,0,747,
07/08/2019,MÉX.,"SAN MARTIN DE LAS PIRAMIDES, MEX.",5,1,6,0,0,7,
07/08/2019,MOR.,"CUERNAVACA, MOR.",2,0,2,0,0,1785,
07/08/2019,NAY.,"SANTIAGO IXCUINTLA, NAY.",1,0,1,0,0,0,
07/08/2019,NAY.,"IXTLAN DEL RIO, NAY.",1,0,1,0,0,0,
07/08/2019,COAH.,"SALTILLO, COAH.",1,0,1,0,0,0,
07/08/2019,CD. MÉX.,"CUAUHTEMOC, CD. MÉX.",1,0,1,0,0,291,
07/08/2019,MÉX.,"COACALCO DE BERRIOZABAL, MEX.",1,0,1,0,0,0,
07/08/2019,CD. MÉX.,"IZTAPALAPA, CD. MÉX.",0,0,0,0,0,91,
08/08/2019,MÉX.,"ATIZAPAN, MEX.",6,1,7,2,0,54,
08/08/2019,CD. MÉX.,"IZTAPALAPA, CD. MÉX.",5,0,5,0,0,2,
08/08/2019,QRO.,"QUERETARO, QRO.",1,3,4,0,0,0,
08/08/2019,CD. MÉX.,"CUAUHTEMOC, CD. MÉX.",4,0,4,0,0,968,
08/08/2019,MOR.,"CUERNAVACA, MOR.",2,0,2,0,0,706,
08/08/2019,MÉX.,"COACALCO DE BERRIOZABAL, MEX.",2,0,2,0,0,18,
08/08/2019,CHIH.,"NUEVO CASAS GRANDES, CHIH.",1,1,2,0,0,47,
08/08/2019,COAH.,"ACUÑA, COAH.",0,1,1,0,0,0,
08/08/2019,NAY.,"SANTIAGO IXCUINTLA, NAY.",1,0,1,0,0,0,
08/08/2019,Q. ROO.,"SOLIDARIDAD, Q. ROO",1,0,1,1,0,7,
09/08/2019,CD. MÉX.,"CUAUHTEMOC, CD. MÉX.",4,0,4,0,0,6264,
09/08/2019,JAL.,"LA HUERTA, JAL.",0,3,3,0,0,0,
09/08/2019,CD. MÉX.,"ALVARO OBREGON, CD. MÉX.",2,1,3,0,0,273,
09/08/2019,CD. MÉX.,"IZTAPALAPA, CD. MÉX.",3,0,3,0,0,22,
09/08/2019,QRO.,"QUERETARO, QRO.",1,1,2,0,0,0,
09/08/2019,AGS.,"ASIENTOS, AGS.",1,1,2,4,1,250,
09/08/2019,MOR.,"CUERNAVACA, MOR.",2,0,2,5,0,1246,
09/08/2019,CHIH.,"NUEVO CASAS GRANDES, CHIH.",2,0,2,0,0,707,
09/08/2019,NAY.,"SANTIAGO IXCUINTLA, NAY.",1,0,1,0,0,0,
09/08/2019,MÉX.,"SAN MARTIN DE LAS PIRAMIDES, MEX.",0,0,0,0,17,63,
09/08/2019,COAH.,"ACUÑA, COAH.",0,0,0,0,0,118,
10/08/2019,AGS.,"ASIENTOS, AGS.",1,0,1,10,0,50,
10/08/2019,MÉX.,"SAN MARTIN DE LAS PIRAMIDES, MEX.",1,0,1,0,0,0,
11/08/2019,JAL.,"SAYULA, JAL.",1,0,1,0,0,33,
12/08/2019,MÉX.,"COACALCO DE BERRIOZABAL, MEX.",3,0,3,0,0,13,
12/08/2019,MÉX.,"AMECAMECA, MEX.",2,1,3,1,0,0,
12/08/2019,CD. MÉX.,"ALVARO OBREGON, CD. MÉX.",2,1,3,0,1,0,
12/08/2019,CD. MÉX.,"IZTAPALAPA, CD. MÉX.",3,0,3,0,0,439,
12/08/2019,QRO.,"QUERETARO, QRO.",2,1,3,0,0,0,
12/08/2019,JAL.,"SAYULA, JAL.",1,0,1,0,0,0,
12/08/2019,ZAC.,"FRESNILLO, ZAC.",1,0,1,4,0,26,
12/08/2019,ZAC.,"GUADALUPE, ZAC.",0,0,0,4,0,110,
12/08/2019,CD. MÉX.,"GUSTAVO A. MADERO, CD. MÉX.",0,0,0,0,0,38,
13/08/2019,MÉX.,"AMECAMECA, MEX.",4,0,4,1,4,0,
13/08/2019,CD. MÉX.,"GUSTAVO A. MADERO, CD. MÉX.",3,1,4,0,0,3,
13/08/2019,CD. MÉX.,"IZTAPALAPA, CD. MÉX.",3,0,3,0,0,124,
13/08/2019,MOR.,"CUERNAVACA, MOR.",2,1,3,12,0,0,
13/08/2019,MÉX.,"COACALCO DE BERRIOZABAL, MEX.",1,0,1,0,0,0,
13/08/2019,NAY.,"TEPIC, NAY.",1,0,1,0,0,0,
13/08/2019,CHIH.,"NUEVO CASAS GRANDES, CHIH.",0,1,1,0,0,1,
13/08/2019,CD. MÉX.,"ALVARO OBREGON, CD. MÉX.",0,1,1,0,0,239,
13/08/2019,QRO.,"QUERETARO, QRO.",1,0,1,0,2,0,
14/08/2019,CHIH.,"NUEVO CASAS GRANDES, CHIH.",3,1,4,0,0,70,
14/08/2019,NAY.,"TEPIC, NAY.",2,1,3,0,0,0,
14/08/2019,QRO.,"QUERETARO, QRO.",2,1,3,0,0,0,
14/08/2019,MÉX.,"COACALCO DE BERRIOZABAL, MEX.",2,1,3,0,0,3553,
14/08/2019,CD. MÉX.,"IZTAPALAPA, CD. MÉX.",2,1,3,0,0,118,
14/08/2019,MOR.,"CUERNAVACA, MOR.",2,0,2,1,0,1013,
14/08/2019,CD. MÉX.,"GUSTAVO A. MADERO, CD. MÉX.",2,0,2,0,0,152,
14/08/2019,NAY.,"ACAPONETA, NAY.",0,1,1,0,0,0,
14/08/2019,MÉX.,"AMECAMECA, MEX.",1,0,1,1,4,0,
14/08/2019,ZAC.,"GUADALUPE, ZAC.",0,0,0,3,0,107,
15/08/2019,CD. MÉX.,"IZTAPALAPA, CD. MÉX.",12,2,14,0,0,110,
15/08/2019,CD. MÉX.,"GUSTAVO A. MADERO, CD. MÉX.",3,0,3,0,10,101,
15/08/2019,QRO.,"QUERETARO, QRO.",3,0,3,0,0,0,
15/08/2019,MÉX.,"COACALCO DE BERRIOZABAL, MEX.",2,0,2,0,0,2,
15/08/2019,MOR.,"CUERNAVACA, MOR.",2,0,2,19,1,0,
15/08/2019,NAY.,"ACAPONETA, NAY.",2,0,2,0,0,0,
15/08/2019,NAY.,"TEPIC, NAY.",0,2,2,0,0,0,
15/08/2019,ZAC.,"FRESNILLO, ZAC.",2,0,2,0,0,30,
15/08/2019,CD. MÉX.,"ALVARO OBREGON, CD. MÉX.",1,0,1,0,0,249,
15/08/2019,MÉX.,"AMECAMECA, MEX.",1,0,1,0,1,19,
15/08/2019,S.L.P.,"RIOVERDE, S.L.P.",1,0,1,0,0,0,
15/08/2019,ZAC.,"GUADALUPE, ZAC.",0,0,0,8,0,100,
16/08/2019,CD. MÉX.,"IZTAPALAPA, CD. MÉX.",9,1,10,0,0,160,
16/08/2019,NAY.,"TEPIC, NAY.",7,3,10,0,0,0,
16/08/2019,CD. MÉX.,"GUSTAVO A. MADERO, CD. MÉX.",7,0,7,0,0,145,
16/08/2019,MÉX.,"AMECAMECA, MEX.",3,0,3,0,1,0,
16/08/2019,AGS.,"TEPEZALÁ, AGS.",2,0,2,11,0,0,
16/08/2019,MOR.,"CUERNAVACA, MOR.",1,1,2,25,1,444,
16/08/2019,CD. MÉX.,"ALVARO OBREGON, CD. MÉX.",1,1,2,0,0,36,
16/08/2019,ZAC.,"FRESNILLO, ZAC.",1,0,1,0,0,641,
16/08/2019,S.L.P.,"SAN LUIS POTOSI, S.L.P.",1,0,1,0,0,0,
16/08/2019,QRO.,"QUERETARO, QRO.",1,0,1,0,0,0,
16/08/2019,NAY.,"ACAPONETA, NAY.",0,1,1,0,0,0,
16/08/2019,ZAC.,"ZAC., ZAC.",0,0,0,1,0,0,
17/08/2019,MÉX.,"COACALCO DE BERRIOZABAL, MEX.",1,2,3,0,0,27,
17/08/2019,S.L.P.,"SAN LUIS POTOSI, S.L.P.",2,0,2,0,2,41,
17/08/2019,MÉX.,"AMECAMECA, MEX.",2,0,2,0,0,0,
17/08/2019,AGS.,"TEPEZALÁ, AGS.",1,0,1,7,0,0,
18/08/2019,S.L.P.,"SAN LUIS POTOSI, S.L.P.",1,0,1,10,0,99,
18/08/2019,S.L.P.,"SOLEDAD DE GRACIANO SANCHEZ, S.L.P.",0,1,1,0,0,0,
19/08/2019,MÉX.,"TLALNEPANTLA DE BAZ, MEX.",6,0,6,2,1,24,
19/08/2019,CD. MÉX.,"IZTAPALAPA, CD. MÉX.",5,0,5,0,0,0,
19/08/2019,S.L.P.,"SOLEDAD DE GRACIANO SANCHEZ, S.L.P.",2,1,3,0,2,0,
19/08/2019,QRO.,"QUERETARO, QRO.",2,1,3,0,0,0,
19/08/2019,MÉX.,"TECAMAC, MEX.",3,0,3,3,11,290,
19/08/2019,CD. MÉX.,"ALVARO OBREGON, CD. MÉX.",2,1,3,0,0,108,
19/08/2019,S.L.P.,"SAN LUIS POTOSI, S.L.P.",2,0,2,0,0,0,
19/08/2019,MOR.,"TEPOZTLAN, MOR.",2,0,2,0,0,0,
19/08/2019,MÉX.,"AXAPUSCO, MEX.",0,2,2,0,0,44,
19/08/2019,MOR.,"CUERNAVACA, MOR.",0,1,1,4,0,135,
19/08/2019,ZAC.,"GUADALUPE, ZAC.",0,0,0,0,0,83,
19/08/2019,CD. MÉX.,"GUSTAVO A. MADERO, CD. MÉX.",0,0,0,0,0,6,
20/08/2019,CD. MÉX.,"IZTAPALAPA, CD. MÉX.",4,1,5,0,0,218,
20/08/2019,QRO.,"QUERETARO, QRO.",3,2,5,0,2,0,
20/08/2019,NAY.,"TEPIC, NAY.",3,0,3,0,0,0,
20/08/2019,QRO.,"EZEQUIEL MONTES, QRO.",1,2,3,0,0,0,
20/08/2019,MOR.,"CUERNAVACA, MOR.",2,0,2,0,0,19,
20/08/2019,CD. MÉX.,"ALVARO OBREGON, CD. MÉX.",2,0,2,0,0,323,
20/08/2019,CHIH.,"NUEVO CASAS GRANDES, CHIH.",1,1,2,1,0,0,
20/08/2019,VER.,"LAS CHOAPAS, VER.",0,2,2,0,0,0,
20/08/2019,TLAX.,"TLAX., TLAX.",1,1,2,1,0,0,
20/08/2019,MÉX.,"TECAMAC, MEX.",1,0,1,0,5,0,
20/08/2019,MOR.,"TEPOZTLAN, MOR.",0,1,1,0,0,73,
20/08/2019,S.L.P.,"SOLEDAD DE GRACIANO SANCHEZ, S.L.P.",1,0,1,0,0,0,
20/08/2019,S.L.P.,"SAN LUIS POTOSI, S.L.P.",1,0,1,0,0,0,
20/08/2019,MÉX.,"AXAPUSCO, MEX.",0,1,1,0,0,0,
20/08/2019,ZAC.,"GUADALUPE, ZAC.",0,0,0,7,0,244,
20/08/2019,ZAC.,"ZAC., ZAC.",0,0,0,3,0,410,
21/08/2019,CD. MÉX.,"GUSTAVO A. MADERO, CD. MÉX.",10,0,10,0,0,4434,
21/08/2019,CD. MÉX.,"IZTAPALAPA, CD. MÉX.",7,0,7,0,0,767,
21/08/2019,GTO.,"IRAPUATO, GTO.",5,2,7,0,0,0,
21/08/2019,QRO.,"EZEQUIEL MONTES, QRO.",2,3,5,0,0,0,
21/08/2019,QRO.,"QUERETARO, QRO.",2,2,4,0,0,0,
21/08/2019,CD. MÉX.,"ALVARO OBREGON, CD. MÉX.",3,0,3,0,0,237,
21/08/2019,MÉX.,"TECAMAC, MEX.",3,0,3,2,3,48,
21/08/2019,VER.,"LAS CHOAPAS, VER.",2,0,2,1,0,0,
21/08/2019,ZAC.,"FRESNILLO, ZAC.",1,0,1,0,0,0,
21/08/2019,CHIH.,"NUEVO CASAS GRANDES, CHIH.",0,1,1,0,0,0,
21/08/2019,S.L.P.,"SALINAS, S.L.P.",0,1,1,0,0,0,
21/08/2019,S.L.P.,"SAN LUIS POTOSI, S.L.P.",1,0,1,0,1,0,
21/08/2019,MOR.,"CUERNAVACA, MOR.",1,0,1,0,0,0,
21/08/2019,NAY.,"HUAJICORI, NAY.",1,0,1,0,0,0,
21/08/2019,MÉX.,"AXAPUSCO, MEX.",1,0,1,0,0,393,
21/08/2019,JAL.,"SAYULA, JAL.",0,1,1,0,0,0,
21/08/2019,ZAC.,"GUADALUPE, ZAC.",0,0,0,3,0,415,
21/08/2019,COAH.,"SALTILLO, COAH.",0,0,0,0,0,222,
21/08/2019,MOR.,"TEPOZTLAN, MOR.",0,0,0,7,0,327,
22/08/2019,MÉX.,"TLALNEPANTLA DE BAZ, MEX.",11,4,15,0,2,1385,
22/08/2019,CD. MÉX.,"MIGUEL HGO., CD. MÉX.",11,0,11,0,0,35,
22/08/2019,QRO.,"QUERETARO, QRO.",7,2,9,0,0,0,
22/08/2019,CD. MÉX.,"IZTAPALAPA, CD. MÉX.",2,4,6,2,1,401,
22/08/2019,MÉX.,"TECAMAC, MEX.",2,2,4,1,0,0,
22/08/2019,S.L.P.,"SAN LUIS POTOSI, S.L.P.",4,0,4,0,2,0,
22/08/2019,S.L.P.,"SOLEDAD DE GRACIANO SANCHEZ, S.L.P.",4,0,4,1,0,259,
22/08/2019,JAL.,"SAYULA, JAL.",3,0,3,0,0,4,
22/08/2019,CD. MÉX.,"GUSTAVO A. MADERO, CD. MÉX.",2,1,3,0,0,801,
22/08/2019,TLAX.,"TLAX., TLAX.",1,1,2,0,0,0,
22/08/2019,GTO.,"IRAPUATO, GTO.",2,0,2,0,1,0,
22/08/2019,TAMPS.,"VICTORIA, TAMPS.",1,1,2,0,0,0,
22/08/2019,NAY.,"XALISCO, NAY.",1,0,1,0,0,0,
22/08/2019,MÉX.,"AXAPUSCO, MEX.",0,1,1,1,0,0,
22/08/2019,QRO.,"EZEQUIEL MONTES, QRO.",1,0,1,0,0,0,
22/08/2019,VER.,"LAS CHOAPAS, VER.",1,0,1,0,0,0,
22/08/2019,ZAC.,"GUADALUPE, ZAC.",0,0,0,16,0,365,
22/08/2019,MOR.,"TEPOZTLAN, MOR.",0,0,0,21,1,443,
23/08/2019,CD. MÉX.,"IZTAPALAPA, CD. MÉX.",5,2,7,0,0,258,
23/08/2019,CD. MÉX.,"GUSTAVO A. MADERO, CD. MÉX.",4,3,7,0,0,8538,
23/08/2019,MÉX.,"TECAMAC, MEX.",5,1,6,0,1,104,
23/08/2019,VER.,"LAS CHOAPAS, VER.",3,2,5,1,0,0,
23/08/2019,AGS.,"PABELLÓN DE ARTEAGA, AGS.",3,0,3,5,0,0,
23/08/2019,QRO.,"QUERETARO, QRO.",2,1,3,0,0,0,
23/08/2019,JAL.,"SAYULA, JAL.",1,1,2,2,0,25,
23/08/2019,GTO.,"IRAPUATO, GTO.",1,1,2,0,0,0,
23/08/2019,MOR.,"CUERNAVACA, MOR.",2,0,2,2,0,1200,
23/08/2019,MÉX.,"AXAPUSCO, MEX.",0,2,2,0,0,0,
23/08/2019,TLAX.,"TLAX., TLAX.",1,0,1,0,0,0,
23/08/2019,COL.,"COL., COL.",1,0,1,0,0,0,
23/08/2019,NAY.,"XALISCO, NAY.",1,0,1,0,0,0,
23/08/2019,B.C.S.,"LA PAZ, B.C.S.",1,0,1,0,0,99,
23/08/2019,TAMPS.,"VICTORIA, TAMPS.",1,0,1,0,0,6,
23/08/2019,S.L.P.,"SAN LUIS POTOSI, S.L.P.",1,0,1,0,0,24,
23/08/2019,S.L.P.,"SOLEDAD DE GRACIANO SANCHEZ, S.L.P.",1,0,1,3,0,0,
23/08/2019,S.L.P.,"CEDRAL, S.L.P.",1,0,1,0,0,0,
23/08/2019,QRO.,"EZEQUIEL MONTES, QRO.",1,0,1,0,0,0,
23/08/2019,MOR.,"TEPOZTLAN, MOR.",1,0,1,15,1,0,
23/08/2019,ZAC.,"GUADALUPE, ZAC.",0,0,0,8,0,473,
23/08/2019,ZAC.,"FRESNILLO, ZAC.",0,0,0,0,0,4,
23/08/2019,S.L.P.,"CIUDAD VALLES, S.L.P.",0,0,0,5,0,0,
24/08/2019,MÉX.,"TLALNEPANTLA DE BAZ, MEX.",7,0,7,1,0,118,
24/08/2019,TAMPS.,"TAMPICO, TAMPS.",4,0,4,0,0,43,
24/08/2019,MÉX.,"TECAMAC, MEX.",2,1,3,0,0,0,
24/08/2019,TAMPS.,"REYNOSA, TAMPS.",3,0,3,1,0,448,
24/08/2019,JAL.,"SAYULA, JAL.",3,0,3,0,0,0,
24/08/2019,TLAX.,"CHIAUTEMPAN, TLAX.",1,2,3,0,0,0,
24/08/2019,TAMPS.,"VICTORIA, TAMPS.",2,0,2,0,0,0,
24/08/2019,TAMPS.,"MATAMOROS, TAMPS.",1,1,2,0,0,0,
24/08/2019,AGS.,"PABELLÓN DE ARTEAGA, AGS.",1,0,1,1,0,0,
24/08/2019,S.L.P.,"EL NARANJO, S.L.P.",0,1,1,0,0,0,
24/08/2019,MÉX.,"ZACUALPAN, MEX.",0,1,1,0,0,0,
25/08/2019,S.L.P.,"SAN LUIS POTOSI, S.L.P.",2,0,2,0,0,0,
26/08/2019,TAMPS.,"TAMPICO, TAMPS.",5,2,7,0,0,117,
26/08/2019,TAMPS.,"REYNOSA, TAMPS.",4,2,6,17,0,493,
26/08/2019,GTO.,"IRAPUATO, GTO.",3,1,4,0,0,65,
26/08/2019,CD. MÉX.,"GUSTAVO A. MADERO, CD. MÉX.",2,2,4,0,0,164,
26/08/2019,MÉX.,"JUCHITEPEC, MEX.",1,2,3,0,0,0,
26/08/2019,MOR.,"CUERNAVACA, MOR.",1,2,3,3,0,323,
26/08/2019,MÉX.,"ATLACOMULCO, MEX.",1,2,3,0,0,0,
26/08/2019,MÉX.,"TECAMAC, MEX.",2,0,2,0,24,228,
26/08/2019,S.L.P.,"SAN LUIS POTOSI, S.L.P.",2,0,2,0,0,0,
26/08/2019,QRO.,"QUERETARO, QRO.",1,1,2,0,0,0,
26/08/2019,TAMPS.,"MATAMOROS, TAMPS.",0,2,2,0,0,197,
26/08/2019,TLAX.,"HUAMANTLA, TLAX.",2,0,2,0,0,0,
26/08/2019,MÉX.,"TLALNEPANTLA DE BAZ, MEX.",2,0,2,0,0,0,
26/08/2019,VER.,"COATZINTLA, VER.",0,1,1,0,0,0,
26/08/2019,S.L.P.,"CIUDAD VALLES, S.L.P.",1,0,1,1,0,0,
26/08/2019,CD. MÉX.,"IZTAPALAPA, CD. MÉX.",1,0,1,0,1,76,
26/08/2019,TLAX.,"APIZACO, TLAX.",1,0,1,0,0,0,
26/08/2019,ZAC.,"ZAC., ZAC.",1,0,1,0,0,0,
26/08/2019,S.L.P.,"SOLEDAD DE GRACIANO SANCHEZ, S.L.P.",1,0,1,0,2,0,
26/08/2019,CD. MÉX.,"TLALPAN, CD. MÉX.",0,0,0,0,0,25,
26/08/2019,ZAC.,"GUADALUPE, ZAC.",0,0,0,12,0,240,
27/08/2019,TAMPS.,"TAMPICO, TAMPS.",6,0,6,0,0,128,
27/08/2019,TAMPS.,"REYNOSA, TAMPS.",4,1,5,4,0,307,
27/08/2019,GTO.,"IRAPUATO, GTO.",3,1,4,0,2,65,
27/08/2019,CD. MÉX.,"MIGUEL HGO., CD. MÉX.",2,2,4,0,0,237,
27/08/2019,TLAX.,"APIZACO, TLAX.",2,1,3,0,0,0,
27/08/2019,MÉX.,"JUCHITEPEC, MEX.",2,1,3,0,0,0,
27/08/2019,CD. MÉX.,"IZTAPALAPA, CD. MÉX.",2,0,2,0,0,25,
27/08/2019,QRO.,"QUERETARO, QRO.",1,1,2,0,0,0,
27/08/2019,MÉX.,"TECAMAC, MEX.",0,2,2,0,29,173,
27/08/2019,JAL.,"SAYULA, JAL.",1,0,1,0,0,15,
27/08/2019,VER.,"PLATON SANCHEZ, VER.",1,0,1,0,0,31,
27/08/2019,CD. MÉX.,"TLALPAN, CD. MÉX.",1,0,1,0,0,37,
27/08/2019,S.L.P.,"CIUDAD VALLES, S.L.P.",1,0,1,0,0,0,
27/08/2019,S.L.P.,"SAN LUIS POTOSI, S.L.P.",0,1,1,0,0,0,
27/08/2019,S.L.P.,"CEDRAL, S.L.P.",1,0,1,0,0,0,
27/08/2019,MOR.,"CUERNAVACA, MOR.",1,0,1,0,0,3,
27/08/2019,JAL.,"TOMATLAN, JAL.",0,1,1,0,0,26,
27/08/2019,VER.,"SANTIAGO TUXTLA, VER.",1,0,1,0,0,0,
27/08/2019,ZAC.,"GUADALUPE, ZAC.",0,0,0,9,0,50,
27/08/2019,AGS.,"CALVILLO, AGS.",0,0,0,3,0,238,
28/08/2019,GTO.,"IRAPUATO, GTO.",7,0,7,0,1,0,
28/08/2019,NAY.,"COMPOSTELA, NAY.",3,0,3,1,0,0,
28/08/2019,TAMPS.,"TAMPICO, TAMPS.",3,0,3,0,0,0,
28/08/2019,TLAX.,"APIZACO, TLAX.",1,1,2,0,0,0,
28/08/2019,CD. MÉX.,"MIGUEL HGO., CD. MÉX.",1,1,2,0,0,18,
28/08/2019,TAMPS.,"MATAMOROS, TAMPS.",1,1,2,0,0,0,
28/08/2019,MÉX.,"TECAMAC, MEX.",2,0,2,2,0,0,
28/08/2019,TLAX.,"HUAMANTLA, TLAX.",0,1,1,0,0,0,
28/08/2019,S.L.P.,"SOLEDAD DE GRACIANO SANCHEZ, S.L.P.",1,0,1,0,0,0,
28/08/2019,CD. MÉX.,"TLALPAN, CD. MÉX.",1,0,1,0,0,63,
28/08/2019,CD. MÉX.,"IZTAPALAPA, CD. MÉX.",0,1,1,0,0,0,
28/08/2019,MOR.,"CUERNAVACA, MOR.",1,0,1,30,4,45,
28/08/2019,ZAC.,"FRESNILLO, ZAC.",1,0,1,0,0,0,
28/08/2019,TAMPS.,"REYNOSA, TAMPS.",0,0,0,13,0,793,
28/08/2019,ZAC.,"GUADALUPE, ZAC.",0,0,0,5,0,0,
28/08/2019,MÉX.,"JUCHITEPEC, MEX.",0,0,0,0,0,24,
28/08/2019,S.L.P.,"SAN LUIS POTOSI, S.L.P.",0,0,0,0,0,28,
29/08/2019,CD. MÉX.,"TLALPAN, CD. MÉX.",1,5,6,0,0,159,
29/08/2019,CD. MÉX.,"MIGUEL HGO., CD. MÉX.",4,1,5,0,0,87,
29/08/2019,TAMPS.,"TAMPICO, TAMPS.",1,3,4,0,0,0,
29/08/2019,MÉX.,"TLALNEPANTLA DE BAZ, MEX.",2,1,3,2,0,45,
29/08/2019,S.L.P.,"SOLEDAD DE GRACIANO SANCHEZ, S.L.P.",2,1,3,0,0,0,
29/08/2019,CD. MÉX.,"IZTAPALAPA, CD. MÉX.",2,1,3,0,0,0,
29/08/2019,MÉX.,"ATLACOMULCO, MEX.",1,1,2,0,0,0,
29/08/2019,MÉX.,"JUCHITEPEC, MEX.",2,0,2,0,10,0,
29/08/2019,TAMPS.,"REYNOSA, TAMPS.",1,1,2,34,0,41,
29/08/2019,TLAX.,"APIZACO, TLAX.",1,0,1,0,0,0,
29/08/2019,TLAX.,"HUAMANTLA, TLAX.",1,0,1,0,0,0,
29/08/2019,MÉX.,"TECAMAC, MEX.",1,0,1,0,0,45,
29/08/2019,S.L.P.,"SAN LUIS POTOSI, S.L.P.",1,0,1,0,0,216,
29/08/2019,TAMPS.,"MATAMOROS, TAMPS.",1,0,1,1,0,14,
29/08/2019,GTO.,"IRAPUATO, GTO.",0,1,1,0,3,0,
29/08/2019,ZAC.,"GUADALUPE, ZAC.",0,0,0,5,0,100,
29/08/2019,ZAC.,"ZAC., ZAC.",0,0,0,2,0,0,
29/08/2019,AGS.,"CALVILLO, AGS.",0,0,0,10,0,0,
30/08/2019,CHIH.,"NUEVO CASAS GRANDES, CHIH.",3,2,5,0,0,0,
30/08/2019,CD. MÉX.,"IZTAPALAPA, CD. MÉX.",3,0,3,0,0,21,
30/08/2019,MÉX.,"TECAMAC, MEX.",1,2,3,0,0,0,
30/08/2019,S.L.P.,"TANQUIAN DE ESCOBEDO, S.L.P.",2,0,2,0,0,0,
30/08/2019,COAH.,"RAMOS ARIZPE, COAH.",1,0,1,0,0,222,
30/08/2019,S.L.P.,"SOLEDAD DE GRACIANO SANCHEZ, S.L.P.",1,0,1,0,0,0,
30/08/2019,S.L.P.,"SAN LUIS POTOSI, S.L.P.",1,0,1,6,0,66,
30/08/2019,CD. MÉX.,"MIGUEL HGO., CD. MÉX.",1,0,1,0,0,9,
30/08/2019,AGS.,"CALVILLO, AGS.",0,1,1,15,0,140,
30/08/2019,MÉX.,"ATLACOMULCO, MEX.",1,0,1,0,0,11,
30/08/2019,NAY.,"TECUALA, NAY.",1,0,1,1,0,0,
30/08/2019,NAY.,"COMPOSTELA, NAY.",0,1,1,0,0,0,
30/08/2019,CD. MÉX.,"TLALPAN, CD. MÉX.",0,0,0,0,0,11,
30/08/2019,MOR.,"CUERNAVACA, MOR.",0,0,0,6,1,24,
30/08/2019,ZAC.,"GUADALUPE, ZAC.",0,0,0,7,0,0,
30/08/2019,MÉX.,"TLALNEPANTLA DE BAZ, MEX.",0,0,0,0,0,33,
30/08/2019,ZAC.,"ZAC., ZAC.",0,0,0,0,0,5,
30/08/2019,MÉX.,"JUCHITEPEC, MEX.",0,0,0,0,10,0,
31/08/2019,MÉX.,"ATLACOMULCO, MEX.",2,3,5,0,0,0,
31/08/2019,MÉX.,"TECAMAC, MEX.",1,2,3,0,0,0,
31/08/2019,MÉX.,"TECAMAC, MEX.",2,1,3,0,1,54,
31/08/2019,AGS.,"SAN FRANCISCO DE LOS ROMO, AGS.",3,0,3,3,0,350,
31/08/2019,MÉX.,"TLALNEPANTLA DE BAZ, MEX.",2,0,2,1,0,11,
31/08/2019,MÉX.,"JUCHITEPEC, MEX.",2,0,2,1,30,0,
31/08/2019,TLAX.,"APIZACO, TLAX.",1,0,1,0,0,0,
31/08/2019,S.L.P.,"AHUALULCO, S.L.P.",1,0,1,0,0,0,
31/08/2019,MÉX.,"JUCHITEPEC, MEX.",0,0,0,0,10,0,
01/09/2019,S.L.P.,"SAN LUIS POTOSI, S.L.P.",0,0,0,0,0,19,
02/09/2019,TAMPS.,"REYNOSA, TAMPS.",8,7,15,66,0,443,
02/09/2019,CD. MÉX.,"IZTAPALAPA, CD. MÉX.",7,0,7,0,0,214,
02/09/2019,MÉX.,"NAUCALPAN DE JUAREZ, MEX.",4,2,6,4,0,5,
02/09/2019,MÉX.,"NEZAHUALCOYOTL, MEX.",4,2,6,2,1,762,
02/09/2019,MÉX.,"TOLUCA, MEX.",3,2,5,1,20,95,
02/09/2019,CD. MÉX.,"MIGUEL HGO., CD. MÉX.",3,2,5,0,0,84,
02/09/2019,TAMPS.,"MATAMOROS, TAMPS.",1,2,3,1,0,56,
02/09/2019,MÉX.,"TEMAMATLA, MEX.",2,1,3,2,0,92,
02/09/2019,GTO.,"IRAPUATO, GTO.",1,1,2,0,0,0,
02/09/2019,ZAC.,"GUADALUPE, ZAC.",1,0,1,2,0,200,
02/09/2019,S.L.P.,"SAN LUIS POTOSI, S.L.P.",1,0,1,0,0,0,
02/09/2019,S.L.P.,"AHUALULCO, S.L.P.",1,0,1,0,0,0,
02/09/2019,TAMPS.,"TAMPICO, TAMPS.",1,0,1,0,0,0,
02/09/2019,MOR.,"CUERNAVACA, MOR.",0,0,0,3,0,791,
03/09/2019,CD. MÉX.,"TLALPAN, CD. MÉX.",6,0,6,0,0,30,
03/09/2019,CD. MÉX.,"MIGUEL HGO., CD. MÉX.",5,0,5,0,0,7,
03/09/2019,TAMPS.,"REYNOSA, TAMPS.",4,0,4,25,0,165,
03/09/2019,MÉX.,"NEZAHUALCOYOTL, MEX.",3,0,3,3,0,458,
03/09/2019,CD. MÉX.,"IZTAPALAPA, CD. MÉX.",3,0,3,0,0,250,
03/09/2019,TAMPS.,"MATAMOROS, TAMPS.",1,1,2,5,0,1,
03/09/2019,NAY.,"IXTLAN DEL RIO, NAY.",0,1,1,0,0,0,
03/09/2019,TAMPS.,"TAMPICO, TAMPS.",1,0,1,0,0,65,
03/09/2019,TAMPS.,"VICTORIA, TAMPS.",1,0,1,0,0,0,
03/09/2019,ZAC.,"GUADALUPE, ZAC.",0,0,0,0,0,515,
03/09/2019,MOR.,"CUERNAVACA, MOR.",0,0,0,0,2,168,
04/09/2019,MÉX.,"NEZAHUALCOYOTL, MEX.",7,0,7,0,0,903,
04/09/2019,CD. MÉX.,"IZTAPALAPA, CD. MÉX.",2,2,4,0,0,762,
04/09/2019,CD. MÉX.,"MIGUEL HGO., CD. MÉX.",3,0,3,0,0,594,
04/09/2019,TAMPS.,"REYNOSA, TAMPS.",2,1,3,0,0,0,
04/09/2019,MOR.,"CUERNAVACA, MOR.",3,0,3,10,0,400,
04/09/2019,GTO.,"IRAPUATO, GTO.",2,0,2,0,0,0,
04/09/2019,TLAX.,"IXTACUIXTLA DE MARIANO MATAMOROS, TLAX.",0,1,1,0,0,0,
04/09/2019,NAY.,"IXTLAN DEL RIO, NAY.",0,1,1,0,0,0,
04/09/2019,S.L.P.,"CIUDAD VALLES, S.L.P.",1,0,1,0,0,0,
04/09/2019,CD. MÉX.,"TLALPAN, CD. MÉX.",0,0,0,0,0,634,
05/09/2019,CD. MÉX.,"IZTAPALAPA, CD. MÉX.",6,3,9,0,0,311,
05/09/2019,MÉX.,"NEZAHUALCOYOTL, MEX.",1,2,3,1,2,247,
05/09/2019,NAY.,"IXTLAN DEL RIO, NAY.",3,0,3,0,0,0,
05/09/2019,TAMPS.,"REYNOSA, TAMPS.",1,1,2,2,0,21,
05/09/2019,GTO.,"IRAPUATO, GTO.",2,0,2,0,0,0,
05/09/2019,ZAC.,"FRESNILLO, ZAC.",0,1,1,0,0,0,
05/09/2019,CD. MÉX.,"MIGUEL HGO., CD. MÉX.",1,0,1,0,0,1,
05/09/2019,TAMPS.,"VICTORIA, TAMPS.",1,0,1,0,0,0,
05/09/2019,TAMPS.,"MATAMOROS, TAMPS.",0,1,1,1,0,0,
05/09/2019,S.L.P.,"SAN LUIS POTOSI, S.L.P.",1,0,1,0,2,0,
05/09/2019,S.L.P.,"SOLEDAD DE GRACIANO SANCHEZ, S.L.P.",1,0,1,1,2,0,
05/09/2019,S.L.P.,"MATEHUALA, S.L.P.",1,0,1,0,0,0,
05/09/2019,COAH.,"SALTILLO, COAH.",0,0,0,0,0,121,
05/09/2019,MOR.,"CUERNAVACA, MOR.",0,0,0,14,2,17,
05/09/2019,MÉX.,"TEMAMATLA, MEX.",0,0,0,0,0,50,
05/09/2019,S.L.P.,"CIUDAD VALLES, S.L.P.",0,0,0,0,3,0,
06/09/2019,GTO.,"IRAPUATO, GTO.",4,6,10,0,0,0,
06/09/2019,CD. MÉX.,"IZTAPALAPA, CD. MÉX.",3,3,6,0,1,917,
06/09/2019,MÉX.,"NEZAHUALCOYOTL, MEX.",3,2,5,0,0,676,
06/09/2019,TAMPS.,"MATAMOROS, TAMPS.",1,3,4,1,0,0,
06/09/2019,CD. MÉX.,"TLALPAN, CD. MÉX.",3,0,3,0,0,206,
06/09/2019,AGS.,"RINCÓN DE ROMOS, AGS.",3,0,3,13,0,50,
06/09/2019,ZAC.,"ZAC., ZAC.",1,0,1,0,0,0,
06/09/2019,JAL.,"SAYULA, JAL.",1,0,1,0,0,0,
06/09/2019,TLAX.,"IXTACUIXTLA DE MARIANO MATAMOROS, TLAX.",0,1,1,0,0,0,
06/09/2019,S.L.P.,"SOLEDAD DE GRACIANO SANCHEZ, S.L.P.",1,0,1,0,1,0,
06/09/2019,CD. MÉX.,"MIGUEL HGO., CD. MÉX.",1,0,1,0,0,0,
06/09/2019,TAMPS.,"VICTORIA, TAMPS.",0,0,0,0,7,0,
06/09/2019,TAMPS.,"REYNOSA, TAMPS.",0,0,0,4,0,85,
06/09/2019,MOR.,"CUERNAVACA, MOR.",0,0,0,10,3,168,
06/09/2019,MÉX.,"TEMAMATLA, MEX.",0,0,0,0,1,0,
07/09/2019,MÉX.,"NEZAHUALCOYOTL, MEX.",3,0,3,2,0,11,
07/09/2019,TLAX.,"IXTACUIXTLA DE MARIANO MATAMOROS, TLAX.",0,3,3,0,0,0,
07/09/2019,AGS.,"RINCÓN DE ROMOS, AGS.",1,0,1,5,0,400,
07/09/2019,MÉX.,"TEMAMATLA, MEX.",0,1,1,0,0,0,
08/09/2019,S.L.P.,"CIUDAD VALLES, S.L.P.",1,0,1,0,2,0,
09/09/2019,CD. MÉX.,"COYOACAN, CD. MÉX.",8,0,8,0,0,100,
09/09/2019,CD. MÉX.,"IZTAPALAPA, CD. MÉX.",6,0,6,0,1,238,
09/09/2019,MÉX.,"NEZAHUALCOYOTL, MEX.",5,0,5,4,0,47,
09/09/2019,MÉX.,"CUAUTITLAN IZCALLI, MEX.",3,0,3,0,0,999,
09/09/2019,GTO.,"IRAPUATO, GTO.",1,2,3,0,0,0,
09/09/2019,TAMPS.,"MATAMOROS, TAMPS.",0,2,2,1,1,52,
09/09/2019,TAMPS.,"REYNOSA, TAMPS.",1,0,1,5,0,0,
09/09/2019,CD. MÉX.,"MIGUEL HGO., CD. MÉX.",1,0,1,0,0,148,
10/09/2019,CD. MÉX.,"IZTAPALAPA, CD. MÉX.",7,4,11,0,0,243,
10/09/2019,CD. MÉX.,"COYOACAN, CD. MÉX.",7,1,8,0,0,5796,
10/09/2019,CD. MÉX.,"MIGUEL HGO., CD. MÉX.",5,2,7,0,0,68,
10/09/2019,MÉX.,"NEZAHUALCOYOTL, MEX.",2,1,3,2,0,146,
10/09/2019,MÉX.,"CUAUTITLAN IZCALLI, MEX.",3,0,3,0,0,20,
10/09/2019,S.L.P.,"VILLA DE REYES, S.L.P.",0,3,3,2,1,0,
10/09/2019,TAMPS.,"TAMPICO, TAMPS.",1,0,1,0,0,0,
10/09/2019,TAMPS.,"MATAMOROS, TAMPS.",1,0,1,2,0,135,
10/09/2019,TAMPS.,"REYNOSA, TAMPS.",1,0,1,34,0,0,
10/09/2019,S.L.P.,"SOLEDAD DE GRACIANO SANCHEZ, S.L.P.",0,0,0,9,2,0,
10/09/2019,S.L.P.,"CIUDAD VALLES, S.L.P.",0,0,0,0,1,0,
11/09/2019,CD. MÉX.,"IZTAPALAPA, CD. MÉX.",5,2,7,0,0,91,
11/09/2019,MÉX.,"CUAUTITLAN IZCALLI, MEX.",3,3,6,0,0,1137,
11/09/2019,CD. MÉX.,"COYOACAN, CD. MÉX.",3,0,3,0,0,122,
11/09/2019,MÉX.,"NEZAHUALCOYOTL, MEX.",3,0,3,3,0,454,
11/09/2019,MOR.,"CUERNAVACA, MOR.",2,0,2,13,0,0,
11/09/2019,CD. MÉX.,"MIGUEL HGO., CD. MÉX.",0,1,1,0,0,0,
11/09/2019,TAMPS.,"TAMPICO, TAMPS.",1,0,1,0,0,0,
12/09/2019,CD. MÉX.,"IZTAPALAPA, CD. MÉX.",4,2,6,0,0,2792,
12/09/2019,CD. MÉX.,"COYOACAN, CD. MÉX.",5,0,5,0,0,341,
12/09/2019,TLAX.,"SAN PABLO DEL MONTE, TLAX.",3,0,3,0,0,0,
12/09/2019,MÉX.,"CUAUTITLAN IZCALLI, MEX.",2,1,3,0,0,1375,
12/09/2019,TAMPS.,"REYNOSA, TAMPS.",2,0,2,0,0,0,
12/09/2019,MÉX.,"NEZAHUALCOYOTL, MEX.",1,0,1,0,0,131,
12/09/2019,TAMPS.,"TAMPICO, TAMPS.",0,0,0,0,0,58,
13/09/2019,CD. MÉX.,"IZTAPALAPA, CD. MÉX.",6,2,8,0,0,0,
13/09/2019,MÉX.,"NEZAHUALCOYOTL, MEX.",4,1,5,0,0,164,
13/09/2019,CD. MÉX.,"COYOACAN, CD. MÉX.",2,2,4,0,0,12,
13/09/2019,MÉX.,"CUAUTITLAN IZCALLI, MEX.",4,0,4,0,0,137,
13/09/2019,CD. MÉX.,"LA MAGDALENA CONTRERAS, CD. MÉX.",1,1,2,0,0,0,
13/09/2019,MOR.,"CUERNAVACA, MOR.",2,0,2,4,0,11,
13/09/2019,TAMPS.,"TAMPICO, TAMPS.",1,0,1,0,0,0,
14/09/2019,MÉX.,"CUAUTITLAN, MEX.",6,0,6,0,0,288,
14/09/2019,MÉX.,"NEZAHUALCOYOTL, MEX.",2,0,2,2,0,4,
17/09/2019,CD. MÉX.,"COYOACAN, CD. MÉX.",6,0,6,0,0,109,
17/09/2019,MÉX.,"NEZAHUALCOYOTL, MEX.",4,0,4,7,0,286,
17/09/2019,TAMPS.,"MATAMOROS, TAMPS.",1,0,1,1,0,47,
17/09/2019,CD. MÉX.,"LA MAGDALENA CONTRERAS, CD. MÉX.",1,0,1,0,0,132,
17/09/2019,TAMPS.,"VICTORIA, TAMPS.",0,0,0,2,0,12,
17/09/2019,CD. MÉX.,"IZTAPALAPA, CD. MÉX.",0,0,0,0,0,17,
18/09/2019,TLAX.,"TETLA DE LA SOLIDARIDAD, TLAX.",0,5,5,0,0,0,
18/09/2019,MÉX.,"NEZAHUALCOYOTL, MEX.",4,0,4,0,0,108,
18/09/2019,TAMPS.,"REYNOSA, TAMPS.",3,0,3,0,0,0,
18/09/2019,CD. MÉX.,"COYOACAN, CD. MÉX.",2,0,2,0,0,4361,
18/09/2019,CD. MÉX.,"IZTAPALAPA, CD. MÉX.",0,2,2,0,0,20,
18/09/2019,MÉX.,"CHICOLOAPAN, MEX.",2,0,2,0,0,13,
18/09/2019,CD. MÉX.,"LA MAGDALENA CONTRERAS, CD. MÉX.",1,0,1,0,0,100,
18/09/2019,TLAX.,"TLAXCO, TLAX.",0,1,1,0,0,0,
18/09/2019,TAMPS.,"VICTORIA, TAMPS.",0,0,0,0,0,500,
18/09/2019,TAMPS.,"MATAMOROS, TAMPS.",0,0,0,2,0,0,
19/09/2019,CD. MÉX.,"COYOACAN, CD. MÉX.",4,0,4,0,0,4281,
19/09/2019,MÉX.,"TIANGUISTENCO, MEX.",3,0,3,1,0,0,
19/09/2019,TLAX.,"TLAXCO, TLAX.",2,0,2,0,0,0,
19/09/2019,MÉX.,"AMATEPEC, MEX.",1,0,1,1,0,0,
19/09/2019,COAH.,"MONCLOVA, COAH.",0,1,1,0,0,0,
19/09/2019,MÉX.,"NEZAHUALCOYOTL, MEX.",1,0,1,0,0,808,
19/09/2019,TAMPS.,"REYNOSA, TAMPS.",1,0,1,1,0,0,
19/09/2019,CD. MÉX.,"IZTAPALAPA, CD. MÉX.",0,0,0,0,0,2152,
19/09/2019,CD. MÉX.,"LA MAGDALENA CONTRERAS, CD. MÉX.",0,0,0,0,0,22,
19/09/2019,MOR.,"CUERNAVACA, MOR.",0,0,0,0,11,120,
19/09/2019,MÉX.,"CHICOLOAPAN, MEX.",0,0,0,0,1,20,
20/09/2019,CD. MÉX.,"COYOACAN, CD. MÉX.",9,1,10,0,0,8379,
20/09/2019,CD. MÉX.,"IZTAPALAPA, CD. MÉX.",7,2,9,0,3,133,
20/09/2019,CD. MÉX.,"LA MAGDALENA CONTRERAS, CD. MÉX.",3,6,9,0,0,1613,
20/09/2019,MÉX.,"NEZAHUALCOYOTL, MEX.",3,1,4,3,0,449,
20/09/2019,MÉX.,"CHICOLOAPAN, MEX.",2,0,2,0,0,17,
20/09/2019,TAMPS.,"REYNOSA, TAMPS.",0,1,1,2,0,33,
20/09/2019,MOR.,"CUERNAVACA, MOR.",0,1,1,2,0,80,
20/09/2019,TAMPS.,"TAMPICO, TAMPS.",1,0,1,0,0,0,
20/09/2019,TLAX.,"TLAXCO, TLAX.",1,0,1,0,0,0,
21/09/2019,MÉX.,"AMATEPEC, MEX.",2,1,3,1,0,0,
21/09/2019,MÉX.,"TIANGUISTENCO, MEX.",2,0,2,0,0,1947,
21/09/2019,MÉX.,"NEZAHUALCOYOTL, MEX.",2,0,2,1,1,1017,
21/09/2019,MÉX.,"TENANGO DEL VALLE, MEX.",1,1,2,0,0,0,
21/09/2019,COAH.,"MONCLOVA, COAH.",0,1,1,0,0,27,
21/09/2019,TAMPS.,"REYNOSA, TAMPS.",0,1,1,0,0,0,
21/09/2019,MÉX.,"CHICOLOAPAN, MEX.",0,1,1,0,0,0,
23/09/2019,CD. MÉX.,"LA MAGDALENA CONTRERAS, CD. MÉX.",10,1,11,0,0,113,
23/09/2019,MÉX.,"CHIMALHUACAN, MEX.",7,1,8,4,0,76,
23/09/2019,CD. MÉX.,"IZTAPALAPA, CD. MÉX.",3,1,4,0,0,90,
23/09/2019,CD. MÉX.,"TLALPAN, CD. MÉX.",2,1,3,0,0,6,
23/09/2019,COL.,"COL., COL.",0,2,2,0,0,0,
23/09/2019,MOR.,"EMILIANO ZAPATA, MOR.",1,1,2,2,0,345,
23/09/2019,TAMPS.,"MATAMOROS, TAMPS.",1,0,1,0,0,0,
23/09/2019,TAMPS.,"REYNOSA, TAMPS.",1,0,1,0,0,620,
23/09/2019,MÉX.,"HUEHUETOCA, MEX.",1,0,1,0,0,108,
23/09/2019,CHIS.,"SAN CRISTOBAL DE LAS CASAS, CHIS.",0,0,0,0,1,0,
24/09/2019,MÉX.,"CHIMALHUACAN, MEX.",6,1,7,2,0,26,
24/09/2019,CHIS.,"TAPACHULA, CHIS.",6,0,6,2,0,232,
24/09/2019,CD. MÉX.,"IZTAPALAPA, CD. MÉX.",2,4,6,0,0,47,
24/09/2019,CD. MÉX.,"TLALPAN, CD. MÉX.",2,0,2,0,0,35,
24/09/2019,CD. MÉX.,"LA MAGDALENA CONTRERAS, CD. MÉX.",2,0,2,0,0,200,
24/09/2019,COL.,"COL., COL.",0,2,2,0,0,0,
24/09/2019,COAH.,"SALTILLO, COAH.",1,0,1,0,0,133,
24/09/2019,TAMPS.,"TAMPICO, TAMPS.",1,0,1,0,0,0,
24/09/2019,TAMPS.,"REYNOSA, TAMPS.",0,1,1,0,0,0,
24/09/2019,MÉX.,"HUEHUETOCA, MEX.",0,0,0,0,0,603,
24/09/2019,CHIS.,"COMITAN DE DOMÍNGUEZ, CHIS.",0,0,0,3,0,40,
24/09/2019,MOR.,"EMILIANO ZAPATA, MOR.",0,0,0,0,0,26,
24/09/2019,CHIS.,"SAN CRISTOBAL DE LAS CASAS, CHIS.",0,0,0,0,0,382,
25/09/2019,MÉX.,"CHIMALHUACAN, MEX.",13,1,14,6,0,0,
25/09/2019,CD. MÉX.,"TLALPAN, CD. MÉX.",2,1,3,0,0,34,
25/09/2019,CD. MÉX.,"LA MAGDALENA CONTRERAS, CD. MÉX.",2,0,2,0,0,116,
25/09/2019,COL.,"COL., COL.",0,2,2,0,0,0,
25/09/2019,TLAX.,"EL CARMEN TEQUEXQUITLA, TLAX.",1,0,1,0,0,0,
25/09/2019,MÉX.,"HUEHUETOCA, MEX.",1,0,1,0,0,98,
25/09/2019,CD. MÉX.,"IZTAPALAPA, CD. MÉX.",1,0,1,0,0,3127,
25/09/2019,TAMPS.,"REYNOSA, TAMPS.",1,0,1,0,0,0,
25/09/2019,CHIS.,"SAN CRISTOBAL DE LAS CASAS, CHIS.",0,0,0,0,0,160,
25/09/2019,MOR.,"EMILIANO ZAPATA, MOR.",0,0,0,2,1,254,
26/09/2019,MÉX.,"CHIMALHUACAN, MEX.",9,2,11,3,0,0,
26/09/2019,CD. MÉX.,"IZTAPALAPA, CD. MÉX.",3,1,4,0,0,61,
26/09/2019,MÉX.,"TENANGO DEL VALLE, MEX.",2,1,3,1,0,0,
26/09/2019,CD. MÉX.,"TLALPAN, CD. MÉX.",2,1,3,0,0,0,
26/09/2019,CD. MÉX.,"LA MAGDALENA CONTRERAS, CD. MÉX.",2,1,3,0,0,0,
26/09/2019,TAMPS.,"TAMPICO, TAMPS.",3,0,3,0,1,0,
26/09/2019,COL.,"COL., COL.",2,1,3,0,0,35,
26/09/2019,MÉX.,"HUEHUETOCA, MEX.",2,0,2,0,3,153,
26/09/2019,CHIS.,"TAPACHULA, CHIS.",2,0,2,2,0,295,
26/09/2019,TLAX.,"YAUHQUEMECAN, TLAX.",0,1,1,0,0,0,
26/09/2019,TLAX.,"EL CARMEN TEQUEXQUITLA, TLAX.",1,0,1,0,0,0,
26/09/2019,CHIS.,"TAPACHULA, CHIS.",1,0,1,0,0,295,
26/09/2019,CHIS.,"LAS MARGARITAS, CHIS.",0,1,1,0,0,92,
26/09/2019,MÉX.,"IXTAPAN DE LA SAL, MEX.",0,0,0,89,0,0,
26/09/2019,CHIS.,"COMITAN DE DOMÍNGUEZ, CHIS.",0,0,0,0,0,96,
26/09/2019,TAMPS.,"REYNOSA, TAMPS.",0,0,0,1,0,23,
26/09/2019,MOR.,"EMILIANO ZAPATA, MOR.",0,0,0,8,0,195,
27/09/2019,MÉX.,"CHIMALHUACAN, MEX.",4,4,8,1,0,56,
27/09/2019,CD. MÉX.,"IZTAPALAPA, CD. MÉX.",2,6,8,0,0,3205,
27/09/2019,TAMPS.,"TAMPICO, TAMPS.",6,1,7,0,1,0,
27/09/2019,COL.,"COL., COL.",1,1,2,0,0,37,
27/09/2019,MÉX.,"HUEHUETOCA, MEX.",2,0,2,0,0,43,
27/09/2019,CHIS.,"SAN CRISTOBAL DE LAS CASAS, CHIS.",1,1,2,1,0,616,
27/09/2019,CHIS.,"COMITAN DE DOMÍNGUEZ, CHIS.",0,1,1,7,0,136,
27/09/2019,TLAX.,"YAUHQUEMECAN, TLAX.",1,0,1,0,0,0,
27/09/2019,CHIS.,"TAPACHULA, CHIS.",0,1,1,0,0,493,
27/09/2019,CD. MÉX.,"TLALPAN, CD. MÉX.",1,0,1,0,0,3,
27/09/2019,Q. ROO.,"BENITO JUAREZ, Q. ROO",0,0,0,0,0,200,
27/09/2019,MOR.,"EMILIANO ZAPATA, MOR.",0,0,0,0,0,90,
27/09/2019,CHIS.,"COMITAN DE DOMÍNGUEZ, CHIS.",0,0,0,0,1,100,
28/09/2019,MÉX.,"CHIMALHUACAN, MEX.",6,1,7,0,0,104,
28/09/2019,COL.,"COL., COL.",1,2,3,0,0,0,
28/09/2019,CHIS.,"TAPACHULA, CHIS.",3,0,3,1,0,355,
28/09/2019,CHIS.,"LAS MARGARITAS, CHIS.",1,0,1,1,0,60,
28/09/2019,TLAX.,"YAUHQUEMECAN, TLAX.",1,0,1,0,0,0,
28/09/2019,TLAX.,"EL CARMEN TEQUEXQUITLA, TLAX.",1,0,1,0,0,0,
29/09/2019,CHIS.,"LAS MARGARITAS, CHIS.",1,0,1,8,0,558,
29/09/2019,CHIS.,"TAPACHULA, CHIS.",0,0,0,0,0,212,
30/09/2019,MÉX.,"CHIMALHUACAN, MEX.",7,0,7,5,0,84,
30/09/2019,TAMPS.,"TAMPICO, TAMPS.",3,0,3,0,0,0,
30/09/2019,MÉX.,"ZUMPANGO, MEX.",2,0,2,2,0,13,
30/09/2019,TLAX.,"TETLATLAHUCA, TLAX.",1,0,1,0,0,0,
30/09/2019,CD. MÉX.,"IZTAPALAPA, CD. MÉX.",1,0,1,0,0,100,
30/09/2019,MÉX.,"METEPEC, MEX.",1,0,1,0,0,0,
30/09/2019,MÉX.,"TENANCINGO, MEX.",0,1,1,0,0,0,
30/09/2019,CHIS.,"TAPACHULA, CHIS.",0,0,0,0,0,199,
30/09/2019,CD. MÉX.,"TLALPAN, CD. MÉX.",0,0,0,0,0,19,
01/10/2019,MÉX.,"CHIMALHUACAN, MEX.",6,1,7,5,0,169,
01/10/2019,CD. MÉX.,"IZTAPALAPA, CD. MÉX.",1,3,4,0,0,5070,
01/10/2019,MÉX.,"ZUMPANGO, MEX.",3,1,4,0,0,4,
01/10/2019,MÉX.,"METEPEC, MEX.",2,0,2,2,0,5,
01/10/2019,TLAX.,"NATIVITAS, TLAX.",0,1,1,0,0,0,
01/10/2019,CD. MÉX.,"LA MAGDALENA CONTRERAS, CD. MÉX.",1,0,1,0,0,175,
01/10/2019,MÉX.,"TENANCINGO, MEX.",1,0,1,0,0,0,
01/10/2019,TAMPS.,"MATAMOROS, TAMPS.",0,0,0,0,0,219,
02/10/2019,MÉX.,"CHIMALHUACAN, MEX.",5,4,9,4,0,21,
02/10/2019,CD. MÉX.,"TLALPAN, CD. MÉX.",3,0,3,0,0,0,
02/10/2019,CD. MÉX.,"LA MAGDALENA CONTRERAS, CD. MÉX.",0,3,3,0,0,0,
02/10/2019,MÉX.,"ZUMPANGO, MEX.",1,2,3,0,26,435,
02/10/2019,CD. MÉX.,"IZTAPALAPA, CD. MÉX.",0,1,1,0,0,0,
02/10/2019,TAMPS.,"TAMPICO, TAMPS.",1,0,1,0,0,0,
02/10/2019,MOR.,"EMILIANO ZAPATA, MOR.",1,0,1,9,0,274,
03/10/2019,MÉX.,"CHIMALHUACAN, MEX.",8,5,13,3,4,198,
03/10/2019,MÉX.,"METEPEC, MEX.",2,1,3,1,0,19,
03/10/2019,MÉX.,"TENANCINGO, MEX.",3,0,3,0,14,0,
03/10/2019,TAMPS.,"TAMPICO, TAMPS.",3,0,3,0,0,0,
03/10/2019,MÉX.,"ZUMPANGO, MEX.",2,0,2,0,0,3,
03/10/2019,TAMPS.,"MATAMOROS, TAMPS.",0,2,2,0,0,0,
03/10/2019,TLAX.,"TETLATLAHUCA, TLAX.",0,1,1,0,0,0,
03/10/2019,TAMPS.,"REYNOSA, TAMPS.",1,0,1,1,0,26,
03/10/2019,CD. MÉX.,"TLALPAN, CD. MÉX.",1,0,1,0,0,2,
03/10/2019,CHIS.,"LAS MARGARITAS, CHIS.",0,0,0,10,0,403,
04/10/2019,MÉX.,"CHIMALHUACAN, MEX.",5,0,5,4,0,130,
04/10/2019,MÉX.,"ZUMPANGO, MEX.",3,1,4,0,0,8,
04/10/2019,CD. MÉX.,"IZTACALCO, CD. MÉX.",2,1,3,0,0,38,
04/10/2019,TAMPS.,"TAMPICO, TAMPS.",2,0,2,0,0,0,
04/10/2019,CD. MÉX.,"TLALPAN, CD. MÉX.",0,2,2,0,0,0,
04/10/2019,TAMPS.,"REYNOSA, TAMPS.",0,0,0,0,0,60,
05/10/2019,TAMPS.,"REYNOSA, TAMPS.",2,0,2,1,0,21,
05/10/2019,TLAX.,"NATIVITAS, TLAX.",1,0,1,0,0,0,
05/10/2019,TAB.,"CENTRO, TAB.",1,0,1,0,0,0,
05/10/2019,CHIS.,"LAS MARGARITAS, CHIS.",0,0,0,1,0,243,
07/10/2019,MÉX.,"CHIMALHUACAN, MEX.",3,6,9,3,0,76,
07/10/2019,TAMPS.,"TAMPICO, TAMPS.",4,1,5,0,0,383,
07/10/2019,MÉX.,"HUIXQUILUCAN, MEX.",3,1,4,0,0,29,
07/10/2019,CD. MÉX.,"IZTAPALAPA, CD. MÉX.",2,1,3,0,0,0,
07/10/2019,MÉX.,"OTUMBA, MEX.",2,1,3,0,3,327,
07/10/2019,TAMPS.,"REYNOSA, TAMPS.",1,1,2,0,0,81,
07/10/2019,CD. MÉX.,"IZTACALCO, CD. MÉX.",1,0,1,0,0,0,
07/10/2019,MOR.,"EMILIANO ZAPATA, MOR.",1,0,1,0,0,0,
07/10/2019,Q. ROO.,"COZUMEL, Q. ROO",0,0,0,0,0,117,
08/10/2019,MÉX.,"HUIXQUILUCAN, MEX.",6,4,10,0,0,0,
08/10/2019,MÉX.,"CHIMALHUACAN, MEX.",4,3,7,1,0,616,
08/10/2019,MÉX.,"METEPEC, MEX.",4,1,5,3,2,702,
08/10/2019,CD. MÉX.,"IZTACALCO, CD. MÉX.",5,0,5,0,0,346,
08/10/2019,CD. MÉX.,"IZTAPALAPA, CD. MÉX.",3,0,3,0,0,0,
08/10/2019,TLAX.,"TENANCINGO, TLAX.",1,0,1,0,0,0,
09/10/2019,CD. MÉX.,"IZTAPALAPA, CD. MÉX.",2,0,2,0,0,341,
09/10/2019,TLAX.,"PANOTLA, TLAX.",1,0,1,0,0,0,
09/10/2019,CD. MÉX.,"IZTACALCO, CD. MÉX.",1,0,1,0,0,15,
09/10/2019,COAH.,"MONCLOVA, COAH.",0,0,0,10,0,728,
09/10/2019,Q. ROO.,"COZUMEL, Q. ROO",0,0,0,0,1,527,
09/10/2019,MOR.,"EMILIANO ZAPATA, MOR.",0,0,0,24,0,611,
10/10/2019,MÉX.,"CHIMALHUACAN, MEX.",10,2,12,4,0,164,
10/10/2019,MÉX.,"HUIXQUILUCAN, MEX.",2,1,3,1,3,27,
10/10/2019,MOR.,"EMILIANO ZAPATA, MOR.",2,0,2,2,0,0,
10/10/2019,CD. MÉX.,"IZTAPALAPA, CD. MÉX.",0,1,1,0,0,0,
10/10/2019,B.C.S.,"LA PAZ, B.C.S.",1,0,1,0,0,0,
10/10/2019,MÉX.,"METEPEC, MEX.",1,0,1,0,0,0,
10/10/2019,MÉX.,"OTUMBA, MEX.",1,0,1,0,0,0,
10/10/2019,CHIS.,"COMITAN DE DOMÍNGUEZ, CHIS.",1,0,1,0,0,0,
10/10/2019,Q. ROO.,"COZUMEL, Q. ROO",0,0,0,0,1,306,
10/10/2019,CD. MÉX.,"IZTACALCO, CD. MÉX.",0,0,0,0,0,48,
11/10/2019,CD. MÉX.,"IZTAPALAPA, CD. MÉX.",0,14,14,0,0,139,
11/10/2019,MÉX.,"CHIMALHUACAN, MEX.",5,4,9,2,0,111,
11/10/2019,CD. MÉX.,"IZTACALCO, CD. MÉX.",2,4,6,0,0,0,
11/10/2019,ZAC.,"FRESNILLO, ZAC.",2,0,2,0,0,0,
11/10/2019,TLAX.,"PAPALOTLA DE XICOHTENCATL, TLAX.",2,0,2,0,0,0,
11/10/2019,TLAX.,"TENANCINGO, TLAX.",1,0,1,0,0,0,
11/10/2019,TLAX.,"PAPALOTLA DE XICOHTENCATL, TLAX.",1,0,1,0,0,0,
11/10/2019,COL.,"COL., COL.",1,0,1,0,0,0,
11/10/2019,ZAC.,"GUADALUPE, ZAC.",0,0,0,13,0,399,
11/10/2019,Q. ROO.,"COZUMEL, Q. ROO",0,0,0,0,9,289,
12/10/2019,MÉX.,"CHIMALHUACAN, MEX.",7,3,10,3,0,0,
12/10/2019,MÉX.,"HUIXQUILUCAN, MEX.",6,1,7,0,0,98,
12/10/2019,MÉX.,"OTUMBA, MEX.",0,1,1,0,0,250,
14/10/2019,CD. MÉX.,"IZTAPALAPA, CD. MÉX.",2,4,6,0,0,148,
14/10/2019,MÉX.,"ZINACANTEPEC, MEX.",2,3,5,0,0,0,
14/10/2019,MÉX.,"IXTAPALUCA, MEX.",5,0,5,0,1,144,
14/10/2019,CD. MÉX.,"IZTACALCO, CD. MÉX.",3,1,4,0,0,0,
14/10/2019,MÉX.,"TEMOAYA, MEX.",1,1,2,0,0,0,
14/10/2019,MÉX.,"TENANGO DEL AIRE, MEX.",1,0,1,0,0,82,
14/10/2019,CD. MÉX.,"CUAJIMALPA DE MOR., CD. MÉX.",1,0,1,0,0,0,
14/10/2019,CHIS.,"COMITAN DE DOMÍNGUEZ, CHIS.",0,0,0,0,0,100,
14/10/2019,ZAC.,"GUADALUPE, ZAC.",0,0,0,13,0,60,
15/10/2019,CD. MÉX.,"IZTAPALAPA, CD. MÉX.",4,10,14,0,0,0,
15/10/2019,MÉX.,"TEMOAYA, MEX.",3,2,5,3,0,154,
15/10/2019,MÉX.,"IXTAPALUCA, MEX.",5,0,5,0,1,142,
15/10/2019,CD. MÉX.,"IZTACALCO, CD. MÉX.",5,0,5,0,0,3,
15/10/2019,CD. MÉX.,"CUAJIMALPA DE MOR., CD. MÉX.",3,0,3,0,0,28,
15/10/2019,MÉX.,"ZINACANTEPEC, MEX.",0,1,1,0,13,2564,
15/10/2019,VER.,"IXHUATLAN DEL CAFE, VER.",1,0,1,0,0,0,
15/10/2019,ZAC.,"ZAC., ZAC.",1,0,1,11,0,316,
15/10/2019,ZAC.,"FRESNILLO, ZAC.",0,1,1,0,0,0,
15/10/2019,COAH.,"SALTILLO, COAH.",0,0,0,0,0,130,
15/10/2019,MÉX.,"TENANGO DEL AIRE, MEX.",0,0,0,0,0,10,
16/10/2019,CD. MÉX.,"IZTAPALAPA, CD. MÉX.",2,3,5,0,0,34,
16/10/2019,MÉX.,"IXTAPALUCA, MEX.",3,0,3,0,0,92,
16/10/2019,CD. MÉX.,"CUAJIMALPA DE MOR., CD. MÉX.",2,0,2,0,0,153,
16/10/2019,CD. MÉX.,"IZTACALCO, CD. MÉX.",2,0,2,0,5,0,
16/10/2019,MÉX.,"TEMOAYA, MEX.",1,1,2,0,0,0,
16/10/2019,MÉX.,"ZINACANTEPEC, MEX.",0,2,2,0,0,34,
16/10/2019,ZAC.,"GUADALUPE, ZAC.",1,0,1,0,0,0,
16/10/2019,ZAC.,"FRESNILLO, ZAC.",1,0,1,8,0,0,
16/10/2019,MÉX.,"TENANGO DEL AIRE, MEX.",1,0,1,0,0,3,
16/10/2019,COAH.,"SALTILLO, COAH.",0,0,0,111,2,2,
16/10/2019,COAH.,"RAMOS ARIZPE, COAH.",0,0,0,0,0,481,
17/10/2019,CHIS.,"EMILIANO ZAPATA, CHIS.",0,3,3,0,0,20,
17/10/2019,CD. MÉX.,"IZTAPALAPA, CD. MÉX.",0,3,3,0,0,244,
17/10/2019,CD. MÉX.,"IZTAPALAPA, CD. MÉX.",2,0,2,0,1,50,
17/10/2019,MÉX.,"IXTAPALUCA, MEX.",1,0,1,0,0,102,
17/10/2019,CHIS.,"COMITAN DE DOMÍNGUEZ, CHIS.",1,0,1,0,0,0,
17/10/2019,CHIH.,"CASAS GRANDES, CHIH.",0,0,0,0,0,175,
17/10/2019,ZAC.,"GUADALUPE, ZAC.",0,0,0,3,0,0,
17/10/2019,MOR.,"EMILIANO ZAPATA, MOR.",0,0,0,1,0,0,
18/10/2019,CD. MÉX.,"CUAJIMALPA DE MOR., CD. MÉX.",4,1,5,0,0,61,
18/10/2019,CD. MÉX.,"IZTAPALAPA, CD. MÉX.",2,2,4,0,0,178,
18/10/2019,CD. MÉX.,"CUAJIMALPA DE MOR., CD. MÉX.",4,0,4,0,0,0,
18/10/2019,B.C.S.,"LA PAZ, B.C.S.",1,0,1,0,0,0,
18/10/2019,ZAC.,"FRESNILLO, ZAC.",1,0,1,0,0,0,
18/10/2019,CHIS.,"EMILIANO ZAPATA, CHIS.",0,0,0,0,0,243,
19/10/2019,MÉX.,"TEMOAYA, MEX.",2,0,2,0,0,0,
19/10/2019,MÉX.,"ZINACANTEPEC, MEX.",1,1,2,0,10,2316,
19/10/2019,MÉX.,"IXTAPALUCA, MEX.",2,0,2,0,0,45,
19/10/2019,MÉX.,"TENANGO DEL AIRE, MEX.",0,2,2,0,0,0,
21/10/2019,CD. MÉX.,"IZTAPALAPA, CD. MÉX.",3,4,7,0,0,111,
21/10/2019,MÉX.,"IXTAPALUCA, MEX.",5,1,6,1,0,93,
21/10/2019,CD. MÉX.,"CUAJIMALPA DE MOR., CD. MÉX.",3,1,4,0,0,1291,
21/10/2019,CD. MÉX.,"IZTACALCO, CD. MÉX.",3,1,4,0,0,0,
21/10/2019,MÉX.,"CHALCO, MEX.",2,0,2,0,0,86,
21/10/2019,ZAC.,"FRESNILLO, ZAC.",1,0,1,0,0,8,
21/10/2019,CHIS.,"JIQUIPILAS, CHIS.",1,0,1,0,0,323,
21/10/2019,MOR.,"EMILIANO ZAPATA, MOR.",1,0,1,14,0,10,
21/10/2019,TLAX.,"CUAPIAXTLA, TLAX.",1,0,1,0,0,0,
21/10/2019,ZAC.,"GUADALUPE, ZAC.",0,0,0,4,0,394,
21/10/2019,ZAC.,"ZAC., ZAC.",0,0,0,2,0,36,
22/10/2019,CD. MÉX.,"CUAJIMALPA DE MOR., CD. MÉX.",5,1,6,0,0,23,
22/10/2019,CD. MÉX.,"IZTACALCO, CD. MÉX.",3,1,4,0,0,93,
22/10/2019,CD. MÉX.,"IZTAPALAPA, CD. MÉX.",3,0,3,0,0,400,
22/10/2019,ZAC.,"ZAC., ZAC.",1,1,2,0,0,101,
22/10/2019,CHIS.,"JIQUIPILAS, CHIS.",1,1,2,2,0,202,
22/10/2019,MÉX.,"IXTAPALUCA, MEX.",2,0,2,2,0,39,
22/10/2019,COAH.,"SALTILLO, COAH.",1,0,1,6,1,325,
22/10/2019,TLAX.,"ALTZAYANCA, TLAX.",1,0,1,0,0,0,
22/10/2019,TLAX.,"CUAPIAXTLA, TLAX.",1,0,1,0,0,0,
22/10/2019,TAB.,"CENTRO, TAB.",1,0,1,0,0,0,
22/10/2019,MÉX.,"CHALCO, MEX.",1,0,1,0,2,261,
23/10/2019,CD. MÉX.,"IZTAPALAPA, CD. MÉX.",5,2,7,0,0,125,
23/10/2019,CD. MÉX.,"CUAJIMALPA DE MOR., CD. MÉX.",5,1,6,0,0,809,
23/10/2019,CD. MÉX.,"AZCAPOTZALCO, CD. MÉX.",3,1,4,0,0,5,
23/10/2019,ZAC.,"GUADALUPE, ZAC.",2,0,2,6,0,875,
23/10/2019,MÉX.,"CHALCO, MEX.",2,0,2,0,0,116,
23/10/2019,TLAX.,"ALTZAYANCA, TLAX.",1,1,2,0,0,0,
23/10/2019,ZAC.,"ZAC., ZAC.",1,0,1,0,0,0,
23/10/2019,CHIS.,"COMITAN DE DOMÍNGUEZ, CHIS.",0,0,0,0,0,115,
23/10/2019,MÉX.,"IXTAPALUCA, MEX.",0,0,0,0,1,146,
23/10/2019,CHIS.,"JIQUIPILAS, CHIS.",0,0,0,0,0,30,
23/10/2019,MOR.,"EMILIANO ZAPATA, MOR.",0,0,0,5,0,300,
24/10/2019,CD. MÉX.,"IZTAPALAPA, CD. MÉX.",3,3,6,0,0,146,
24/10/2019,MÉX.,"CHALCO, MEX.",2,0,2,0,0,64,
24/10/2019,MÉX.,"IXTAPALUCA, MEX.",1,1,2,0,0,139,
24/10/2019,CD. MÉX.,"AZCAPOTZALCO, CD. MÉX.",0,1,1,0,0,633,
24/10/2019,TLAX.,"ALTZAYANCA, TLAX.",0,1,1,0,0,0,
24/10/2019,MÉX.,"CALIMAYA, MEX.",0,0,0,0,0,66,
24/10/2019,CD. MÉX.,"CUAJIMALPA DE MOR., CD. MÉX.",0,0,0,0,1,112,
24/10/2019,MOR.,"EMILIANO ZAPATA, MOR.",0,0,0,5,0,300,
25/10/2019,CD. MÉX.,"CUAJIMALPA DE MOR., CD. MÉX.",6,3,9,0,0,0,
25/10/2019,CD. MÉX.,"IZTAPALAPA, CD. MÉX.",2,4,6,0,0,63,
25/10/2019,CD. MÉX.,"AZCAPOTZALCO, CD. MÉX.",0,1,1,0,0,0,
25/10/2019,COL.,"COL., COL.",0,1,1,0,0,0,
25/10/2019,CHIS.,"LA INDEPENDENCIA, CHIS.",0,1,1,0,0,0,
25/10/2019,ZAC.,"GUADALUPE, ZAC.",0,0,0,4,0,0,
26/10/2019,MÉX.,"IXTAPALUCA, MEX.",5,1,6,4,0,135,
26/10/2019,MÉX.,"CHALCO, MEX.",3,0,3,0,0,0,
26/10/2019,CHIS.,"LA INDEPENDENCIA, CHIS.",0,0,0,0,0,169,
28/10/2019,CD. MÉX.,"IZTAPALAPA, CD. MÉX.",1,1,2,0,0,2,
28/10/2019,CHIS.,"JIQUIPILAS, CHIS.",1,0,1,1,0,170,
28/10/2019,CD. MÉX.,"TLAHUAC, CD. MÉX.",1,0,1,0,0,6,
28/10/2019,VER.,"TUXPAM, VER.",1,0,1,0,0,0,
28/10/2019,MÉX.,"TEXCOCO, MEX.",1,0,1,1,1,12,
28/10/2019,MÉX.,"CHALCO, MEX.",0,1,1,0,0,1000,
28/10/2019,CHIS.,"CINTALAPA, CHIS.",0,0,0,0,1,390,
28/10/2019,CHIS.,"LA INDEPENDENCIA, CHIS.",0,0,0,3,0,200,
29/10/2019,CD. MÉX.,"IZTAPALAPA, CD. MÉX.",5,0,5,0,2,615,
29/10/2019,MÉX.,"CHALCO, MEX.",3,2,5,0,0,201,
29/10/2019,VER.,"COSOLEACAQUE, VER.",3,0,3,0,0,339,
29/10/2019,CD. MÉX.,"AZCAPOTZALCO, CD. MÉX.",2,1,3,0,0,0,
29/10/2019,MÉX.,"TEXCOCO, MEX.",1,1,2,0,0,113,
29/10/2019,B.C.S.,"LOS CABOS, B.C.S.",1,0,1,0,0,0,
29/10/2019,CHIS.,"LA INDEPENDENCIA, CHIS.",0,1,1,0,0,0,
29/10/2019,VER.,"TUXPAM, VER.",1,0,1,0,0,0,
29/10/2019,CD. MÉX.,"TLAHUAC, CD. MÉX.",1,0,1,0,0,0,
29/10/2019,ZAC.,"GUADALUPE, ZAC.",0,0,0,2,0,0,
30/10/2019,CD. MÉX.,"AZCAPOTZALCO, CD. MÉX.",2,2,4,0,0,52,
30/10/2019,CD. MÉX.,"IZTAPALAPA, CD. MÉX.",3,1,4,0,0,773,
30/10/2019,MÉX.,"TEXCOCO, MEX.",2,0,2,1,0,100,
30/10/2019,MÉX.,"CHALCO, MEX.",1,1,2,0,0,530,
30/10/2019,CD. MÉX.,"TLAHUAC, CD. MÉX.",1,1,2,0,0,13,
30/10/2019,VER.,"COSOLEACAQUE, VER.",2,0,2,0,0,100,
30/10/2019,TLAX.,"XALOZTOC, TLAX.",1,0,1,0,0,0,
30/10/2019,CHIS.,"CHIAPILLA, CHIS.",0,0,0,2,0,0,
31/10/2019,CD. MÉX.,"AZCAPOTZALCO, CD. MÉX.",3,0,3,0,0,0,
31/10/2019,MÉX.,"TEXCOCO, MEX.",1,0,1,1,7,85,
31/10/2019,MÉX.,"CHALCO, MEX.",1,0,1,0,0,366,
31/10/2019,VER.,"COSOLEACAQUE, VER.",1,0,1,1,0,37,
31/10/2019,CHIS.,"LA INDEPENDENCIA, CHIS.",0,0,0,1,0,50,
31/10/2019,CD. MÉX.,"IZTAPALAPA, CD. MÉX.",0,0,0,0,0,796,
01/11/2019,CD. MÉX.,"TLAHUAC, CD. MÉX.",0,6,6,0,0,65,
01/11/2019,CD. MÉX.,"AZCAPOTZALCO, CD. MÉX.",1,3,4,0,0,0,
01/11/2019,MÉX.,"OTZOLOTEPEC, MEX.",0,3,3,1,1,82,
01/11/2019,CD. MÉX.,"IZTAPALAPA, CD. MÉX.",2,1,3,0,0,896,
01/11/2019,MÉX.,"TEXCOCO, MEX.",2,0,2,0,0,200,
01/11/2019,MÉX.,"CHALCO, MEX.",1,1,2,0,0,58,
01/11/2019,VER.,"COSOLEACAQUE, VER.",1,0,1,0,0,0,
04/11/2019,CD. MÉX.,"BENITO JUAREZ, CD. MÉX.",1,7,8,0,0,67,
04/11/2019,CD. MÉX.,"AZCAPOTZALCO, CD. MÉX.",3,1,4,0,0,17,
04/11/2019,MÉX.,"CHAPA DE MOTA, MEX.",0,1,1,0,0,0,
04/11/2019,MÉX.,"TEXCOCO, MEX.",1,0,1,0,0,313,
04/11/2019,MÉX.,"LA PAZ, MEX.",1,0,1,0,1,63,
04/11/2019,TLAX.,"LAZARO CARDENAS, TLAX.",1,0,1,0,0,0,
04/11/2019,CD. MÉX.,"TLAHUAC, CD. MÉX.",0,0,0,0,0,25,
04/11/2019,ZAC.,"GUADALUPE, ZAC.",0,0,0,8,0,29,
05/11/2019,MÉX.,"LA PAZ, MEX.",7,0,7,0,0,875,
05/11/2019,CD. MÉX.,"BENITO JUAREZ, CD. MÉX.",4,0,4,0,0,137,
05/11/2019,CD. MÉX.,"AZCAPOTZALCO, CD. MÉX.",1,2,3,0,0,0,
05/11/2019,CD. MÉX.,"TLAHUAC, CD. MÉX.",2,0,2,0,0,103,
05/11/2019,MÉX.,"SAN MATEO ATENCO, MEX.",1,0,1,0,0,0,
05/11/2019,TAB.,"CENTRO, TAB.",1,0,1,0,0,8,
05/11/2019,ZAC.,"GUADALUPE, ZAC.",0,0,0,0,0,155,
05/11/2019,ZAC.,"FRESNILLO, ZAC.",0,0,0,6,0,319,
06/11/2019,CD. MÉX.,"BENITO JUAREZ, CD. MÉX.",6,3,9,0,0,218,
06/11/2019,MÉX.,"LA PAZ, MEX.",5,0,5,0,0,314,
06/11/2019,MÉX.,"TEXCOCO, MEX.",4,0,4,2,0,1254,
06/11/2019,ZAC.,"GUADALUPE, ZAC.",2,0,2,0,0,0,
06/11/2019,CD. MÉX.,"AZCAPOTZALCO, CD. MÉX.",2,0,2,0,0,10,
06/11/2019,TLAX.,"EMILIANO ZAPATA, TLAX.",0,1,1,0,0,0,
06/11/2019,ZAC.,"FRESNILLO, ZAC.",0,0,0,4,0,0,
07/11/2019,CD. MÉX.,"IZTAPALAPA, CD. MÉX.",0,6,6,0,1,0,
07/11/2019,CD. MÉX.,"BENITO JUAREZ, CD. MÉX.",2,2,4,0,0,165,
07/11/2019,MÉX.,"SAN MATEO ATENCO, MEX.",3,0,3,0,0,0,
07/11/2019,MÉX.,"SAN MATEO ATENCO, MEX.",3,0,3,0,0,0,
07/11/2019,MÉX.,"LA PAZ, MEX.",2,1,3,0,1,156,
07/11/2019,MÉX.,"TEXCOCO, MEX.",1,1,2,0,0,7,
07/11/2019,MÉX.,"CHAPA DE MOTA, MEX.",1,0,1,0,0,0,
07/11/2019,CD. MÉX.,"TLAHUAC, CD. MÉX.",1,0,1,0,0,100,
07/11/2019,CHIH.,"CASAS GRANDES, CHIH.",0,1,1,0,0,310,
07/11/2019,TAB.,"CARDENAS, TAB.",1,0,1,0,0,0,
07/11/2019,ZAC.,"FRESNILLO, ZAC.",0,0,0,6,0,0,
08/11/2019,MÉX.,"LA PAZ, MEX.",3,1,4,0,0,76,
08/11/2019,ZAC.,"ZAC., ZAC.",1,2,3,1,0,0,
08/11/2019,CD. MÉX.,"BENITO JUAREZ, CD. MÉX.",1,1,2,0,0,25,
08/11/2019,CD. MÉX.,"IZTAPALAPA, CD. MÉX.",1,1,2,0,1,0,
08/11/2019,CD. MÉX.,"TLAHUAC, CD. MÉX.",1,0,1,0,0,6,
08/11/2019,MÉX.,"TEXCOCO, MEX.",1,0,1,0,0,207,
08/11/2019,MÉX.,"CHAPA DE MOTA, MEX.",1,0,1,0,0,0,
08/11/2019,MÉX.,"SAN MATEO ATENCO, MEX.",0,0,0,0,0,338,
08/11/2019,ZAC.,"GUADALUPE, ZAC.",0,0,0,2,0,0,
09/11/2019,MÉX.,"LA PAZ, MEX.",3,2,5,0,0,100,
09/11/2019,MÉX.,"SAN MATEO ATENCO, MEX.",2,0,2,1,20,22,
09/11/2019,MÉX.,"CHAPA DE MOTA, MEX.",1,0,1,0,0,0,
09/11/2019,MÉX.,"TEXCOCO, MEX.",1,0,1,0,0,13,
11/11/2019,CD. MÉX.,"BENITO JUAREZ, CD. MÉX.",4,1,5,0,0,457,
11/11/2019,MÉX.,"CUAUTITLAN IZCALLI, MEX.",4,1,5,0,0,249,
11/11/2019,MÉX.,"TEPETLAOXTOC, MEX.",3,1,4,1,3,0,
11/11/2019,CD. MÉX.,"CUAUHTEMOC, CD. MÉX.",1,0,1,0,0,0,
11/11/2019,MÉX.,"JOCOTITLAN, MEX.",0,0,0,0,0,40,
12/11/2019,CD. MÉX.,"IZTAPALAPA, CD. MÉX.",4,3,7,0,0,30,
12/11/2019,CD. MÉX.,"BENITO JUAREZ, CD. MÉX.",3,3,6,0,0,427,
12/11/2019,MÉX.,"JOCOTITLAN, MEX.",0,4,4,0,1,0,
12/11/2019,CD. MÉX.,"CUAUHTEMOC, CD. MÉX.",3,0,3,0,0,38,
12/11/2019,CHIS.,"CHILÓN, CHIS.",3,0,3,0,0,48,
12/11/2019,MÉX.,"EL ORO, MEX.",1,1,2,0,0,0,
12/11/2019,MÉX.,"TEPETLAOXTOC, MEX.",1,1,2,0,0,0,
12/11/2019,MÉX.,"CUAUTITLAN IZCALLI, MEX.",2,0,2,0,1,0,
12/11/2019,TLAX.,"TEOLOCHOLCO, TLAX.",1,0,1,0,0,0,
13/11/2019,CD. MÉX.,"BENITO JUAREZ, CD. MÉX.",4,3,7,0,0,962,
13/11/2019,CD. MÉX.,"IZTAPALAPA, CD. MÉX.",4,3,7,0,0,48,
13/11/2019,CHIS.,"TUXTLA GUTIÉRREZ, CHIS.",1,6,7,0,0,0,
13/11/2019,MÉX.,"TEPETLAOXTOC, MEX.",2,1,3,0,0,43,
13/11/2019,TLAX.,"TEOLOCHOLCO, TLAX.",2,0,2,0,0,0,
13/11/2019,CHIS.,"VILLAFLORES, CHIS.",0,2,2,0,0,198,
13/11/2019,MÉX.,"CUAUTITLAN IZCALLI, MEX.",0,2,2,0,0,20,
13/11/2019,TLAX.,"TEOLOCHOLCO, TLAX.",2,0,2,0,0,0,
13/11/2019,COAH.,"SALTILLO, COAH.",1,0,1,2,0,1342,
13/11/2019,VER.,"VILLA ALDAMA, VER.",0,1,1,0,0,0,
13/11/2019,CHIS.,"CHILÓN, CHIS.",0,0,0,0,0,100,
14/11/2019,CHIS.,"TUXTLA GUTIÉRREZ, CHIS.",4,2,6,0,12,0,
14/11/2019,CHIS.,"VILLAFLORES, CHIS.",0,4,4,0,3,355,
14/11/2019,TLAX.,"TEOLOCHOLCO, TLAX.",3,0,3,0,0,0,
14/11/2019,CHIS.,"TAPACHULA, CHIS.",1,1,2,0,0,6,
14/11/2019,CD. MÉX.,"BENITO JUAREZ, CD. MÉX.",2,0,2,0,0,31,
14/11/2019,CD. MÉX.,"IZTAPALAPA, CD. MÉX.",2,0,2,0,0,1555,
14/11/2019,CHIS.,"CINTALAPA, CHIS.",1,0,1,0,0,164,
14/11/2019,CHIS.,"CHILÓN, CHIS.",1,0,1,0,0,0,
14/11/2019,MÉX.,"CUAUTITLAN IZCALLI, MEX.",0,1,1,0,1,225,
14/11/2019,CHIS.,"COMITAN DE DOMÍNGUEZ, CHIS.",0,0,0,0,1,29,
15/11/2019,CD. MÉX.,"BENITO JUAREZ, CD. MÉX.",6,5,11,0,0,1112,
15/11/2019,CHIS.,"TUXTLA GUTIÉRREZ, CHIS.",1,8,9,3,13,218,
15/11/2019,MÉX.,"TEPETLAOXTOC, MEX.",1,2,3,0,0,0,
15/11/2019,CHIS.,"VILLAFLORES, CHIS.",1,1,2,0,0,667,
15/11/2019,VER.,"VILLA ALDAMA, VER.",0,2,2,0,0,0,
15/11/2019,CD. MÉX.,"CUAUHTEMOC, CD. MÉX.",1,0,1,0,0,0,
15/11/2019,MÉX.,"CUAUTITLAN, MEX.",1,0,1,0,0,109,
15/11/2019,CHIS.,"CINTALAPA, CHIS.",1,0,1,0,0,458,
15/11/2019,CHIS.,"CHILÓN, CHIS.",0,1,1,0,0,200,
15/11/2019,MÉX.,"EL ORO, MEX.",1,0,1,0,0,0,
15/11/2019,MÉX.,"EL ORO, MEX.",1,0,1,0,0,0,
15/11/2019,CHIS.,"SUCHIATE, CHIS.",1,0,1,0,0,6,
15/11/2019,CHIS.,"COMITAN DE DOMÍNGUEZ, CHIS.",0,0,0,2,0,60,
16/11/2019,MÉX.,"EL ORO, MEX.",2,2,4,0,0,0,
16/11/2019,MÉX.,"CUAUTITLAN IZCALLI, MEX.",1,3,4,0,0,691,
16/11/2019,CHIS.,"PALENQUE, CHIS.",3,0,3,0,0,46,
16/11/2019,CHIS.,"TUXTLA GUTIÉRREZ, CHIS.",2,0,2,1,0,50,
16/11/2019,MÉX.,"TEPETLAOXTOC, MEX.",1,1,2,0,0,0,
16/11/2019,CHIS.,"VILLAFLORES, CHIS.",0,1,1,0,0,0,
16/11/2019,CHIS.,"COMITAN DE DOMÍNGUEZ, CHIS.",0,1,1,0,0,0,
16/11/2019,CHIS.,"CINTALAPA, CHIS.",0,0,0,0,0,79,
16/11/2019,CHIS.,"SUCHIATE, CHIS.",0,0,0,0,0,165,
17/11/2019,CHIS.,"COMITAN DE DOMÍNGUEZ, CHIS.",1,0,1,0,1,160,
17/11/2019,CHIS.,"CINTALAPA, CHIS.",0,0,0,1,0,82,
17/11/2019,CHIS.,"TUXTLA GUTIÉRREZ, CHIS.",0,0,0,0,1,8,
19/11/2019,CD. MÉX.,"IZTAPALAPA, CD. MÉX.",4,4,8,0,0,972,
19/11/2019,MÉX.,"CHALCO, MEX.",4,0,4,3,0,328,
19/11/2019,MÉX.,"ALMOLOYA DE JUAREZ, MEX.",3,0,3,0,0,118,
19/11/2019,CD. MÉX.,"CUAUHTEMOC, CD. MÉX.",2,0,2,0,0,9,
19/11/2019,MOR.,"JIUTEPEC, MOR.",2,0,2,50,0,29,
19/11/2019,MÉX.,"COYOTEPEC, MEX.",2,0,2,0,0,321,
19/11/2019,TLAX.,"HUEYOTLIPAN, TLAX.",1,0,1,0,0,0,
19/11/2019,CD. MÉX.,"COYOACAN, CD. MÉX.",0,0,0,0,0,58,
19/11/2019,MÉX.,"TEPETLAOXTOC, MEX.",0,0,0,0,7,0,
20/11/2019,MÉX.,"VALLE DE CHALCO SOLIDARIDAD, MEX.",4,0,4,2,0,5,
20/11/2019,MÉX.,"ALMOLOYA DE JUAREZ, MEX.",1,2,3,0,0,27,
20/11/2019,CD. MÉX.,"CUAUHTEMOC, CD. MÉX.",2,0,2,0,0,41,
20/11/2019,CD. MÉX.,"COYOACAN, CD. MÉX.",0,1,1,0,0,86,
20/11/2019,MÉX.,"COYOTEPEC, MEX.",1,0,1,0,0,248,
20/11/2019,MOR.,"JIUTEPEC, MOR.",0,0,0,92,1,151,
21/11/2019,CD. MÉX.,"IZTAPALAPA, CD. MÉX.",3,6,9,0,0,0,
21/11/2019,MÉX.,"VALLE DE CHALCO SOLIDARIDAD, MEX.",4,2,6,2,0,82,
21/11/2019,CD. MÉX.,"CUAUHTEMOC, CD. MÉX.",4,1,5,0,0,164,
21/11/2019,MÉX.,"COYOTEPEC, MEX.",2,0,2,0,0,26,
21/11/2019,CD. MÉX.,"COYOACAN, CD. MÉX.",1,0,1,0,0,870,
21/11/2019,MÉX.,"ALMOLOYA DE JUAREZ, MEX.",0,1,1,0,0,0,
21/11/2019,TAB.,"CENTRO, TAB.",0,1,1,0,0,0,
22/11/2019,CD. MÉX.,"CUAUHTEMOC, CD. MÉX.",5,7,12,0,0,959,
22/11/2019,MÉX.,"ALMOLOYA DE JUAREZ, MEX.",5,0,5,0,0,0,
22/11/2019,CD. MÉX.,"COYOACAN, CD. MÉX.",2,3,5,0,0,0,
22/11/2019,MÉX.,"COYOTEPEC, MEX.",4,1,5,0,3,228,
22/11/2019,MÉX.,"VALLE DE CHALCO SOLIDARIDAD, MEX.",3,1,4,2,25,0,
22/11/2019,MOR.,"JIUTEPEC, MOR.",0,1,1,1,0,0,
22/11/2019,CD. MÉX.,"IZTAPALAPA, CD. MÉX.",1,0,1,0,0,0,
22/11/2019,COAH.,"SALTILLO, COAH.",0,0,0,3,0,3,
23/11/2019,MÉX.,"TEPETLAOXTOC, MEX.",4,0,4,0,0,0,
23/11/2019,MÉX.,"COYOTEPEC, MEX.",3,1,4,0,0,0,
23/11/2019,MÉX.,"ALMOLOYA DE JUAREZ, MEX.",3,0,3,0,0,6,
23/11/2019,MÉX.,"VALLE DE CHALCO SOLIDARIDAD, MEX.",1,1,2,0,0,96,
25/11/2019,CD. MÉX.,"IZTAPALAPA, CD. MÉX.",0,6,6,0,0,3666,
25/11/2019,GTO.,"LEON, GTO.",1,2,3,0,0,0,
25/11/2019,CD. MÉX.,"COYOACAN, CD. MÉX.",2,0,2,0,2,2028,
25/11/2019,CD. MÉX.,"CUAUHTEMOC, CD. MÉX.",1,0,1,0,0,0,
25/11/2019,MOR.,"JIUTEPEC, MOR.",0,0,0,0,10,261,
26/11/2019,CD. MÉX.,"IZTAPALAPA, CD. MÉX.",2,5,7,0,0,0,
26/11/2019,GTO.,"LEON, GTO.",2,1,3,0,0,0,
26/11/2019,S.L.P.,"CIUDAD VALLES, S.L.P.",1,2,3,1,0,0,
26/11/2019,CD. MÉX.,"XOCHIMILCO, CD. MÉX.",2,0,2,0,0,0,
26/11/2019,CD. MÉX.,"COYOACAN, CD. MÉX.",2,0,2,0,0,111,
26/11/2019,MOR.,"JIUTEPEC, MOR.",1,0,1,1,0,34,
27/11/2019,GTO.,"LEON, GTO.",3,5,8,0,0,0,
27/11/2019,CD. MÉX.,"IZTAPALAPA, CD. MÉX.",0,6,6,0,0,0,
27/11/2019,CD. MÉX.,"COYOACAN, CD. MÉX.",1,2,3,0,0,0,
27/11/2019,S.L.P.,"TAMAZUNCHALE, S.L.P.",1,0,1,0,0,0,
27/11/2019,S.L.P.,"SAN LUIS POTOSI, S.L.P.",1,0,1,0,0,0,
27/11/2019,CD. MÉX.,"XOCHIMILCO, CD. MÉX.",1,0,1,0,0,22,
27/11/2019,MOR.,"JIUTEPEC, MOR.",1,0,1,0,0,0,
27/11/2019,VER.,"PEROTE, VER.",0,0,0,7,0,0,
28/11/2019,GTO.,"LEON, GTO.",0,5,5,0,0,0,
28/11/2019,CD. MÉX.,"COYOACAN, CD. MÉX.",4,0,4,0,1,105,
28/11/2019,ZAC.,"GUADALUPE, ZAC.",4,0,4,3,0,142,
28/11/2019,CD. MÉX.,"XOCHIMILCO, CD. MÉX.",3,0,3,5,0,0,
28/11/2019,TLAX.,"TLAX., TLAX.",2,0,2,0,0,0,
28/11/2019,CD. MÉX.,"IZTAPALAPA, CD. MÉX.",1,1,2,0,1,43,
28/11/2019,S.L.P.,"SAN LUIS POTOSI, S.L.P.",1,0,1,10,0,0,
28/11/2019,MOR.,"JIUTEPEC, MOR.",0,1,1,0,0,0,
28/11/2019,ZAC.,"ZAC., ZAC.",1,0,1,0,0,0,
28/11/2019,VER.,"PEROTE, VER.",0,0,0,7,0,0,
28/11/2019,ZAC.,"FRESNILLO, ZAC.",0,0,0,2,0,0,
29/11/2019,GTO.,"LEON, GTO.",9,2,11,0,0,0,
29/11/2019,CD. MÉX.,"IZTAPALAPA, CD. MÉX.",1,7,8,0,0,7,
29/11/2019,CD. MÉX.,"COYOACAN, CD. MÉX.",4,0,4,0,0,106,
29/11/2019,ZAC.,"ZAC., ZAC.",2,0,2,0,0,62,
29/11/2019,ZAC.,"FRESNILLO, ZAC.",2,0,2,4,0,0,
29/11/2019,HGO.,"YAHUALICA, HGO.",1,1,2,0,0,0,
29/11/2019,ZAC.,"GUADALUPE, ZAC.",0,1,1,15,0,0,
29/11/2019,S.L.P.,"TAMAZUNCHALE, S.L.P.",1,0,1,0,0,0,
29/11/2019,CD. MÉX.,"XOCHIMILCO, CD. MÉX.",1,0,1,0,0,0,
29/11/2019,HGO.,"APAN, HGO.",0,0,0,1,1,0,
30/11/2019,S.L.P.,"SAN LUIS POTOSI, S.L.P.",1,0,1,8,3,0,
30/11/2019,S.L.P.,"CIUDAD VALLES, S.L.P.",0,0,0,4,0,0,
30/11/2019,HGO.,"APAN, HGO.",0,0,0,3,1,0,
01/12/2019,CD. MÉX.,"IZTAPALAPA, CD. MÉX.",2,4,6,0,0,19,
01/12/2019,CD. MÉX.,"MIGUEL HGO., CD. MÉX.",2,0,2,0,0,0,
01/12/2019,S.L.P.,"SAN LUIS POTOSI, S.L.P.",1,0,1,0,0,0,
02/12/2019,GTO.,"LEON, GTO.",4,1,5,0,0,0,
02/12/2019,N.L.,"GUADALUPE, N.L.",1,1,2,2,0,133,
02/12/2019,ZAC.,"GUADALUPE, ZAC.",1,0,1,1,0,120,
02/12/2019,ZAC.,"FRESNILLO, ZAC.",1,0,1,1,0,1,
02/12/2019,B.C.,"TIJUANA, B.C.",1,0,1,2,0,57,
02/12/2019,ZAC.,"ZAC., ZAC.",0,0,0,3,0,8,
03/12/2019,CD. MÉX.,"XOCHIMILCO, CD. MÉX.",2,9,11,0,0,44,
03/12/2019,GTO.,"LEON, GTO.",2,5,7,0,4,0,
03/12/2019,ZAC.,"FRESNILLO, ZAC.",2,0,2,1,0,0,
03/12/2019,N.L.,"GUADALUPE, N.L.",2,0,2,0,0,352,
03/12/2019,CD. MÉX.,"MIGUEL HGO., CD. MÉX.",1,1,2,0,0,7,
03/12/2019,CD. MÉX.,"IZTAPALAPA, CD. MÉX.",2,0,2,0,0,90,
03/12/2019,ZAC.,"ZAC., ZAC.",1,0,1,0,0,0,
03/12/2019,COAH.,"RAMOS ARIZPE, COAH.",1,0,1,1,0,0,
03/12/2019,S.L.P.,"SOLEDAD DE GRACIANO SANCHEZ, S.L.P.",1,0,1,1,0,18,
04/12/2019,GTO.,"LEON, GTO.",4,5,9,0,0,0,
04/12/2019,CD. MÉX.,"IZTAPALAPA, CD. MÉX.",1,7,8,0,0,129,
04/12/2019,CD. MÉX.,"XOCHIMILCO, CD. MÉX.",2,1,3,0,0,16,
04/12/2019,N.L.,"GUADALUPE, N.L.",2,0,2,3,0,0,
04/12/2019,ZAC.,"GUADALUPE, ZAC.",1,0,1,3,0,21,
04/12/2019,ZAC.,"FRESNILLO, ZAC.",0,0,0,0,0,76,
04/12/2019,S.L.P.,"TAMAZUNCHALE, S.L.P.",0,0,0,0,1,0,
04/12/2019,S.L.P.,"SAN LUIS POTOSI, S.L.P.",0,0,0,0,0,163,
04/12/2019,MOR.,"JIUTEPEC, MOR.",0,0,0,66,0,0,
05/12/2019,GTO.,"LEON, GTO.",1,2,3,0,0,0,
05/12/2019,ZAC.,"FRESNILLO, ZAC.",2,0,2,1,2,3,
05/12/2019,N.L.,"GUADALUPE, N.L.",2,0,2,0,0,0,
05/12/2019,CD. MÉX.,"IZTAPALAPA, CD. MÉX.",1,1,2,0,0,1,
05/12/2019,MOR.,"JIUTEPEC, MOR.",1,1,2,55,2,594,
05/12/2019,ZAC.,"GUADALUPE, ZAC.",1,0,1,17,0,48,
05/12/2019,S.L.P.,"SAN LUIS POTOSI, S.L.P.",1,0,1,14,2,0,
05/12/2019,S.L.P.,"SOLEDAD DE GRACIANO SANCHEZ, S.L.P.",1,0,1,0,0,0,
05/12/2019,CD. MÉX.,"XOCHIMILCO, CD. MÉX.",0,1,1,0,0,140,
05/12/2019,ZAC.,"ZAC., ZAC.",0,0,0,1,0,206,
06/12/2019,GTO.,"LEON, GTO.",11,3,14,0,0,0,
06/12/2019,CD. MÉX.,"IZTAPALAPA, CD. MÉX.",1,8,9,0,0,0,
06/12/2019,CD. MÉX.,"XOCHIMILCO, CD. MÉX.",0,5,5,0,0,0,
06/12/2019,ZAC.,"GUADALUPE, ZAC.",3,0,3,1,0,50,
06/12/2019,CD. MÉX.,"MIGUEL HGO., CD. MÉX.",3,0,3,0,0,37,
06/12/2019,ZAC.,"FRESNILLO, ZAC.",1,0,1,0,0,0,
06/12/2019,JAL.,"GUADALAJARA, JAL.",1,0,1,0,0,0,
06/12/2019,COAH.,"SALTILLO, COAH.",0,0,0,0,0,12,
06/12/2019,COAH.,"RAMOS ARIZPE, COAH.",0,0,0,0,0,225,
06/12/2019,S.L.P.,"SAN LUIS POTOSI, S.L.P.",0,0,0,20,0,0,
07/12/2019,JAL.,"GUADALAJARA, JAL.",1,0,1,0,0,0,
09/12/2019,CD. MÉX.,"MIGUEL HGO., CD. MÉX.",1,2,3,0,16,1165,
09/12/2019,SON.,"HERMOSILLO, SON.",2,0,2,0,0,0,
09/12/2019,ZAC.,"GUADALUPE, ZAC.",2,0,2,1,0,417,
09/12/2019,CD. MÉX.,"IZTAPALAPA, CD. MÉX.",1,1,2,0,0,243,
09/12/2019,S.L.P.,"SAN LUIS POTOSI, S.L.P.",2,0,2,2,0,0,
09/12/2019,GTO.,"LEON, GTO.",0,1,1,0,0,0,
09/12/2019,CD. MÉX.,"IZTACALCO, CD. MÉX.",0,1,1,0,0,0,
09/12/2019,S.L.P.,"CIUDAD VALLES, S.L.P.",1,0,1,1,0,0,
10/12/2019,CD. MÉX.,"IZTAPALAPA, CD. MÉX.",1,9,10,0,0,500,
10/12/2019,N.L.,"GUADALUPE, N.L.",3,0,3,4,0,13,
10/12/2019,CD. MÉX.,"MIGUEL HGO., CD. MÉX.",2,1,3,0,0,113,
10/12/2019,ZAC.,"GUADALUPE, ZAC.",0,2,2,13,0,4,
10/12/2019,CD. MÉX.,"IZTACALCO, CD. MÉX.",1,0,1,0,0,129,
10/12/2019,JAL.,"SAN MARTIN HGO., JAL.",1,0,1,0,0,0,
10/12/2019,S.L.P.,"CIUDAD VALLES, S.L.P.",0,1,1,2,0,0,
10/12/2019,S.L.P.,"SOLEDAD DE GRACIANO SANCHEZ, S.L.P.",1,0,1,0,2,0,
10/12/2019,ZAC.,"ZAC., ZAC.",0,0,0,5,0,0,
10/12/2019,ZAC.,"FRESNILLO, ZAC.",0,0,0,0,0,13,
10/12/2019,S.L.P.,"SAN LUIS POTOSI, S.L.P.",0,0,0,15,7,0,
11/12/2019,ZAC.,"GUADALUPE, ZAC.",3,0,3,1,0,6,
11/12/2019,JAL.,"GUADALAJARA, JAL.",2,0,2,0,0,0,
11/12/2019,CD. MÉX.,"IZTAPALAPA, CD. MÉX.",2,0,2,0,0,3388,
11/12/2019,ZAC.,"FRESNILLO, ZAC.",1,0,1,4,0,107,
11/12/2019,CD. MÉX.,"IZTACALCO, CD. MÉX.",1,0,1,0,0,86,
11/12/2019,CD. MÉX.,"MIGUEL HGO., CD. MÉX.",1,0,1,0,0,5702,
11/12/2019,B.C.,"TIJUANA, B.C.",0,1,1,0,0,0,
11/12/2019,S.L.P.,"CIUDAD VALLES, S.L.P.",0,0,0,4,0,0,
11/12/2019,N.L.,"APODACA, N.L.",0,0,0,3,0,0,
11/12/2019,B.C.,"MEXICALI, B.C.",0,0,0,0,1,0,
12/12/2019,CD. MÉX.,"IZTAPALAPA, CD. MÉX.",3,6,9,0,0,50,
12/12/2019,CD. MÉX.,"IZTACALCO, CD. MÉX.",2,6,8,0,4,55,
12/12/2019,S.L.P.,"SAN LUIS POTOSI, S.L.P.",1,1,2,7,0,23,
12/12/2019,CD. MÉX.,"MIGUEL HGO., CD. MÉX.",0,1,1,0,0,0,
12/12/2019,JAL.,"GUADALAJARA, JAL.",0,1,1,0,0,0,
13/12/2019,CD. MÉX.,"IZTAPALAPA, CD. MÉX.",3,8,11,0,0,275,
13/12/2019,CD. MÉX.,"IZTACALCO, CD. MÉX.",0,4,4,0,0,32,
13/12/2019,GTO.,"LEON, GTO.",4,0,4,0,0,0,
13/12/2019,CD. MÉX.,"MIGUEL HGO., CD. MÉX.",3,0,3,0,16,1494,
13/12/2019,N.L.,"GUADALUPE, N.L.",1,0,1,50,1,0,
14/12/2019,JAL.,"GUADALAJARA, JAL.",1,0,1,0,0,51,
15/12/2019,S.L.P.,"SAN LUIS POTOSI, S.L.P.",1,0,1,0,0,0,
15/12/2019,JAL.,"GUADALAJARA, JAL.",1,0,1,0,0,51,
16/12/2019,CD. MÉX.,"IZTAPALAPA, CD. MÉX.",2,9,11,0,0,53,
16/12/2019,JAL.,"GUADALAJARA, JAL.",0,4,4,0,0,0,
16/12/2019,S.L.P.,"SOLEDAD DE GRACIANO SANCHEZ, S.L.P.",3,0,3,0,0,0,
16/12/2019,CD. MÉX.,"IZTACALCO, CD. MÉX.",0,3,3,0,0,735,
16/12/2019,CD. MÉX.,"MIGUEL HGO., CD. MÉX.",1,0,1,0,3,1659,
17/12/2019,CD. MÉX.,"IZTAPALAPA, CD. MÉX.",1,11,12,0,0,0,
17/12/2019,CD. MÉX.,"IZTACALCO, CD. MÉX.",1,6,7,0,0,1113,
17/12/2019,CD. MÉX.,"MIGUEL HGO., CD. MÉX.",0,1,1,0,0,0,
17/12/2019,S.L.P.,"CIUDAD VALLES, S.L.P.",0,0,0,2,0,0,
18/12/2019,CD. MÉX.,"IZTAPALAPA, CD. MÉX.",4,10,14,0,0,54,
18/12/2019,CD. MÉX.,"IZTACALCO, CD. MÉX.",2,7,9,0,0,0,
18/12/2019,CD. MÉX.,"MIGUEL HGO., CD. MÉX.",2,2,4,0,0,5649,
18/12/2019,S.L.P.,"SAN LUIS POTOSI, S.L.P.",1,2,3,12,0,0,
18/12/2019,S.L.P.,"SOLEDAD DE GRACIANO SANCHEZ, S.L.P.",3,0,3,2,0,0,
18/12/2019,B.C.,"ENSENADA, B.C.",1,0,1,0,0,0,
19/12/2019,S.L.P.,"CIUDAD VALLES, S.L.P.",2,1,3,0,0,0,
19/12/2019,JAL.,"GUADALAJARA, JAL.",1,0,1,0,0,0,
20/12/2019,JAL.,"GUADALAJARA, JAL.",1,3,4,0,0,6,
20/12/2019,S.L.P.,"SOLEDAD DE GRACIANO SANCHEZ, S.L.P.",2,0,2,0,0,0,
21/12/2019,S.L.P.,"SAN LUIS POTOSI, S.L.P.",2,0,2,0,0,0,
22/12/2019,S.L.P.,"CIUDAD VALLES, S.L.P.",1,0,1,0,0,0,
24/12/2019,S.L.P.,"SOLEDAD DE GRACIANO SANCHEZ, S.L.P.",1,0,1,0,2,0,
24/12/2019,S.L.P.,"CIUDAD VALLES, S.L.P.",0,1,1,2,0,0,
24/12/2019,S.L.P.,"SAN LUIS POTOSI, S.L.P.",0,0,0,15,7,0,
25/12/2019,S.L.P.,"CIUDAD VALLES, S.L.P.",1,0,1,1,1,0,
26/12/2019,S.L.P.,"CIUDAD VALLES, S.L.P.",0,1,1,0,0,0,
15/01/2020,SON.,"HERMOSILLO, SON.",1,0,1,0,0,0,
16/01/2020,B.C.,"TIJUANA, B.C.",1,0,1,0,0,0,
16/01/2020,CHIS.,"TONALÁ, CHIS.",0,0,0,0,0,34,
16/01/2020,CHIS.,"TAPACHULA, CHIS.",0,0,0,0,0,100,
16/01/2020,TAB.,"CENTRO, TAB.",0,0,0,0,0,60,
17/01/2020,CHIS.,"TAPACHULA, CHIS.",0,0,0,0,0,100,
17/01/2020,ZAC.,"ZAC., ZAC.",0,0,0,1,0,18,
18/01/2020,CHIS.,"TAPACHULA, CHIS.",0,1,1,0,0,351,
18/01/2020,B.C.,"TIJUANA, B.C.",1,0,1,0,0,0,
19/01/2020,CHIS.,"TAPACHULA, CHIS.",2,0,2,0,0,47,
20/01/2020,CHIS.,"TAPACHULA, CHIS.",2,0,2,3,0,57,
20/01/2020,ZAC.,"GUADALUPE, ZAC.",0,0,0,3,0,0,
20/01/2020,ZAC.,"FRESNILLO, ZAC.",0,0,0,2,0,1,
21/01/2020,CHIS.,"COPAINALÁ, CHIS.",1,2,3,0,0,0,
21/01/2020,ZAC.,"GUADALUPE, ZAC.",1,1,2,3,0,530,
21/01/2020,CHIS.,"TAPACHULA, CHIS.",0,0,0,0,1,60,
22/01/2020,CHIS.,"COPAINALÁ, CHIS.",0,1,1,0,1,23,
22/01/2020,ZAC.,"GUADALUPE, ZAC.",1,0,1,10,0,358,
23/01/2020,CD. MÉX.,"GUSTAVO A. MADERO, CD. MÉX.",13,1,14,0,0,778,
23/01/2020,CHIS.,"TAPACHULA, CHIS.",1,0,1,0,0,119,
23/01/2020,ZAC.,"GUADALUPE, ZAC.",1,0,1,1,0,0,
23/01/2020,ZAC.,"FRESNILLO, ZAC.",1,0,1,2,0,168,
23/01/2020,ZAC.,"ZAC., ZAC.",0,0,0,0,2,0,
24/01/2020,CD. MÉX.,"GUSTAVO A. MADERO, CD. MÉX.",17,2,19,0,3,433,
24/01/2020,CD. MÉX.,"MILPA ALTA, CD. MÉX.",2,0,2,0,0,0,
24/01/2020,ZAC.,"GUADALUPE, ZAC.",1,0,1,2,0,250,
24/01/2020,ZAC.,"FRESNILLO, ZAC.",1,0,1,0,0,12,
27/01/2020,CD. MÉX.,"GUSTAVO A. MADERO, CD. MÉX.",19,4,23,0,2,878,
27/01/2020,CD. MÉX.,"MILPA ALTA, CD. MÉX.",1,2,3,0,0,32,
27/01/2020,CD. MÉX.,"IZTAPALAPA, CD. MÉX.",2,1,3,0,0,174,
27/01/2020,ZAC.,"FRESNILLO, ZAC.",1,0,1,0,0,0,
27/01/2020,ZAC.,"GUADALUPE, ZAC.",0,0,0,10,0,700,
28/01/2020,CD. MÉX.,"GUSTAVO A. MADERO, CD. MÉX.",13,0,13,0,0,515,
28/01/2020,CD. MÉX.,"IZTAPALAPA, CD. MÉX.",5,1,6,0,0,342,
28/01/2020,ZAC.,"GUADALUPE, ZAC.",1,0,1,6,0,0,
28/01/2020,ZAC.,"ZAC., ZAC.",1,0,1,0,0,0,
28/01/2020,VER.,"MINATITLAN, VER.",1,0,1,0,0,0,
28/01/2020,CD. MÉX.,"MILPA ALTA, CD. MÉX.",0,0,0,0,0,32,
28/01/2020,TAB.,"CARDENAS, TAB.",0,0,0,0,0,133,
29/01/2020,CD. MÉX.,"GUSTAVO A. MADERO, CD. MÉX.",7,3,10,0,0,1123,
29/01/2020,CD. MÉX.,"IZTAPALAPA, CD. MÉX.",4,1,5,0,0,55,
29/01/2020,CHIS.,"COMITAN DE DOMÍNGUEZ, CHIS.",2,3,5,2,2,420,
29/01/2020,VER.,"MINATITLAN, VER.",3,0,3,2,0,24,
29/01/2020,CD. MÉX.,"MILPA ALTA, CD. MÉX.",1,0,1,0,0,50,
29/01/2020,ZAC.,"GUADALUPE, ZAC.",0,1,1,1,0,6,
29/01/2020,ZAC.,"ZAC., ZAC.",1,0,1,0,0,0,
30/01/2020,CD. MÉX.,"GUSTAVO A. MADERO, CD. MÉX.",7,2,9,0,0,2007,
30/01/2020,CD. MÉX.,"IZTAPALAPA, CD. MÉX.",5,0,5,0,0,340,
30/01/2020,VER.,"MINATITLAN, VER.",2,2,4,0,0,0,
30/01/2020,CHIS.,"TAPACHULA, CHIS.",1,2,3,3,0,0,
30/01/2020,CD. MÉX.,"MILPA ALTA, CD. MÉX.",0,2,2,0,0,0,
30/01/2020,ZAC.,"GUADALUPE, ZAC.",0,0,0,15,0,450,
31/01/2020,CD. MÉX.,"GUSTAVO A. MADERO, CD. MÉX.",11,2,13,0,1,534,
31/01/2020,VER.,"MINATITLAN, VER.",3,0,3,2,0,12,
31/01/2020,CD. MÉX.,"MILPA ALTA, CD. MÉX.",2,1,3,0,0,5,
31/01/2020,COAH.,"SABINAS, COAH.",2,0,2,0,0,0,
31/01/2020,ZAC.,"GUADALUPE, ZAC.",0,1,1,0,0,167,
31/01/2020,CD. MÉX.,"IZTAPALAPA, CD. MÉX.",1,0,1,0,0,0,
04/02/2020,CD. MÉX.,"GUSTAVO A. MADERO, CD. MÉX.",13,1,14,0,0,3426,
04/02/2020,CD. MÉX.,"IZTAPALAPA, CD. MÉX.",6,1,7,0,0,919,
04/02/2020,ZAC.,"GUADALUPE, ZAC.",1,0,1,16,0,0,
04/02/2020,ZAC.,"FRESNILLO, ZAC.",1,0,1,0,0,0,
04/02/2020,CD. MÉX.,"MILPA ALTA, CD. MÉX.",0,1,1,0,0,0,
04/02/2020,ZAC.,"GUADALUPE, ZAC.",0,1,1,0,0,0,
04/02/2020,ZAC.,"FRESNILLO, ZAC.",1,0,1,0,0,0,
04/02/2020,ZAC.,"ZAC., ZAC.",0,0,0,5,0,0,
04/02/2020,COAH.,"SABINAS, COAH.",0,0,0,40,0,0,
05/02/2020,CD. MÉX.,"IZTAPALAPA, CD. MÉX.",4,1,5,0,1,733,
05/02/2020,CD. MÉX.,"MILPA ALTA, CD. MÉX.",2,0,2,0,4,114,
05/02/2020,COAH.,"MÚZQUIZ, COAH.",2,0,2,0,0,0,
05/02/2020,CD. MÉX.,"GUSTAVO A. MADERO, CD. MÉX.",1,0,1,0,0,14,
05/02/2020,ZAC.,"ZAC., ZAC.",1,0,1,0,0,0,
05/02/2020,ZAC.,"GUADALUPE, ZAC.",0,0,0,4,0,150,
05/02/2020,ZAC.,"GUADALUPE, ZAC.",0,0,0,3,0,13,
05/02/2020,ZAC.,"FRESNILLO, ZAC.",0,0,0,13,0,2,
06/02/2020,CD. MÉX.,"IZTAPALAPA, CD. MÉX.",7,1,8,0,0,52,
06/02/2020,CD. MÉX.,"MILPA ALTA, CD. MÉX.",1,3,4,0,3,144,
06/02/2020,CD. MÉX.,"GUSTAVO A. MADERO, CD. MÉX.",2,0,2,0,0,637,
06/02/2020,ZAC.,"ZAC., ZAC.",1,0,1,9,0,62,
06/02/2020,COAH.,"MÚZQUIZ, COAH.",1,0,1,0,0,0,
06/02/2020,ZAC.,"GUADALUPE, ZAC.",0,0,0,2,0,100,
07/02/2020,CD. MÉX.,"IZTAPALAPA, CD. MÉX.",10,3,13,0,1,189,
07/02/2020,COAH.,"SABINAS, COAH.",1,3,4,0,0,0,
07/02/2020,CD. MÉX.,"CUAUHTEMOC, CD. MÉX.",1,2,3,0,0,7,
07/02/2020,ZAC.,"ZAC., ZAC.",1,1,2,5,0,34,
07/02/2020,CD. MÉX.,"GUSTAVO A. MADERO, CD. MÉX.",2,0,2,0,0,234,
07/02/2020,ZAC.,"GUADALUPE, ZAC.",1,0,1,1,0,640,
07/02/2020,ZAC.,"FRESNILLO, ZAC.",1,0,1,0,0,0,
09/02/2020,CHIH.,"ALDAMA, CHIH.",2,0,2,0,0,60,
10/02/2020,CD. MÉX.,"GUSTAVO A. MADERO, CD. MÉX.",3,1,4,0,0,651,
10/02/2020,CD. MÉX.,"IZTAPALAPA, CD. MÉX.",2,0,2,0,0,129,
11/02/2020,CD. MÉX.,"GUSTAVO A. MADERO, CD. MÉX.",7,0,7,0,0,290,
11/02/2020,SIN.,"SALVADOR ALVARADO, SIN.",4,0,4,0,2,0,
11/02/2020,SON.,"HERMOSILLO, SON.",1,1,2,0,0,0,
11/02/2020,CD. MÉX.,"CUAUHTEMOC, CD. MÉX.",0,1,1,0,0,80,
11/02/2020,CD. MÉX.,"IZTAPALAPA, CD. MÉX.",1,0,1,0,0,35,
12/02/2020,COAH.,"SALTILLO, COAH.",9,7,16,11,0,323,
12/02/2020,CD. MÉX.,"IZTAPALAPA, CD. MÉX.",3,5,8,0,0,76,
12/02/2020,CD. MÉX.,"TLALPAN, CD. MÉX.",3,1,4,0,0,161,
12/02/2020,CD. MÉX.,"CUAUHTEMOC, CD. MÉX.",4,0,4,0,0,0,
12/02/2020,SIN.,"SALVADOR ALVARADO, SIN.",2,2,4,0,4,0,
12/02/2020,SIN.,"CULIACAN, SIN.",2,1,3,0,1,1,
12/02/2020,SIN.,"NAVOLATO, SIN.",3,0,3,0,0,0,
12/02/2020,SIN.,"GUASAVE, SIN.",1,0,1,0,0,0,
13/02/2020,CD. MÉX.,"IZTAPALAPA, CD. MÉX.",8,1,9,0,0,0,
13/02/2020,SIN.,"NAVOLATO, SIN.",3,0,3,0,0,0,
13/02/2020,CD. MÉX.,"CUAUHTEMOC, CD. MÉX.",1,2,3,0,0,0,
13/02/2020,SIN.,"CULIACAN, SIN.",1,0,1,0,0,0,
13/02/2020,SIN.,"SALVADOR ALVARADO, SIN.",1,0,1,0,0,0,
13/02/2020,SON.,"CAJEME, SON.",1,0,1,0,0,0,
13/02/2020,CD. MÉX.,"TLALPAN, CD. MÉX.",0,0,0,0,0,49,
14/02/2020,CD. MÉX.,"IZTAPALAPA, CD. MÉX.",6,4,10,0,0,205,
14/02/2020,CD. MÉX.,"CUAUHTEMOC, CD. MÉX.",5,0,5,0,0,223,
14/02/2020,SIN.,"SALVADOR ALVARADO, SIN.",2,2,4,0,3,0,
14/02/2020,SIN.,"GUASAVE, SIN.",3,0,3,0,0,0,
14/02/2020,CD. MÉX.,"TLALPAN, CD. MÉX.",2,1,3,0,1,0,
14/02/2020,SIN.,"CULIACAN, SIN.",2,0,2,0,0,0,
14/02/2020,SON.,"HERMOSILLO, SON.",1,0,1,0,0,68,
16/02/2020,CHIH.,"ALDAMA, CHIH.",1,0,1,0,0,0,
17/02/2020,SIN.,"GUASAVE, SIN.",2,5,7,0,0,0,
17/02/2020,CD. MÉX.,"CUAUHTEMOC, CD. MÉX.",2,4,6,0,0,97,
17/02/2020,SIN.,"CULIACAN, SIN.",3,0,3,0,0,0,
17/02/2020,SIN.,"NAVOLATO, SIN.",3,0,3,0,0,0,
17/02/2020,CD. MÉX.,"TLALPAN, CD. MÉX.",0,1,1,0,0,0,
17/02/2020,CD. MÉX.,"IZTAPALAPA, CD. MÉX.",1,0,1,0,0,0,
17/02/2020,SIN.,"MOCORITO, SIN.",1,0,1,0,0,0,
17/02/2020,SIN.,"ELOTA, SIN.",1,0,1,0,0,0,
17/02/2020,NAY.,"TEPIC, NAY.",1,0,1,1,0,0,
18/02/2020,CD. MÉX.,"CUAUHTEMOC, CD. MÉX.",4,1,5,0,0,628,
18/02/2020,CD. MÉX.,"TLALPAN, CD. MÉX.",1,0,1,0,0,201,
18/02/2020,SIN.,"CULIACAN, SIN.",1,0,1,0,0,0,
18/02/2020,NAY.,"TEPIC, NAY.",1,0,1,0,89,396,
18/02/2020,ZAC.,"GUADALUPE, ZAC.",0,0,0,3,0,400,
19/02/2020,SIN.,"SIN., SIN.",9,7,16,0,0,0,
19/02/2020,SIN.,"GUASAVE, SIN.",3,10,13,0,0,0,
19/02/2020,ZAC.,"ZAC., ZAC.",6,0,6,0,0,0,
19/02/2020,CD. MÉX.,"CUAUHTEMOC, CD. MÉX.",3,0,3,0,0,33,
19/02/2020,SIN.,"CULIACAN, SIN.",1,2,3,0,0,0,
19/02/2020,SIN.,"NAVOLATO, SIN.",2,0,2,0,0,0,
19/02/2020,SIN.,"MOCORITO, SIN.",0,2,2,0,0,0,
19/02/2020,TAB.,"MACUSPANA, TAB.",1,0,1,0,0,0,
19/02/2020,NAY.,"TEPIC, NAY.",1,0,1,0,0,0,
19/02/2020,CD. MÉX.,"TLALPAN, CD. MÉX.",0,0,0,0,0,261,
20/02/2020,CD. MÉX.,"TLALPAN, CD. MÉX.",7,0,7,0,0,6,
20/02/2020,CD. MÉX.,"IZTAPALAPA, CD. MÉX.",1,2,3,0,0,2383,
20/02/2020,SIN.,"ELOTA, SIN.",0,3,3,0,0,0,
20/02/2020,NAY.,"TEPIC, NAY.",3,0,3,1,0,84,
20/02/2020,ZAC.,"RIO GRANDE, ZAC.",3,0,3,3,0,0,
20/02/2020,COAH.,"PIEDRAS NEGRAS, COAH.",0,2,2,0,0,62,
20/02/2020,SIN.,"MOCORITO, SIN.",0,2,2,0,3,0,
20/02/2020,ZAC.,"ZAC., ZAC.",2,0,2,0,0,0,
20/02/2020,ZAC.,"JALPA, ZAC.",2,0,2,0,0,0,
20/02/2020,CD. MÉX.,"CUAUHTEMOC, CD. MÉX.",1,0,1,0,0,100,
20/02/2020,SON.,"HERMOSILLO, SON.",1,0,1,0,0,0,
20/02/2020,SON.,"CAJEME, SON.",1,0,1,1,0,0,
20/02/2020,COAH.,"FRANCISCO I. MADERO, COAH.",0,1,1,1,0,0,
20/02/2020,SIN.,"CULIACAN, SIN.",1,0,1,0,0,0,
20/02/2020,ZAC.,"GUADALUPE, ZAC.",1,0,1,0,0,0,
20/02/2020,ZAC.,"JEREZ, ZAC.",1,0,1,0,0,3,
20/02/2020,TAB.,"MACUSPANA, TAB.",0,0,0,0,0,20,
21/02/2020,SIN.,"SIN., SIN.",12,12,24,0,3,0,
21/02/2020,CD. MÉX.,"IZTAPALAPA, CD. MÉX.",1,5,6,0,0,225,
21/02/2020,SIN.,"GUASAVE, SIN.",4,1,5,0,0,0,
21/02/2020,CD. MÉX.,"TLALPAN, CD. MÉX.",2,1,3,0,0,39,
21/02/2020,COAH.,"PIEDRAS NEGRAS, COAH.",1,2,3,0,0,0,
21/02/2020,CD. MÉX.,"XOCHIMILCO, CD. MÉX.",2,0,2,0,1,0,
21/02/2020,SIN.,"MOCORITO, SIN.",1,1,2,0,3,0,
21/02/2020,SIN.,"CULIACAN, SIN.",0,1,1,0,1,0,
21/02/2020,SIN.,"NAVOLATO, SIN.",0,1,1,0,0,0,
21/02/2020,SIN.,"ELOTA, SIN.",0,1,1,0,0,0,
21/02/2020,ZAC.,"ZAC., ZAC.",0,0,0,7,0,88,
21/02/2020,NAY.,"TEPIC, NAY.",0,0,0,0,174,0,
22/02/2020,COAH.,"FRANCISCO I. MADERO, COAH.",1,2,3,0,0,0,
22/02/2020,COAH.,"PIEDRAS NEGRAS, COAH.",1,0,1,3,0,126,
24/02/2020,CD. MÉX.,"TLALPAN, CD. MÉX.",8,0,8,0,0,151,
24/02/2020,COAH.,"PIEDRAS NEGRAS, COAH.",2,0,2,1,1,163,
24/02/2020,TAB.,"MACUSPANA, TAB.",0,1,1,0,0,0,
24/02/2020,COAH.,"SALTILLO, COAH.",1,0,1,1,1,610,
24/02/2020,SIN.,"BADIRAGUATO, SIN.",1,0,1,0,0,0,
24/02/2020,ZAC.,"FRESNILLO, ZAC.",0,1,1,1,0,134,
24/02/2020,CD. MÉX.,"XOCHIMILCO, CD. MÉX.",1,0,1,0,0,754,
24/02/2020,CD. MÉX.,"IZTAPALAPA, CD. MÉX.",1,0,1,0,0,23,
24/02/2020,ZAC.,"GUADALUPE, ZAC.",0,0,0,1,0,103,
25/02/2020,NAY.,"TEPIC, NAY.",9,0,9,7,10,435,
25/02/2020,CD. MÉX.,"IZTAPALAPA, CD. MÉX.",2,3,5,0,0,50,
25/02/2020,CD. MÉX.,"XOCHIMILCO, CD. MÉX.",2,2,4,0,1,146,
25/02/2020,COAH.,"PIEDRAS NEGRAS, COAH.",1,2,3,0,0,83,
25/02/2020,COAH.,"SALTILLO, COAH.",0,2,2,1,1,0,
25/02/2020,COAH.,"RAMOS ARIZPE, COAH.",2,0,2,0,0,72,
25/02/2020,COAH.,"MONCLOVA, COAH.",2,0,2,0,0,0,
25/02/2020,ZAC.,"FRESNILLO, ZAC.",2,0,2,2,0,0,
25/02/2020,CD. MÉX.,"TLALPAN, CD. MÉX.",1,0,1,0,1,0,
25/02/2020,ZAC.,"GUADALUPE, ZAC.",1,0,1,0,0,0,
25/02/2020,ZAC.,"ZAC., ZAC.",1,0,1,0,1,69,
25/02/2020,COAH.,"MÚZQUIZ, COAH.",0,0,0,7,0,0,
25/02/2020,CHIS.,"SAN CRISTOBAL DE LAS CASAS, CHIS.",0,0,0,3,0,225,
26/02/2020,SIN.,"CHOIX, SIN.",3,3,6,0,0,0,
26/02/2020,NAY.,"TEPIC, NAY.",6,0,6,3,0,75,
26/02/2020,CD. MÉX.,"IZTAPALAPA, CD. MÉX.",1,2,3,0,12,0,
26/02/2020,COAH.,"SALTILLO, COAH.",3,0,3,0,0,225,
26/02/2020,ZAC.,"GUADALUPE, ZAC.",1,0,1,1,0,15,
26/02/2020,CHIS.,"SAN CRISTOBAL DE LAS CASAS, CHIS.",1,0,1,0,0,1277,
26/02/2020,CD. MÉX.,"XOCHIMILCO, CD. MÉX.",1,0,1,0,0,277,
26/02/2020,SON.,"CAJEME, SON.",1,0,1,0,0,0,
26/02/2020,COAH.,"TORREÓN, COAH.",0,1,1,2,0,338,
26/02/2020,COAH.,"PIEDRAS NEGRAS, COAH.",0,1,1,0,0,24,
26/02/2020,ZAC.,"FRESNILLO, ZAC.",0,0,0,1,0,0,
26/02/2020,SIN.,"BADIRAGUATO, SIN.",0,0,0,0,12,0,
27/02/2020,NAY.,"TEPIC, NAY.",4,3,7,7,0,58,
27/02/2020,COAH.,"SALTILLO, COAH.",2,3,5,1,0,30,
27/02/2020,CD. MÉX.,"BENITO JUAREZ, CD. MÉX.",4,0,4,0,1,0,
27/02/2020,COAH.,"MONCLOVA, COAH.",2,2,4,0,2,43,
27/02/2020,CD. MÉX.,"IZTAPALAPA, CD. MÉX.",1,1,2,0,0,21,
27/02/2020,COAH.,"SAN PEDRO, COAH.",0,2,2,0,0,0,
27/02/2020,COAH.,"SAN PEDRO, COAH.",0,2,2,0,0,0,
27/02/2020,SON.,"CAJEME, SON.",0,1,1,0,0,0,
27/02/2020,ZAC.,"GUADALUPE, ZAC.",1,0,1,0,0,0,
27/02/2020,ZAC.,"ZAC., ZAC.",0,1,1,0,0,0,
27/02/2020,SIN.,"CHOIX, SIN.",0,1,1,0,0,0,
27/02/2020,COAH.,"FRANCISCO I. MADERO, COAH.",0,1,1,0,0,0,
27/02/2020,COAH.,"PIEDRAS NEGRAS, COAH.",0,1,1,0,0,17,
27/02/2020,COAH.,"MÚZQUIZ, COAH.",1,0,1,8,0,0,
27/02/2020,ZAC.,"FRESNILLO, ZAC.",0,0,0,1,0,0,
27/02/2020,CD. MÉX.,"XOCHIMILCO, CD. MÉX.",0,0,0,0,0,396,
28/02/2020,CD. MÉX.,"IZTAPALAPA, CD. MÉX.",7,3,10,0,0,0,
28/02/2020,SIN.,"CHOIX, SIN.",3,3,6,0,0,0,
28/02/2020,VER.,"POZA RICA DE HGO., VER.",2,2,4,1,0,204,
28/02/2020,COAH.,"TORREÓN, COAH.",2,2,4,0,0,0,
28/02/2020,COAH.,"SALTILLO, COAH.",3,1,4,0,0,439,
28/02/2020,CHIS.,"SAN CRISTOBAL DE LAS CASAS, CHIS.",2,1,3,0,0,646,
28/02/2020,COAH.,"RAMOS ARIZPE, COAH.",1,1,2,0,0,0,
28/02/2020,SIN.,"BADIRAGUATO, SIN.",0,1,1,0,4,0,
28/02/2020,ZAC.,"FRESNILLO, ZAC.",0,1,1,0,0,2,
28/02/2020,CD. MÉX.,"XOCHIMILCO, CD. MÉX.",1,0,1,0,0,0,
28/02/2020,CD. MÉX.,"BENITO JUAREZ, CD. MÉX.",0,1,1,0,0,9,
28/02/2020,COAH.,"MÚZQUIZ, COAH.",1,0,1,4,1,170,
28/02/2020,COAH.,"ACUÑA, COAH.",1,0,1,0,1,109,
28/02/2020,ZAC.,"ZAC., ZAC.",0,0,0,0,0,44,
28/02/2020,COAH.,"FRANCISCO I. MADERO, COAH.",0,0,0,0,1,0,
29/02/2020,NAY.,"TEPIC, NAY.",3,4,7,2,234,315,
29/02/2020,CHIS.,"SAN CRISTOBAL DE LAS CASAS, CHIS.",0,0,0,0,0,981,
29/02/2020,SIN.,"CULIACAN, SIN.",0,0,0,0,0,1,
02/03/2020,CHIH.,"CHIH., CHIH.",6,0,6,0,0,0,
02/03/2020,CD. MÉX.,"IZTAPALAPA, CD. MÉX.",3,0,3,0,0,0,
02/03/2020,SON.,"HERMOSILLO, SON.",2,0,2,0,0,0,
02/03/2020,NAY.,"TEPIC, NAY.",0,1,1,0,0,0,
02/03/2020,CD. MÉX.,"XOCHIMILCO, CD. MÉX.",0,0,0,0,0,250,
03/03/2020,CHIH.,"CHIH., CHIH.",14,7,21,0,2,432,
03/03/2020,CD. MÉX.,"BENITO JUAREZ, CD. MÉX.",5,2,7,0,0,91,
03/03/2020,CD. MÉX.,"XOCHIMILCO, CD. MÉX.",2,2,4,0,0,0,
03/03/2020,COAH.,"SALTILLO, COAH.",2,0,2,0,0,85,
03/03/2020,CD. MÉX.,"IZTAPALAPA, CD. MÉX.",2,0,2,0,0,115,
03/03/2020,NAY.,"XALISCO, NAY.",1,1,2,0,0,0,
03/03/2020,COAH.,"TORREÓN, COAH.",2,0,2,0,0,114,
03/03/2020,COAH.,"FRANCISCO I. MADERO, COAH.",0,2,2,1,0,16,
03/03/2020,SIN.,"ANGOSTURA, SIN.",1,0,1,0,0,0,
03/03/2020,COAH.,"MATAMOROS, COAH.",0,0,0,4,0,0,
03/03/2020,COAH.,"PIEDRAS NEGRAS, COAH.",0,0,0,0,0,50,
03/03/2020,COAH.,"MÚZQUIZ, COAH.",0,0,0,16,0,0,
04/03/2020,CD. MÉX.,"BENITO JUAREZ, CD. MÉX.",5,2,7,0,0,172,
04/03/2020,CD. MÉX.,"IZTAPALAPA, CD. MÉX.",2,4,6,0,0,516,
04/03/2020,COAH.,"TORREÓN, COAH.",4,0,4,0,0,0,
04/03/2020,CD. MÉX.,"XOCHIMILCO, CD. MÉX.",2,2,4,0,0,97,
04/03/2020,CHIH.,"CHIH., CHIH.",3,0,3,0,0,95,
04/03/2020,NAY.,"XALISCO, NAY.",1,0,1,0,20,0,
04/03/2020,COAH.,"PIEDRAS NEGRAS, COAH.",0,0,0,1,0,0,
05/03/2020,CHIH.,"CHIH., CHIH.",18,1,19,0,0,151,
05/03/2020,CD. MÉX.,"BENITO JUAREZ, CD. MÉX.",5,1,6,0,1,187,
05/03/2020,CD. MÉX.,"IZTAPALAPA, CD. MÉX.",3,3,6,0,0,0,
05/03/2020,COAH.,"SALTILLO, COAH.",4,0,4,0,0,0,
05/03/2020,SIN.,"SAN IGNACIO, SIN.",1,2,3,0,0,0,
05/03/2020,COAH.,"TORREÓN, COAH.",1,1,2,0,0,0,
05/03/2020,SIN.,"ANGOSTURA, SIN.",1,0,1,0,3,0,
05/03/2020,CD. MÉX.,"XOCHIMILCO, CD. MÉX.",1,0,1,0,0,300,
05/03/2020,COAH.,"PIEDRAS NEGRAS, COAH.",0,1,1,0,0,0,
05/03/2020,COAH.,"MÚZQUIZ, COAH.",0,1,1,3,0,31,
06/03/2020,CHIH.,"CHIH., CHIH.",10,2,12,1,0,176,
06/03/2020,VER.,"XALAPA, VER.",7,0,7,4,0,50,
06/03/2020,CD. MÉX.,"IZTAPALAPA, CD. MÉX.",3,3,6,0,0,40,
06/03/2020,VER.,"VER., VER.",4,0,4,5,1,12,
06/03/2020,SIN.,"SAN IGNACIO, SIN.",2,2,4,0,0,0,
06/03/2020,SIN.,"ANGOSTURA, SIN.",1,2,3,0,0,0,
06/03/2020,VER.,"COATZACOALCOS, VER.",1,1,2,0,0,0,
06/03/2020,CD. MÉX.,"BENITO JUAREZ, CD. MÉX.",2,0,2,0,0,137,
06/03/2020,ZAC.,"ZAC., ZAC.",0,0,0,0,0,9,
07/03/2020,VER.,"XALAPA, VER.",8,1,9,13,0,1103,
07/03/2020,VER.,"COATZACOALCOS, VER.",3,0,3,0,0,84,
07/03/2020,VER.,"VER., VER.",2,1,3,62,1,1899,
08/03/2020,VER.,"VER., VER.",3,1,4,6,1,439,
08/03/2020,VER.,"XALAPA, VER.",2,0,2,18,0,49,
08/03/2020,VER.,"COATZACOALCOS, VER.",0,0,0,4,0,34,
09/03/2020,CD. MÉX.,"BENITO JUAREZ, CD. MÉX.",10,1,11,0,0,537,
09/03/2020,VER.,"COATZACOALCOS, VER.",5,0,5,3,0,165,
09/03/2020,CD. MÉX.,"CUAJIMALPA DE MOR., CD. MÉX.",2,0,2,0,0,0,
09/03/2020,CD. MÉX.,"IZTAPALAPA, CD. MÉX.",2,0,2,0,0,186,
09/03/2020,VER.,"XALAPA, VER.",2,0,2,39,0,43,
09/03/2020,VER.,"VER., VER.",2,0,2,40,0,544,
09/03/2020,NAY.,"XALISCO, NAY.",2,0,2,0,0,0,
10/03/2020,CHIH.,"JUÁREZ, CHIH.",12,1,13,25,0,324,
10/03/2020,VER.,"VER., VER.",9,0,9,49,0,386,
10/03/2020,CD. MÉX.,"BENITO JUAREZ, CD. MÉX.",4,0,4,0,0,96,
10/03/2020,CD. MÉX.,"IZTAPALAPA, CD. MÉX.",3,1,4,0,0,986,
10/03/2020,VER.,"XALAPA, VER.",1,2,3,16,0,519,
10/03/2020,ZAC.,"ZAC., ZAC.",1,1,2,0,0,30,
10/03/2020,COAH.,"MONCLOVA, COAH.",1,1,2,0,0,0,
10/03/2020,CD. MÉX.,"CUAJIMALPA DE MOR., CD. MÉX.",1,0,1,0,0,0,
10/03/2020,VER.,"COATZACOALCOS, VER.",1,0,1,0,0,53,
10/03/2020,SIN.,"AHOME, SIN.",0,1,1,0,0,0,
10/03/2020,COAH.,"TORREÓN, COAH.",1,0,1,0,0,0,
10/03/2020,COAH.,"SALTILLO, COAH.",1,0,1,0,0,165,
10/03/2020,CHIH.,"CASAS GRANDES, CHIH.",0,0,0,0,0,49,
11/03/2020,CHIH.,"JUÁREZ, CHIH.",20,13,33,14,0,524,
11/03/2020,SIN.,"AHOME, SIN.",4,10,14,0,2,0,
11/03/2020,VER.,"XALAPA, VER.",5,2,7,55,0,37,
11/03/2020,VER.,"VER., VER.",4,0,4,3,0,899,
11/03/2020,COAH.,"FRANCISCO I. MADERO, COAH.",2,1,3,0,0,0,
11/03/2020,CD. MÉX.,"IZTAPALAPA, CD. MÉX.",2,0,2,0,0,0,
11/03/2020,ZAC.,"ZAC., ZAC.",1,0,1,1,0,172,
11/03/2020,S.L.P.,"CIUDAD VALLES, S.L.P.",0,1,1,0,0,0,
11/03/2020,S.L.P.,"SAN LUIS POTOSI, S.L.P.",1,0,1,0,0,0,
11/03/2020,COAH.,"MÚZQUIZ, COAH.",0,1,1,0,0,0,
11/03/2020,NAY.,"XALISCO, NAY.",0,1,1,0,0,0,
11/03/2020,NAY.,"HUAJICORI, NAY.",1,0,1,0,0,0,
11/03/2020,SIN.,"CULIACAN, SIN.",0,0,0,0,1,0,
11/03/2020,CD. MÉX.,"MIGUEL HGO., CD. MÉX.",0,0,0,0,0,6,
12/03/2020,CHIH.,"JUÁREZ, CHIH.",10,7,17,72,0,1248,
12/03/2020,CD. MÉX.,"IZTAPALAPA, CD. MÉX.",3,3,6,0,0,86,
12/03/2020,VER.,"COATZACOALCOS, VER.",3,1,4,3,0,45,
12/03/2020,COAH.,"TORREÓN, COAH.",1,2,3,0,0,0,
12/03/2020,NAY.,"XALISCO, NAY.",3,0,3,0,4,0,
12/03/2020,CHIH.,"NUEVO CASAS GRANDES, CHIH.",3,0,3,5,2,907,
12/03/2020,COAH.,"RAMOS ARIZPE, COAH.",2,0,2,0,0,0,
12/03/2020,COAH.,"MONCLOVA, COAH.",0,2,2,0,0,0,
12/03/2020,S.L.P.,"SAN LUIS POTOSI, S.L.P.",2,0,2,5,0,0,
12/03/2020,CD. MÉX.,"CUAJIMALPA DE MOR., CD. MÉX.",2,0,2,0,0,0,
12/03/2020,CD. MÉX.,"MIGUEL HGO., CD. MÉX.",2,0,2,0,0,135,
12/03/2020,COAH.,"SALTILLO, COAH.",1,0,1,7,0,77,
12/03/2020,COAH.,"MÚZQUIZ, COAH.",1,0,1,0,0,0,
12/03/2020,COAH.,"PIEDRAS NEGRAS, COAH.",0,0,0,0,0,159,
13/03/2020,CHIH.,"JUÁREZ, CHIH.",7,4,11,7,1,837,
13/03/2020,SIN.,"AHOME, SIN.",8,2,10,0,5,0,
13/03/2020,VER.,"VER., VER.",9,0,9,9,0,1127,
13/03/2020,CD. MÉX.,"CUAJIMALPA DE MOR., CD. MÉX.",3,1,4,0,0,0,
13/03/2020,CD. MÉX.,"MIGUEL HGO., CD. MÉX.",2,1,3,0,0,0,
13/03/2020,CD. MÉX.,"IZTAPALAPA, CD. MÉX.",0,3,3,0,0,4830,
13/03/2020,S.L.P.,"CIUDAD VALLES, S.L.P.",1,0,1,2,0,0,
13/03/2020,S.L.P.,"SAN LUIS POTOSI, S.L.P.",1,0,1,0,0,0,
13/03/2020,S.L.P.,"SOLEDAD DE GRACIANO SANCHEZ, S.L.P.",0,1,1,0,0,0,
13/03/2020,S.L.P.,"MATEHUALA, S.L.P.",1,0,1,0,0,0,
13/03/2020,VER.,"COATZACOALCOS, VER.",1,0,1,2,0,677,
13/03/2020,NAY.,"XALISCO, NAY.",0,1,1,0,0,0,
13/03/2020,VER.,"XALAPA, VER.",0,0,0,0,0,184,
14/03/2020,COAH.,"PIEDRAS NEGRAS, COAH.",1,1,2,0,0,0,
14/03/2020,VER.,"XALAPA, VER.",2,0,2,19,0,535,
14/03/2020,COAH.,"PIEDRAS NEGRAS, COAH.",1,1,2,0,0,0,
14/03/2020,S.L.P.,"MATEHUALA, S.L.P.",1,0,1,0,0,0,
14/03/2020,VER.,"VER., VER.",1,0,1,0,0,2289,
15/03/2020,S.L.P.,"SOLEDAD DE GRACIANO SANCHEZ, S.L.P.",0,2,2,0,0,0,
15/03/2020,S.L.P.,"SAN LUIS POTOSI, S.L.P.",1,0,1,25,0,0,
15/03/2020,VER.,"XALAPA, VER.",0,0,0,26,0,187,
15/03/2020,VER.,"VER., VER.",0,0,0,0,0,397,
16/03/2020,COAH.,"TORREÓN, COAH.",2,2,4,0,0,0,
16/03/2020,VER.,"VER., VER.",2,0,2,2,0,343,
16/03/2020,VER.,"XALAPA, VER.",0,1,1,49,0,1193,
16/03/2020,S.L.P.,"CIUDAD VALLES, S.L.P.",1,0,1,0,0,0,
16/03/2020,S.L.P.,"MATEHUALA, S.L.P.",0,1,1,0,0,0,
16/03/2020,VER.,"COATZACOALCOS, VER.",0,0,0,2,0,301,
17/03/2020,CHIH.,"JUÁREZ, CHIH.",7,1,8,13,0,306,
17/03/2020,COAH.,"TORREÓN, COAH.",0,3,3,0,0,0,
17/03/2020,COAH.,"SALTILLO, COAH.",3,0,3,0,0,54,
17/03/2020,VER.,"XALAPA, VER.",3,0,3,6,0,0,
17/03/2020,VER.,"COATZACOALCOS, VER.",2,0,2,3,0,19,
17/03/2020,VER.,"VER., VER.",1,0,1,3,0,5526,
17/03/2020,CHIH.,"NUEVO CASAS GRANDES, CHIH.",0,0,0,0,0,428,
19/03/2020,VER.,"XALAPA, VER.",2,0,2,51,0,425,
19/03/2020,NAY.,"XALISCO, NAY.",1,0,1,0,0,0,
19/03/2020,VER.,"VER., VER.",1,0,1,2,0,20817,
20/03/2020,CHIH.,"JUÁREZ, CHIH.",9,2,11,13,0,420,
20/03/2020,VER.,"XALAPA, VER.",3,3,6,8,0,637,
20/03/2020,CHIS.,"COMITAN DE DOMÍNGUEZ, CHIS.",1,3,4,0,0,404,
20/03/2020,S.L.P.,"SAN LUIS POTOSI, S.L.P.",0,1,1,0,0,1549,
20/03/2020,VER.,"COATZACOALCOS, VER.",1,0,1,2,0,204,
20/03/2020,VER.,"VER., VER.",0,0,0,22,0,18920,
20/03/2020,S.L.P.,"TAMAZUNCHALE, S.L.P.",0,0,0,0,0,72,
21/03/2020,S.L.P.,"SAN LUIS POTOSI, S.L.P.",3,0,3,0,0,0,
21/03/2020,S.L.P.,"MATEHUALA, S.L.P.",0,0,0,0,0,30,
23/03/2020,COAH.,"SALTILLO, COAH.",1,0,1,0,0,0,
23/03/2020,COAH.,"MONCLOVA, COAH.",1,0,1,0,0,0,
24/03/2020,COAH.,"MONCLOVA, COAH.",0,2,2,2,0,0,
24/03/2020,S.L.P.,"CIUDAD VALLES, S.L.P.",0,0,0,0,0,150,
25/03/2020,COAH.,"TORREÓN, COAH.",3,1,4,0,0,0,
25/03/2020,COAH.,"SALTILLO, COAH.",3,0,3,0,0,52,
25/03/2020,S.L.P.,"CIUDAD VALLES, S.L.P.",1,1,2,0,0,0,
25/03/2020,COAH.,"PIEDRAS NEGRAS, COAH.",1,0,1,2,0,15,
25/03/2020,S.L.P.,"SAN LUIS POTOSI, S.L.P.",1,0,1,7,1,0,
07/07/2020,CD. MÉX.,"GUSTAVO A. MADERO, CD. MÉX.",3,0,3,0,0,298,
08/07/2020,CD. MÉX.,"GUSTAVO A. MADERO, CD. MÉX.",4,0,4,0,0,17,
09/07/2020,CD. MÉX.,"GUSTAVO A. MADERO, CD. MÉX.",3,0,3,0,0,0,
09/07/2020,CD. MÉX.,"CUAUHTEMOC, CD. MÉX.",0,0,0,0,1,0,
10/07/2020,CD. MÉX.,"GUSTAVO A. MADERO, CD. MÉX.",1,11,12,0,0,2534,
10/07/2020,CD. MÉX.,"CUAUHTEMOC, CD. MÉX.",8,1,9,0,0,307,
13/07/2020,CD. MÉX.,"CUAUHTEMOC, CD. MÉX.",1,1,2,0,0,444,
14/07/2020,CD. MÉX.,"CUAUHTEMOC, CD. MÉX.",0,3,3,0,0,0,
14/07/2020,CD. MÉX.,"GUSTAVO A. MADERO, CD. MÉX.",2,0,2,0,0,0,
15/07/2020,CD. MÉX.,"GUSTAVO A. MADERO, CD. MÉX.",2,0,2,0,0,62,
15/07/2020,CD. MÉX.,"CUAUHTEMOC, CD. MÉX.",2,0,2,0,0,12,
16/07/2020,CD. MÉX.,"CUAUHTEMOC, CD. MÉX.",4,0,4,0,0,98,
16/07/2020,CD. MÉX.,"GUSTAVO A. MADERO, CD. MÉX.",3,0,3,0,0,71,
17/07/2020,CD. MÉX.,"GUSTAVO A. MADERO, CD. MÉX.",1,1,2,0,0,0,
17/07/2020,CD. MÉX.,"CUAUHTEMOC, CD. MÉX.",2,0,2,0,0,25,
20/07/2020,CD. MÉX.,"CUAUHTEMOC, CD. MÉX.",0,0,0,0,1,0,
21/07/2020,CD. MÉX.,"GUSTAVO A. MADERO, CD. MÉX.",1,0,1,0,0,0,
22/07/2020,CD. MÉX.,"CUAUHTEMOC, CD. MÉX.",1,0,1,0,0,148,
22/07/2020,CD. MÉX.,"GUSTAVO A. MADERO, CD. MÉX.",1,0,1,0,0,0,
23/07/2020,CD. MÉX.,"GUSTAVO A. MADERO, CD. MÉX.",2,0,2,0,0,3,
23/07/2020,CD. MÉX.,"CUAUHTEMOC, CD. MÉX.",0,2,2,0,0,48,
24/07/2020,CD. MÉX.,"GUSTAVO A. MADERO, CD. MÉX.",2,0,2,0,0,194,
24/07/2020,CD. MÉX.,"CUAUHTEMOC, CD. MÉX.",0,0,0,0,0,1376,
27/07/2020,CD. MÉX.,"GUSTAVO A. MADERO, CD. MÉX.",1,0,1,0,0,0,
28/07/2020,CD. MÉX.,"CUAUHTEMOC, CD. MÉX.",1,2,3,0,0,4,
28/07/2020,CD. MÉX.,"GUSTAVO A. MADERO, CD. MÉX.",1,1,2,0,0,430,
30/07/2020,CD. MÉX.,"GUSTAVO A. MADERO, CD. MÉX.",2,2,4,0,0,11,
30/07/2020,CD. MÉX.,"CUAUHTEMOC, CD. MÉX.",3,0,3,0,2,43,
31/07/2020,CD. MÉX.,"GUSTAVO A. MADERO, CD. MÉX.",4,4,8,0,2,562,
31/07/2020,CD. MÉX.,"CUAUHTEMOC, CD. MÉX.",2,0,2,0,0,0,
03/08/2020,CD. MÉX.,"CUAUHTEMOC, CD. MÉX.",0,0,0,0,0,2000,
04/08/2020,CD. MÉX.,"GUSTAVO A. MADERO, CD. MÉX.",1,1,2,0,0,96,
05/08/2020,CD. MÉX.,"CUAUHTEMOC, CD. MÉX.",1,1,2,0,0,0,
05/08/2020,CD. MÉX.,"GUSTAVO A. MADERO, CD. MÉX.",0,0,0,0,0,35,
06/08/2020,CD. MÉX.,"CUAUHTEMOC, CD. MÉX.",3,0,3,0,0,0,
07/08/2020,CD. MÉX.,"CUAUHTEMOC, CD. MÉX.",0,3,3,0,0,0,
07/08/2020,CD. MÉX.,"GUSTAVO A. MADERO, CD. MÉX.",1,1,2,0,0,0,
10/08/2020,CD. MÉX.,"CUAUHTEMOC, CD. MÉX.",2,1,3,0,0,675,
11/08/2020,CD. MÉX.,"CUAUHTEMOC, CD. MÉX.",0,1,1,0,0,254,
12/08/2020,CD. MÉX.,"CUAUHTEMOC, CD. MÉX.",1,0,1,0,0,0,
12/08/2020,CD. MÉX.,"GUSTAVO A. MADERO, CD. MÉX.",0,0,0,0,0,10,
14/08/2020,CD. MÉX.,"CUAUHTEMOC, CD. MÉX.",5,2,7,0,0,100,
14/08/2020,CD. MÉX.,"GUSTAVO A. MADERO, CD. MÉX.",1,0,1,0,0,45,
18/08/2020,CD. MÉX.,"GUSTAVO A. MADERO, CD. MÉX.",1,0,1,0,4,0,
19/08/2020,CD. MÉX.,"GUSTAVO A. MADERO, CD. MÉX.",2,0,2,0,0,14,
20/08/2020,CD. MÉX.,"CUAUHTEMOC, CD. MÉX.",3,0,3,0,0,0,
20/08/2020,CD. MÉX.,"GUSTAVO A. MADERO, CD. MÉX.",1,0,1,0,0,0,
21/08/2020,CD. MÉX.,"CUAUHTEMOC, CD. MÉX.",2,1,3,0,0,22,
21/08/2020,CD. MÉX.,"GUSTAVO A. MADERO, CD. MÉX.",2,0,2,0,0,0,
24/08/2020,CD. MÉX.,"CUAUHTEMOC, CD. MÉX.",3,0,3,0,0,50,
25/08/2020,CD. MÉX.,"CUAUHTEMOC, CD. MÉX.",0,0,0,0,1,48,
26/08/2020,CD. MÉX.,"CUAUHTEMOC, CD. MÉX.",1,0,1,0,1,18,
27/08/2020,CD. MÉX.,"CUAUHTEMOC, CD. MÉX.",1,0,1,0,0,23,
28/08/2020,CD. MÉX.,"GUSTAVO A. MADERO, CD. MÉX.",1,0,1,0,0,1275,
31/08/2020,CD. MÉX.,"CUAUHTEMOC, CD. MÉX.",2,0,2,0,0,156,
01/09/2020,CD. MÉX.,"CUAUHTEMOC, CD. MÉX.",1,0,1,0,0,109,
02/09/2020,CD. MÉX.,"CUAUHTEMOC, CD. MÉX.",0,0,0,0,0,64,
03/09/2020,CD. MÉX.,"CUAUHTEMOC, CD. MÉX.",0,0,0,0,0,11,
04/09/2020,CD. MÉX.,"GUSTAVO A. MADERO, CD. MÉX.",1,0,1,0,0,0,
07/09/2020,CD. MÉX.,"CUAUHTEMOC, CD. MÉX.",3,0,3,0,0,0,
07/09/2020,CD. MÉX.,"GUSTAVO A. MADERO, CD. MÉX.",0,0,0,0,0,32,
08/09/2020,CD. MÉX.,"GUSTAVO A. MADERO, CD. MÉX.",3,1,4,0,0,116,
09/09/2020,CD. MÉX.,"GUSTAVO A. MADERO, CD. MÉX.",2,0,2,0,0,0,
09/09/2020,CD. MÉX.,"CUAUHTEMOC, CD. MÉX.",2,0,2,0,0,20,
10/09/2020,CD. MÉX.,"GUSTAVO A. MADERO, CD. MÉX.",1,1,2,0,1,0,
11/09/2020,CD. MÉX.,"GUSTAVO A. MADERO, CD. MÉX.",1,1,2,0,0,3,
17/09/2020,CD. MÉX.,"GUSTAVO A. MADERO, CD. MÉX.",4,1,5,0,0,0,
18/09/2020,CD. MÉX.,"GUSTAVO A. MADERO, CD. MÉX.",1,1,2,0,0,0,
18/09/2020,CD. MÉX.,"CUAUHTEMOC, CD. MÉX.",1,1,2,0,0,0,
19/09/2020,VER.,"CORDOBA, VER.",2,0,2,1,0,1265,
19/09/2020,VER.,"MARTINEZ DE LA TORRE, VER.",1,0,1,0,0,0,
20/09/2020,VER.,"MARTINEZ DE LA TORRE, VER.",2,2,4,0,0,5,
20/09/2020,VER.,"CORDOBA, VER.",2,0,2,1,0,0,
21/09/2020,VER.,"CORDOBA, VER.",4,1,5,3,0,129,
21/09/2020,VER.,"MARTINEZ DE LA TORRE, VER.",2,2,4,2,0,0,
22/09/2020,VER.,"MARTINEZ DE LA TORRE, VER.",2,2,4,1,0,18,
22/09/2020,CD. MÉX.,"GUSTAVO A. MADERO, CD. MÉX.",2,1,3,0,0,2,
22/09/2020,VER.,"CORDOBA, VER.",3,0,3,4,0,200,
22/09/2020,CD. MÉX.,"CUAUHTEMOC, CD. MÉX.",1,0,1,0,0,0,
23/09/2020,CD. MÉX.,"CUAUHTEMOC, CD. MÉX.",1,1,2,0,0,0,
23/09/2020,CD. MÉX.,"GUSTAVO A. MADERO, CD. MÉX.",2,0,2,0,0,0,
23/09/2020,VER.,"CORDOBA, VER.",2,0,2,1,0,1265,
23/09/2020,VER.,"MARTINEZ DE LA TORRE, VER.",1,0,1,0,0,0,
24/09/2020,VER.,"CORDOBA, VER.",2,0,2,2,0,697,
24/09/2020,VER.,"MARTINEZ DE LA TORRE, VER.",2,0,2,0,0,4,
24/09/2020,VER.,"MARTINEZ DE LA TORRE, VER.",1,0,1,0,0,700,
24/09/2020,VER.,"CORDOBA, VER.",0,0,0,0,1,1270,
25/09/2020,CD. MÉX.,"CUAUHTEMOC, CD. MÉX.",3,3,6,0,0,2320,
25/09/2020,CD. MÉX.,"GUSTAVO A. MADERO, CD. MÉX.",2,1,3,0,0,26,
25/09/2020,VER.,"CORDOBA, VER.",2,0,2,0,0,1757,
25/09/2020,VER.,"MARTINEZ DE LA TORRE, VER.",1,0,1,0,0,9,
27/09/2020,VER.,"MARTINEZ DE LA TORRE, VER.",2,3,5,2,0,0,
28/09/2020,VER.,"CORDOBA, VER.",2,0,2,0,0,8049,
28/09/2020,VER.,"MARTINEZ DE LA TORRE, VER.",2,0,2,1,0,90,
29/09/2020,CD. MÉX.,"GUSTAVO A. MADERO, CD. MÉX.",1,1,2,0,0,554,
30/09/2020,VER.,"MARTINEZ DE LA TORRE, VER.",1,4,5,1,0,317,
30/09/2020,VER.,"CORDOBA, VER.",1,0,1,0,0,2110,
01/10/2020,VER.,"CORDOBA, VER.",2,0,2,0,0,23,
01/10/2020,VER.,"VEGA DE ALATORRE, VER.",1,0,1,0,3,176,
02/10/2020,VER.,"CORDOBA, VER.",1,4,5,1,0,9539,
02/10/2020,VER.,"MARTINEZ DE LA TORRE, VER.",3,0,3,7,1,161,
02/10/2020,CD. MÉX.,"GUSTAVO A. MADERO, CD. MÉX.",1,0,1,0,0,0,
02/10/2020,CD. MÉX.,"CUAUHTEMOC, CD. MÉX.",0,1,1,0,0,0,
05/10/2020,CD. MÉX.,"GUSTAVO A. MADERO, CD. MÉX.",1,0,1,0,0,0,
07/10/2020,CD. MÉX.,"GUSTAVO A. MADERO, CD. MÉX.",2,0,2,0,0,0,
08/10/2020,CD. MÉX.,"GUSTAVO A. MADERO, CD. MÉX.",0,5,5,0,0,0,
09/10/2020,CD. MÉX.,"CUAUHTEMOC, CD. MÉX.",1,1,2,0,1,0,
09/10/2020,CD. MÉX.,"GUSTAVO A. MADERO, CD. MÉX.",0,0,0,0,0,198,
14/10/2020,CD. MÉX.,"CUAUHTEMOC, CD. MÉX.",2,0,2,0,0,0,
14/10/2020,CD. MÉX.,"GUSTAVO A. MADERO, CD. MÉX.",1,0,1,0,0,0,
16/10/2020,CD. MÉX.,"GUSTAVO A. MADERO, CD. MÉX.",0,4,4,0,0,0,
16/10/2020,CD. MÉX.,"CUAUHTEMOC, CD. MÉX.",2,0,2,0,0,0,
19/10/2020,CD. MÉX.,"CUAUHTEMOC, CD. MÉX.",1,0,1,0,0,0,
20/10/2020,CD. MÉX.,"GUSTAVO A. MADERO, CD. MÉX.",0,2,2,0,1,437,
20/10/2020,CD. MÉX.,"CUAUHTEMOC, CD. MÉX.",1,0,1,0,0,0,
21/10/2020,CD. MÉX.,"CUAUHTEMOC, CD. MÉX.",1,0,1,0,0,135,
22/10/2020,CD. MÉX.,"GUSTAVO A. MADERO, CD. MÉX.",0,4,4,0,0,0,
23/10/2020,CD. MÉX.,"CUAUHTEMOC, CD. MÉX.",10,1,11,0,0,87,
23/10/2020,CD. MÉX.,"GUSTAVO A. MADERO, CD. MÉX.",3,1,4,0,0,316,
26/10/2020,CD. MÉX.,"TLALPAN, CD. MÉX.",4,0,4,0,0,0,
26/10/2020,CD. MÉX.,"GUSTAVO A. MADERO, CD. MÉX.",2,0,2,0,0,0,
27/10/2020,CD. MÉX.,"TLALPAN, CD. MÉX.",1,5,6,0,0,1459,
27/10/2020,CD. MÉX.,"GUSTAVO A. MADERO, CD. MÉX.",4,1,5,0,0,460,
29/10/2020,CD. MÉX.,"GUSTAVO A. MADERO, CD. MÉX.",7,0,7,0,0,78,
29/10/2020,CD. MÉX.,"TLALPAN, CD. MÉX.",1,0,1,0,0,0,
30/10/2020,CD. MÉX.,"TLALPAN, CD. MÉX.",2,0,2,0,0,0,
30/10/2020,VER.,"COATEPEC, VER.",1,1,2,1,0,0,
30/10/2020,VER.,"VEGA DE ALATORRE, VER.",0,1,1,0,0,75,
31/10/2020,VER.,"COATEPEC, VER.",1,1,2,8,0,135,
03/11/2020,CD. MÉX.,"GUSTAVO A. MADERO, CD. MÉX.",1,3,4,0,0,35,
03/11/2020,CD. MÉX.,"TLALPAN, CD. MÉX.",2,0,2,0,0,0,
03/11/2020,VER.,"COATEPEC, VER.",0,0,0,7,0,75,
04/11/2020,CD. MÉX.,"GUSTAVO A. MADERO, CD. MÉX.",0,1,1,0,0,199,
04/11/2020,VER.,"COATEPEC, VER.",1,0,1,1,0,564,
05/11/2020,CD. MÉX.,"TLALPAN, CD. MÉX.",1,0,1,0,0,1843,
06/11/2020,CD. MÉX.,"GUSTAVO A. MADERO, CD. MÉX.",3,2,5,0,0,0,
06/11/2020,CD. MÉX.,"TLALPAN, CD. MÉX.",2,0,2,0,0,0,
08/11/2020,VER.,"VEGA DE ALATORRE, VER.",0,0,0,0,0,5414,
08/11/2020,VER.,"COATEPEC, VER.",0,0,0,0,0,7257,
09/11/2020,CD. MÉX.,"MIGUEL HGO., CD. MÉX.",1,2,3,0,0,434,
09/11/2020,CD. MÉX.,"GUSTAVO A. MADERO, CD. MÉX.",2,0,2,0,0,7364,
09/11/2020,VER.,"COATEPEC, VER.",1,0,1,1,0,11604,
10/11/2020,CD. MÉX.,"GUSTAVO A. MADERO, CD. MÉX.",0,1,1,0,0,7762,
10/11/2020,VER.,"VEGA DE ALATORRE, VER.",0,0,0,0,0,101,
10/11/2020,VER.,"COATEPEC, VER.",0,0,0,19,0,9824,
11/11/2020,CD. MÉX.,"VENUSTIANO CARRANZA, CD. MÉX.",0,3,3,0,0,0,
11/11/2020,VER.,"COATEPEC, VER.",1,0,1,0,0,6549,
11/11/2020,VER.,"VEGA DE ALATORRE, VER.",0,0,0,18,0,6206,
12/11/2020,CD. MÉX.,"GUSTAVO A. MADERO, CD. MÉX.",1,1,2,0,0,1000,
12/11/2020,VER.,"VEGA DE ALATORRE, VER.",1,1,2,0,0,798,
12/11/2020,VER.,"COATEPEC, VER.",2,0,2,15,0,5887,
12/11/2020,CD. MÉX.,"MIGUEL HGO., CD. MÉX.",0,1,1,0,0,0,
13/11/2020,CD. MÉX.,"MIGUEL HGO., CD. MÉX.",3,2,5,0,0,65,
13/11/2020,CD. MÉX.,"GUSTAVO A. MADERO, CD. MÉX.",1,1,2,0,0,0,
13/11/2020,VER.,"COATEPEC, VER.",1,0,1,0,0,4205,
13/11/2020,VER.,"VEGA DE ALATORRE, VER.",0,0,0,0,0,584,
17/11/2020,CD. MÉX.,"GUSTAVO A. MADERO, CD. MÉX.",1,1,2,0,0,0,
17/11/2020,CD. MÉX.,"CUAUHTEMOC, CD. MÉX.",1,0,1,0,0,0,
18/11/2020,CD. MÉX.,"MIGUEL HGO., CD. MÉX.",3,0,3,0,0,0,
18/11/2020,CD. MÉX.,"CUAUHTEMOC, CD. MÉX.",1,2,3,0,0,0,
18/11/2020,CD. MÉX.,"GUSTAVO A. MADERO, CD. MÉX.",3,0,3,0,0,252,
19/11/2020,CD. MÉX.,"GUSTAVO A. MADERO, CD. MÉX.",1,2,3,0,0,100,
20/11/2020,CD. MÉX.,"GUSTAVO A. MADERO, CD. MÉX.",0,0,0,0,0,100,
20/11/2020,CD. MÉX.,"CUAUHTEMOC, CD. MÉX.",0,0,0,0,0,85,
23/11/2020,CD. MÉX.,"GUSTAVO A. MADERO, CD. MÉX.",1,3,4,0,0,0,
24/11/2020,CD. MÉX.,"GUSTAVO A. MADERO, CD. MÉX.",2,2,4,0,0,0,
24/11/2020,CD. MÉX.,"BENITO JUAREZ, CD. MÉX.",1,0,1,0,0,0,
25/11/2020,CD. MÉX.,"CUAUHTEMOC, CD. MÉX.",3,3,6,0,0,0,
25/11/2020,CD. MÉX.,"BENITO JUAREZ, CD. MÉX.",0,0,0,0,0,43,
25/11/2020,CD. MÉX.,"GUSTAVO A. MADERO, CD. MÉX.",0,0,0,0,0,603,
26/11/2020,CD. MÉX.,"GUSTAVO A. MADERO, CD. MÉX.",0,3,3,0,0,0,
27/11/2020,CD. MÉX.,"GUSTAVO A. MADERO, CD. MÉX.",0,2,2,0,0,200,
27/11/2020,CD. MÉX.,"CUAUHTEMOC, CD. MÉX.",0,1,1,0,0,0,
30/11/2020,CD. MÉX.,"GUSTAVO A. MADERO, CD. MÉX.",1,3,4,0,0,0,
30/11/2020,CD. MÉX.,"BENITO JUAREZ, CD. MÉX.",1,0,1,0,0,37,
30/11/2020,CD. MÉX.,"CUAUHTEMOC, CD. MÉX.",1,0,1,0,0,0,
01/12/2020,CD. MÉX.,"GUSTAVO A. MADERO, CD. MÉX.",0,1,1,0,0,0,
02/12/2020,CD. MÉX.,"BENITO JUAREZ, CD. MÉX.",0,0,0,0,0,101,
03/12/2020,CD. MÉX.,"GUSTAVO A. MADERO, CD. MÉX.",0,4,4,0,0,0,
03/12/2020,CD. MÉX.,"CUAUHTEMOC, CD. MÉX.",1,0,1,0,0,79,
04/12/2020,CD. MÉX.,"GUSTAVO A. MADERO, CD. MÉX.",1,3,4,0,0,0,
04/12/2020,CD. MÉX.,"BENITO JUAREZ, CD. MÉX.",1,1,2,0,1,16,
07/12/2020,CD. MÉX.,"GUSTAVO A. MADERO, CD. MÉX.",2,3,5,0,0,0,
07/12/2020,CD. MÉX.,"VENUSTIANO CARRANZA, CD. MÉX.",1,0,1,0,0,0,
08/12/2020,CD. MÉX.,"GUSTAVO A. MADERO, CD. MÉX.",3,0,3,0,0,0,
08/12/2020,CD. MÉX.,"VENUSTIANO CARRANZA, CD. MÉX.",1,2,3,0,0,477,
09/12/2020,CD. MÉX.,"GUSTAVO A. MADERO, CD. MÉX.",0,6,6,0,0,0,
09/12/2020,CD. MÉX.,"VENUSTIANO CARRANZA, CD. MÉX.",0,0,0,0,0,6,
10/12/2020,CD. MÉX.,"VENUSTIANO CARRANZA, CD. MÉX.",0,2,2,0,0,0,
10/12/2020,CD. MÉX.,"CUAUHTEMOC, CD. MÉX.",0,0,0,0,0,88,
11/12/2020,CD. MÉX.,"CUAUHTEMOC, CD. MÉX.",0,8,8,0,0,0,
11/12/2020,CD. MÉX.,"VENUSTIANO CARRANZA, CD. MÉX.",4,0,4,0,0,109,
14/12/2020,CD. MÉX.,"GUSTAVO A. MADERO, CD. MÉX.",0,2,2,0,0,0,
15/12/2020,CD. MÉX.,"GUSTAVO A. MADERO, CD. MÉX.",0,5,5,0,0,0,
15/12/2020,CD. MÉX.,"VENUSTIANO CARRANZA, CD. MÉX.",2,0,2,0,0,3385,
15/12/2020,CD. MÉX.,"CUAUHTEMOC, CD. MÉX.",0,0,0,0,0,600,
16/12/2020,CD. MÉX.,"VENUSTIANO CARRANZA, CD. MÉX.",4,0,4,0,0,573,
16/12/2020,CD. MÉX.,"CUAUHTEMOC, CD. MÉX.",0,4,4,0,0,0,
16/12/2020,CD. MÉX.,"GUSTAVO A. MADERO, CD. MÉX.",0,2,2,0,0,0,
17/12/2020,CD. MÉX.,"GUSTAVO A. MADERO, CD. MÉX.",2,2,4,0,0,0,
17/12/2020,CD. MÉX.,"VENUSTIANO CARRANZA, CD. MÉX.",0,0,0,0,0,161,
18/12/2020,CD. MÉX.,"CUAUHTEMOC, CD. MÉX.",0,5,5,0,0,0,
18/12/2020,CD. MÉX.,"GUSTAVO A. MADERO, CD. MÉX.",0,3,3,0,0,0,
18/12/2020,CD. MÉX.,"VENUSTIANO CARRANZA, CD. MÉX.",1,0,1,0,15,4163,
25/02/2021,CHIS.,"CHENALHÓ, CHIS.",1,22,23,0,0,0,
25/02/2021,CHIS.,"ALDAMA, CHIS.",0,0,0,0,2,0,
26/02/2021,CHIS.,"CHENALHÓ, CHIS.",14,38,52,0,0,0,
14/06/2021,CD. MÉX.,"GUSTAVO A. MADERO, CD. MÉX.",1,0,1,0,0,0,
15/06/2021,CD. MÉX.,"CUAUHTEMOC, CD. MÉX.",1,0,1,0,0,0,
16/06/2021,CD. MÉX.,"IZTAPALAPA, CD. MÉX.",44,9,53,0,27,4471,
16/06/2021,CD. MÉX.,"ALVARO OBREGON, CD. MÉX.",2,0,2,0,0,42,
16/06/2021,CD. MÉX.,"GUSTAVO A. MADERO, CD. MÉX.",1,0,1,0,0,36,
17/06/2021,CD. MÉX.,"IZTAPALAPA, CD. MÉX.",0,1,1,0,0,0,
17/06/2021,CD. MÉX.,"ALVARO OBREGON, CD. MÉX.",1,0,1,0,0,206,
18/06/2021,CD. MÉX.,"ALVARO OBREGON, CD. MÉX.",1,1,2,0,0,25,
18/06/2021,CD. MÉX.,"IZTAPALAPA, CD. MÉX.",0,0,0,0,0,52,
09/07/2021,VER.,"MARTINEZ DE LA TORRE, VER.",2,1,3,1,0,10056,
09/07/2021,VER.,"MINATITLAN, VER.",3,0,3,0,0,8,
09/07/2021,VER.,"POZA RICA DE HGO., VER.",0,0,0,2,1,5100,
10/07/2021,VER.,"MARTINEZ DE LA TORRE, VER.",2,0,2,0,0,5708,
10/07/2021,VER.,"MINATITLAN, VER.",2,0,2,0,0,927,
10/07/2021,VER.,"POZA RICA DE HGO., VER.",2,0,2,3,0,8945,
11/07/2021,VER.,"POZA RICA DE HGO., VER.",0,1,1,0,0,6674,
11/07/2021,VER.,"MINATITLAN, VER.",0,0,0,1,0,70,
11/07/2021,VER.,"MARTINEZ DE LA TORRE, VER.",0,0,0,0,0,112,
12/07/2021,VER.,"MINATITLAN, VER.",1,1,2,3,0,378,
12/07/2021,VER.,"MARTINEZ DE LA TORRE, VER.",1,0,1,0,0,60,
12/07/2021,VER.,"POZA RICA DE HGO., VER.",1,0,1,1,1,1098,
12/07/2021,COAH.,"SABINAS, COAH.",0,0,0,0,1,8,
13/07/2021,VER.,"POZA RICA DE HGO., VER.",1,0,1,0,0,39,
13/07/2021,VER.,"MINATITLAN, VER.",0,0,0,0,1,0,
13/07/2021,VER.,"MARTINEZ DE LA TORRE, VER.",0,0,0,4,0,58,
14/07/2021,VER.,"POZA RICA DE HGO., VER.",2,1,3,2,0,62,
14/07/2021,VER.,"MARTINEZ DE LA TORRE, VER.",1,2,3,3,0,353,
14/07/2021,COAH.,"SABINAS, COAH.",0,1,1,1,0,434,
14/07/2021,COAH.,"ACUÑA, COAH.",0,1,1,0,0,0,
14/07/2021,VER.,"MINATITLAN, VER.",0,0,0,4,0,253,
15/07/2021,VER.,"MINATITLAN, VER.",2,1,3,1,0,1900,
15/07/2021,VER.,"POZA RICA DE HGO., VER.",2,1,3,2,0,289,
15/07/2021,COAH.,"SABINAS, COAH.",1,0,1,0,0,68,
15/07/2021,VER.,"ALAMO, VER.",1,0,1,0,0,0,
15/07/2021,COAH.,"ACUÑA, COAH.",0,0,0,1,0,0,
15/07/2021,VER.,"MARTINEZ DE LA TORRE, VER.",0,0,0,0,0,150,
16/07/2021,COAH.,"PIEDRAS NEGRAS, COAH.",3,3,6,1,0,23,
16/07/2021,VER.,"POZA RICA DE HGO., VER.",2,0,2,1,0,91,
16/07/2021,VER.,"MINATITLAN, VER.",2,0,2,1,0,125,
16/07/2021,COAH.,"MONCLOVA, COAH.",0,2,2,0,0,97,
16/07/2021,COAH.,"SAN PEDRO, COAH.",1,0,1,0,0,1,
16/07/2021,VER.,"MARTINEZ DE LA TORRE, VER.",0,1,1,0,0,1823,
16/07/2021,COAH.,"ACUÑA, COAH.",0,0,0,0,0,24,
17/07/2021,VER.,"MINATITLAN, VER.",1,1,2,0,0,137,
17/07/2021,VER.,"POZA RICA DE HGO., VER.",0,0,0,0,0,14520,
17/07/2021,VER.,"MARTINEZ DE LA TORRE, VER.",0,0,0,0,0,425,
18/07/2021,VER.,"MARTINEZ DE LA TORRE, VER.",0,0,0,1,0,664,
18/07/2021,VER.,"MINATITLAN, VER.",0,0,0,0,0,320,
19/07/2021,COAH.,"MONCLOVA, COAH.",4,0,4,2,1,141,
19/07/2021,VER.,"POZA RICA DE HGO., VER.",2,1,3,0,0,933,
19/07/2021,COAH.,"PIEDRAS NEGRAS, COAH.",2,0,2,4,0,280,
19/07/2021,VER.,"MARTINEZ DE LA TORRE, VER.",0,1,1,0,0,95,
19/07/2021,COAH.,"SAN PEDRO, COAH.",1,0,1,0,0,3,
19/07/2021,COAH.,"SALTILLO, COAH.",0,0,0,25,0,0,
19/07/2021,VER.,"MINATITLAN, VER.",0,0,0,0,0,368,
20/07/2021,VER.,"MINATITLAN, VER.",3,1,4,2,0,674,
20/07/2021,COAH.,"MONCLOVA, COAH.",2,0,2,2,0,14,
20/07/2021,COAH.,"MÚZQUIZ, COAH.",1,1,2,19,0,0,
20/07/2021,VER.,"MARTINEZ DE LA TORRE, VER.",0,1,1,12,0,2808,
20/07/2021,COAH.,"TORREÓN, COAH.",0,1,1,0,0,0,
20/07/2021,VER.,"POZA RICA DE HGO., VER.",0,1,1,2,1,19,
20/07/2021,COAH.,"RAMOS ARIZPE, COAH.",1,0,1,0,0,28,
20/07/2021,COAH.,"SALTILLO, COAH.",1,0,1,0,0,0,
20/07/2021,COAH.,"SAN PEDRO, COAH.",0,1,1,0,0,0,
20/07/2021,COAH.,"ACUÑA, COAH.",0,0,0,0,0,94,
20/07/2021,COAH.,"MATAMOROS, COAH.",0,0,0,17,0,0,
21/07/2021,COAH.,"MONCLOVA, COAH.",2,1,3,0,0,467,
21/07/2021,VER.,"POZA RICA DE HGO., VER.",2,0,2,1,1,187,
21/07/2021,COAH.,"PIEDRAS NEGRAS, COAH.",2,0,2,1,0,0,
21/07/2021,VER.,"MINATITLAN, VER.",1,0,1,0,0,8509,
21/07/2021,COAH.,"SALTILLO, COAH.",0,0,0,0,3,0,
21/07/2021,COAH.,"ACUÑA, COAH.",0,0,0,0,0,125,
22/07/2021,VER.,"POZA RICA DE HGO., VER.",3,1,4,3,0,206,
22/07/2021,COAH.,"PIEDRAS NEGRAS, COAH.",0,2,2,0,0,79,
22/07/2021,COAH.,"ACUÑA, COAH.",0,1,1,0,0,0,
22/07/2021,VER.,"MARTINEZ DE LA TORRE, VER.",0,0,0,0,0,382,
23/07/2021,COAH.,"TORREÓN, COAH.",1,3,4,0,0,0,
23/07/2021,VER.,"POZA RICA DE HGO., VER.",1,2,3,1,1,872,
23/07/2021,COAH.,"SAN PEDRO, COAH.",2,0,2,5,0,59,
23/07/2021,VER.,"MINATITLAN, VER.",1,0,1,2,0,831,
23/07/2021,VER.,"MARTINEZ DE LA TORRE, VER.",0,0,0,1,0,0,
09/08/2021,CD. MÉX.,"BENITO JUAREZ, CD. MÉX.",21,55,76,0,6,5044,
11/09/2021,CD. MÉX.,"GUSTAVO A. MADERO, CD. MÉX.",69,15,84,0,8,5962,
14/09/2021,B.C.,"MEXICALI, B.C.",3,5,8,0,0,0,
14/09/2021,B.C.,"SAN QUINTÍN, B.C.",2,0,2,1,0,0,
15/09/2021,B.C.,"SAN QUINTÍN, B.C.",0,0,0,0,0,20,
17/09/2021,B.C.,"SAN QUINTÍN, B.C.",1,1,2,1,0,0,
20/09/2021,B.C.,"SAN QUINTÍN, B.C.",0,1,1,0,0,0,
21/09/2021,B.C.,"MEXICALI, B.C.",3,0,3,0,0,0,
21/09/2021,B.C.,"SAN QUINTÍN, B.C.",0,2,2,0,0,0,
23/09/2021,GTO.,"SALAMANCA, GTO.",5,0,5,0,0,138,
23/09/2021,CHIH.,"CUAUHTÉMOC, CHIH.",1,1,2,0,1,100,
23/09/2021,CHIH.,"CUAUHTÉMOC, CHIH.",0,1,1,0,1,27,
24/09/2021,CD. MÉX.,"MIGUEL HGO., CD. MÉX.",15,2,17,0,0,1257,
24/09/2021,CHIH.,"CUAUHTÉMOC, CHIH.",2,0,2,2,4,263,
25/09/2021,CHIH.,"CUAUHTÉMOC, CHIH.",2,0,2,2,4,750,
27/09/2021,CHIH.,"DELICIAS, CHIH.",7,1,8,0,0,0,
27/09/2021,CHIH.,"HGO. DEL PARRAL, CHIH.",1,0,1,0,0,164,
27/09/2021,CHIH.,"CUAUHTÉMOC, CHIH.",0,0,0,1,1,427,
29/09/2021,CHIH.,"DELICIAS, CHIH.",2,0,2,7,0,352,
29/09/2021,CHIH.,"HGO. DEL PARRAL, CHIH.",1,0,1,0,0,144,
30/09/2021,CHIH.,"DELICIAS, CHIH.",8,3,11,11,1,221,
30/09/2021,B.C.,"SAN QUINTÍN, B.C.",0,1,1,0,0,0,
30/09/2021,CHIH.,"HGO. DEL PARRAL, CHIH.",0,0,0,0,0,422,
07/10/2021,B.C.,"SAN QUINTÍN, B.C.",0,1,1,1,0,0,
08/10/2021,B.C.,"ENSENADA, B.C.",1,0,1,7,0,96,
08/10/2021,B.C.,"SAN QUINTÍN, B.C.",0,0,0,2,0,150,
15/10/2021,B.C.,"SAN FELIPE, B.C.",1,0,1,0,0,0,
19/10/2021,CD. MÉX.,"TLALPAN, CD. MÉX.",3,0,3,0,0,246,
19/10/2021,B.C.,"SAN FELIPE, B.C.",1,0,1,0,0,0,
19/10/2021,B.C.,"TIJUANA, B.C.",1,0,1,0,0,0,
20/10/2021,CD. MÉX.,"IZTACALCO, CD. MÉX.",30,9,39,0,6,3732,
20/10/2021,CD. MÉX.,"IZTACALCO, CD. MÉX.",4,0,4,0,0,4,
20/10/2021,CD. MÉX.,"BENITO JUAREZ, CD. MÉX.",0,0,0,0,0,127,
21/10/2021,CD. MÉX.,"BENITO JUAREZ, CD. MÉX.",1,1,2,0,0,37,
21/10/2021,CD. MÉX.,"IZTACALCO, CD. MÉX.",1,0,1,0,0,623,
22/10/2021,CD. MÉX.,"IZTACALCO, CD. MÉX.",3,0,3,0,0,0,
22/10/2021,CD. MÉX.,"BENITO JUAREZ, CD. MÉX.",1,0,1,0,0,0,
25/10/2021,CD. MÉX.,"TLALPAN, CD. MÉX.",1,0,1,0,0,147,
25/10/2021,CD. MÉX.,"BENITO JUAREZ, CD. MÉX.",0,0,0,0,0,37,
29/10/2021,CD. MÉX.,"TLAHUAC, CD. MÉX.",2,0,2,0,0,0,
01/11/2021,CD. MÉX.,"BENITO JUAREZ, CD. MÉX.",1,0,1,0,0,0,
01/11/2021,CD. MÉX.,"BENITO JUAREZ, CD. MÉX.",1,0,1,0,0,0,
03/11/2021,CD. MÉX.,"XOCHIMILCO, CD. MÉX.",2,0,2,0,0,25,
03/11/2021,CD. MÉX.,"XOCHIMILCO, CD. MÉX.",2,0,2,0,0,25,
03/11/2021,CD. MÉX.,"COYOACAN, CD. MÉX.",1,0,1,1,0,497,
03/11/2021,CD. MÉX.,"COYOACAN, CD. MÉX.",1,0,1,1,0,497,
04/11/2021,CD. MÉX.,"COYOACAN, CD. MÉX.",2,1,3,0,0,790,
04/11/2021,CD. MÉX.,"COYOACAN, CD. MÉX.",2,1,3,0,0,790,
04/11/2021,CD. MÉX.,"XOCHIMILCO, CD. MÉX.",0,2,2,0,0,195,
04/11/2021,CD. MÉX.,"XOCHIMILCO, CD. MÉX.",0,2,2,0,0,195,
05/11/2021,CD. MÉX.,"XOCHIMILCO, CD. MÉX.",3,0,3,0,0,235,
05/11/2021,CD. MÉX.,"TLAHUAC, CD. MÉX.",2,0,2,0,0,0,
05/11/2021,CD. MÉX.,"COYOACAN, CD. MÉX.",1,0,1,0,0,0,
08/11/2021,CD. MÉX.,"COYOACAN, CD. MÉX.",5,0,5,0,0,310,
08/11/2021,TLAX.,"TLAX., TLAX.",1,2,3,0,0,50,
08/11/2021,TLAX.,"ZACATELCO, TLAX.",2,1,3,0,0,0,
08/11/2021,CD. MÉX.,"TLAHUAC, CD. MÉX.",1,0,1,0,0,11,
08/11/2021,TLAX.,"CONTLA DE JUAN CUAMATZI, TLAX.",1,0,1,0,0,0,
09/11/2021,TLAX.,"TLAX., TLAX.",4,1,5,0,0,46,
09/11/2021,TLAX.,"ZACATELCO, TLAX.",3,1,4,0,0,0,
09/11/2021,TLAX.,"CONTLA DE JUAN CUAMATZI, TLAX.",1,1,2,2,0,182,
09/11/2021,TLAX.,"PANOTLA, TLAX.",0,1,1,0,0,0,
10/11/2021,TLAX.,"CONTLA DE JUAN CUAMATZI, TLAX.",3,1,4,0,0,62,
10/11/2021,TLAX.,"ZACATELCO, TLAX.",4,0,4,0,0,0,
10/11/2021,TLAX.,"TLAX., TLAX.",2,1,3,0,0,0,
10/11/2021,TLAX.,"PANOTLA, TLAX.",1,0,1,0,0,0,
10/11/2021,CD. MÉX.,"COYOACAN, CD. MÉX.",0,0,0,0,0,8,
11/11/2021,TLAX.,"ZACATELCO, TLAX.",6,0,6,0,0,0,
11/11/2021,TLAX.,"TLAX., TLAX.",3,2,5,0,0,0,
11/11/2021,TLAX.,"CONTLA DE JUAN CUAMATZI, TLAX.",2,2,4,0,0,78,
11/11/2021,CD. MÉX.,"COYOACAN, CD. MÉX.",2,0,2,0,0,0,
11/11/2021,B.C.,"TIJUANA, B.C.",1,1,2,0,0,0,
12/11/2021,TLAX.,"ZACATELCO, TLAX.",4,1,5,0,0,0,
12/11/2021,TLAX.,"CONTLA DE JUAN CUAMATZI, TLAX.",4,0,4,0,0,19,
12/11/2021,CD. MÉX.,"COYOACAN, CD. MÉX.",2,1,3,0,0,53,
12/11/2021,VER.,"MINATITLAN, VER.",2,0,2,0,0,7,
12/11/2021,TLAX.,"TLAX., TLAX.",1,1,2,0,0,0,
12/11/2021,TLAX.,"PANOTLA, TLAX.",1,1,2,0,0,0,
12/11/2021,VER.,"NOGALES, VER.",1,0,1,0,0,25,
13/11/2021,VER.,"NOGALES, VER.",2,0,2,0,0,90,
13/11/2021,TLAX.,"CONTLA DE JUAN CUAMATZI, TLAX.",2,0,2,0,0,0,
13/11/2021,TLAX.,"PANOTLA, TLAX.",0,2,2,0,0,0,
13/11/2021,TLAX.,"TLAX., TLAX.",1,0,1,0,0,0,
13/11/2021,VER.,"SAYULA DE ALEMAN, VER.",1,0,1,0,0,0,
14/11/2021,VER.,"ALAMO, VER.",1,0,1,1,0,0,
14/11/2021,VER.,"SAYULA DE ALEMAN, VER.",1,0,1,0,0,559,
14/11/2021,VER.,"NOGALES, VER.",0,1,1,0,0,0,
15/11/2021,VER.,"SAYULA DE ALEMAN, VER.",1,0,1,1,0,59,
15/11/2021,VER.,"NOGALES, VER.",1,0,1,0,1,0,
15/11/2021,VER.,"ALAMO, VER.",0,1,1,1,0,66,
16/11/2021,VER.,"ALAMO, VER.",2,1,3,0,0,0,
16/11/2021,CHIH.,"OJINAGA, CHIH.",2,0,2,0,0,0,
16/11/2021,TLAX.,"IXTACUIXTLA DE MARIANO MATAMOROS, TLAX.",1,0,1,2,0,44,
16/11/2021,TLAX.,"NATIVITAS, TLAX.",1,0,1,0,0,0,
17/11/2021,TLAX.,"SAN PABLO DEL MONTE, TLAX.",4,1,5,0,0,0,
17/11/2021,VER.,"NOGALES, VER.",3,0,3,4,0,35,
17/11/2021,CD. MÉX.,"MIGUEL HGO., CD. MÉX.",1,1,2,0,0,54,
17/11/2021,VER.,"ALAMO, VER.",1,1,2,0,0,0,
17/11/2021,CD. MÉX.,"CUAJIMALPA DE MOR., CD. MÉX.",1,0,1,0,0,1329,
17/11/2021,TLAX.,"IXTACUIXTLA DE MARIANO MATAMOROS, TLAX.",0,1,1,0,0,0,
17/11/2021,TLAX.,"NATIVITAS, TLAX.",1,0,1,0,0,0,
17/11/2021,B.C.,"TIJUANA, B.C.",1,0,1,5,0,0,
18/11/2021,TLAX.,"SAN PABLO DEL MONTE, TLAX.",1,3,4,0,0,0,
18/11/2021,CD. MÉX.,"MIGUEL HGO., CD. MÉX.",2,1,3,0,0,600,
18/11/2021,CD. MÉX.,"CUAJIMALPA DE MOR., CD. MÉX.",2,0,2,0,0,51,
18/11/2021,VER.,"NOGALES, VER.",0,0,0,13,0,52,
19/11/2021,TLAX.,"SAN PABLO DEL MONTE, TLAX.",2,0,2,0,0,0,
19/11/2021,CD. MÉX.,"MIGUEL HGO., CD. MÉX.",2,0,2,0,0,100,
19/11/2021,VER.,"NOGALES, VER.",1,0,1,0,0,60,
19/11/2021,VER.,"ALAMO, VER.",1,0,1,0,0,66,
19/11/2021,B.C.,"SAN FELIPE, B.C.",0,0,0,0,0,165,
20/11/2021,VER.,"ALAMO, VER.",1,0,1,0,0,66,
20/11/2021,VER.,"SAYULA DE ALEMAN, VER.",0,0,0,0,0,9427,
22/11/2021,TLAX.,"ZITLALTEPEC DE TRINIDAD SANCHEZ SANTOS, TLAX.",1,1,2,0,0,0,
22/11/2021,CD. MÉX.,"MIGUEL HGO., CD. MÉX.",1,0,1,0,0,100,
22/11/2021,VER.,"NOGALES, VER.",0,1,1,20,0,100,
22/11/2021,TLAX.,"HUAMANTLA, TLAX.",1,0,1,0,0,46,
22/11/2021,VER.,"ALAMO, VER.",0,0,0,0,0,9,
23/11/2021,TLAX.,"ALTZAYANCA, TLAX.",2,1,3,0,0,0,
23/11/2021,CD. MÉX.,"ALVARO OBREGON, CD. MÉX.",1,1,2,0,0,78,
23/11/2021,CD. MÉX.,"GUSTAVO A. MADERO, CD. MÉX.",2,0,2,0,0,67,
23/11/2021,VER.,"NOGALES, VER.",1,0,1,0,0,130,
23/11/2021,TLAX.,"ZITLALTEPEC DE TRINIDAD SANCHEZ SANTOS, TLAX.",1,0,1,0,0,0,
23/11/2021,VER.,"ALAMO, VER.",1,0,1,1,0,77,
23/11/2021,VER.,"SAYULA DE ALEMAN, VER.",0,0,0,0,0,1536,
24/11/2021,CHIH.,"JUÁREZ, CHIH.",11,9,20,11,0,592,
24/11/2021,TLAX.,"ZITLALTEPEC DE TRINIDAD SANCHEZ SANTOS, TLAX.",2,0,2,0,0,0,
24/11/2021,CD. MÉX.,"CUAJIMALPA DE MOR., CD. MÉX.",2,0,2,0,0,0,
24/11/2021,TLAX.,"ALTZAYANCA, TLAX.",1,0,1,0,0,0,
24/11/2021,VER.,"ALAMO, VER.",1,0,1,0,0,0,
24/11/2021,VER.,"SAYULA DE ALEMAN, VER.",0,0,0,0,0,1260,
24/11/2021,VER.,"NOGALES, VER.",0,0,0,0,0,1066,
24/11/2021,CD. MÉX.,"ALVARO OBREGON, CD. MÉX.",0,0,0,0,0,174,
25/11/2021,CHIH.,"JUÁREZ, CHIH.",14,2,16,8,0,459,
25/11/2021,TLAX.,"HUAMANTLA, TLAX.",3,1,4,0,0,70,
25/11/2021,TLAX.,"ALTZAYANCA, TLAX.",0,2,2,0,0,0,
25/11/2021,CD. MÉX.,"GUSTAVO A. MADERO, CD. MÉX.",2,0,2,0,0,0,
25/11/2021,CD. MÉX.,"CUAJIMALPA DE MOR., CD. MÉX.",2,0,2,0,0,0,
25/11/2021,VER.,"ALAMO, VER.",0,1,1,0,0,0,
25/11/2021,VER.,"NOGALES, VER.",1,0,1,0,0,38,
25/11/2021,TLAX.,"ZITLALTEPEC DE TRINIDAD SANCHEZ SANTOS, TLAX.",0,1,1,0,0,0,
25/11/2021,TLAX.,"EL CARMEN TEQUEXQUITLA, TLAX.",0,1,1,0,0,0,
25/11/2021,CD. MÉX.,"ALVARO OBREGON, CD. MÉX.",0,1,1,0,0,0,
25/11/2021,VER.,"SAYULA DE ALEMAN, VER.",0,0,0,0,0,613,
26/11/2021,CHIH.,"JUÁREZ, CHIH.",8,5,13,3,1,508,
26/11/2021,TLAX.,"ZITLALTEPEC DE TRINIDAD SANCHEZ SANTOS, TLAX.",0,3,3,0,0,0,
26/11/2021,TLAX.,"HUAMANTLA, TLAX.",2,0,2,1,0,0,
26/11/2021,TLAX.,"EL CARMEN TEQUEXQUITLA, TLAX.",1,0,1,0,0,0,
26/11/2021,VER.,"ALAMO, VER.",1,0,1,0,0,27,
26/11/2021,VER.,"NOGALES, VER.",1,0,1,1,0,626,
26/11/2021,CD. MÉX.,"ALVARO OBREGON, CD. MÉX.",0,0,0,0,0,49,
26/11/2021,VER.,"SAYULA DE ALEMAN, VER.",0,0,0,0,0,5441,
27/11/2021,TLAX.,"ZITLALTEPEC DE TRINIDAD SANCHEZ SANTOS, TLAX.",1,2,3,0,0,0,
27/11/2021,TLAX.,"ALTZAYANCA, TLAX.",0,2,2,0,0,0,
27/11/2021,TLAX.,"HUAMANTLA, TLAX.",2,0,2,1,0,0,
27/11/2021,VER.,"ALAMO, VER.",1,0,1,0,0,27,
27/11/2021,B.C.,"SAN FELIPE, B.C.",0,0,0,1,0,97,
27/11/2021,B.C.,"SAN FELIPE, B.C.",0,0,0,0,0,200,
28/11/2021,VER.,"ALAMO, VER.",1,0,1,0,0,27,
29/11/2021,TLAX.,"TETLA DE LA SOLIDARIDAD, TLAX.",2,1,3,0,0,0,
29/11/2021,CHIS.,"MARQUÉS DE COMILLAS, CHIS.",1,1,2,1,0,0,
29/11/2021,CHIS.,"PALENQUE, CHIS.",0,1,1,0,0,0,
29/11/2021,TLAX.,"YAUHQUEMECAN, TLAX.",0,1,1,0,1,0,
29/11/2021,CD. MÉX.,"CUAJIMALPA DE MOR., CD. MÉX.",0,0,0,0,1,0,
29/11/2021,CHIS.,"BENEMÉRITO DE LAS AMÉRICAS, CHIS.",0,0,0,0,0,12,
30/11/2021,CHIH.,"JUÁREZ, CHIH.",10,4,14,59,0,420,
30/11/2021,TLAX.,"YAUHQUEMECAN, TLAX.",2,3,5,0,0,0,
30/11/2021,CHIS.,"BERRIOZÁBAL, CHIS.",3,1,4,2,6,722,
30/11/2021,CHIS.,"TUXTLA GUTIÉRREZ, CHIS.",3,0,3,0,0,441,
30/11/2021,CD. MÉX.,"ALVARO OBREGON, CD. MÉX.",2,0,2,0,0,0,
30/11/2021,TLAX.,"TERRENATE, TLAX.",1,0,1,0,0,0,
30/11/2021,TLAX.,"TETLA DE LA SOLIDARIDAD, TLAX.",1,0,1,0,0,0,
30/11/2021,CHIS.,"SAN FERNANDO, CHIS.",0,0,0,0,1,545,
01/12/2021,CHIS.,"TUXTLA GUTIÉRREZ, CHIS.",2,1,3,0,7,126,
01/12/2021,CHIS.,"BERRIOZÁBAL, CHIS.",2,1,3,0,4,1416,
01/12/2021,CHIS.,"CHALCHIHUITÁN, CHIS.",0,1,1,0,0,0,
01/12/2021,CHIS.,"TAPACHULA, CHIS.",1,0,1,0,0,0,
01/12/2021,SON.,"HERMOSILLO, SON.",0,1,1,0,0,0,
01/12/2021,CHIS.,"PALENQUE, CHIS.",0,0,0,0,0,40,
02/12/2021,SON.,"HERMOSILLO, SON.",7,1,8,4,0,15,
02/12/2021,CHIH.,"CHIH., CHIH.",7,0,7,0,0,0,
02/12/2021,CHIH.,"JUÁREZ, CHIH.",4,2,6,4,0,199,
02/12/2021,TLAX.,"TETLA DE LA SOLIDARIDAD, TLAX.",2,1,3,0,0,0,
02/12/2021,CHIS.,"TUXTLA GUTIÉRREZ, CHIS.",2,0,2,0,2,483,
02/12/2021,TLAX.,"CALPULALPAN, TLAX.",2,0,2,0,0,0,
02/12/2021,CD. MÉX.,"GUSTAVO A. MADERO, CD. MÉX.",2,0,2,0,0,251,
02/12/2021,CHIS.,"CHALCHIHUITÁN, CHIS.",1,0,1,0,0,0,
02/12/2021,SON.,"NOGALES, SON.",1,0,1,0,0,0,
02/12/2021,SON.,"MAGDALENA, SON.",1,0,1,0,0,0,
02/12/2021,SON.,"SAN LUIS RIO COLORADO, SON.",1,0,1,0,0,0,
02/12/2021,SON.,"CABORCA, SON.",1,0,1,10,0,0,
02/12/2021,TLAX.,"YAUHQUEMECAN, TLAX.",1,0,1,0,0,0,
02/12/2021,TLAX.,"TERRENATE, TLAX.",0,1,1,0,0,0,
02/12/2021,SON.,"AGUA PRIETA, SON.",0,0,0,90,0,0,
03/12/2021,CHIH.,"JUÁREZ, CHIH.",8,1,9,2,0,497,
03/12/2021,CHIH.,"CHIH., CHIH.",5,2,7,0,0,174,
04/12/2021,CHIS.,"TUXTLA GUTIÉRREZ, CHIS.",2,1,3,2,0,1531,
04/12/2021,OAX.,"OAX. DE JUAREZ, OAX.",2,1,3,0,0,50,
04/12/2021,CHIH.,"CHIH., CHIH.",1,1,2,0,0,174,
04/12/2021,CHIS.,"BENEMÉRITO DE LAS AMÉRICAS, CHIS.",1,0,1,0,0,187,
05/12/2021,CHIS.,"TUXTLA GUTIÉRREZ, CHIS.",1,1,2,0,2,311,
05/12/2021,CHIS.,"TAPACHULA, CHIS.",1,0,1,1,0,85,
05/12/2021,OAX.,"OAX. DE JUAREZ, OAX.",1,0,1,0,0,97,
05/12/2021,CHIS.,"TAPACHULA, CHIS.",0,0,0,0,0,73,
05/12/2021,CHIH.,"CHIH., CHIH.",0,0,0,0,0,210,
06/12/2021,SON.,"HERMOSILLO, SON.",7,3,10,11,1,257,
06/12/2021,CHIH.,"JUÁREZ, CHIH.",5,2,7,0,0,649,
06/12/2021,CHIH.,"CHIH., CHIH.",2,2,4,0,0,0,
06/12/2021,CD. MÉX.,"ALVARO OBREGON, CD. MÉX.",3,0,3,0,0,0,
06/12/2021,CHIS.,"CHIAPA DE CORZO, CHIS.",1,0,1,0,0,213,
06/12/2021,TLAX.,"EMILIANO ZAPATA, TLAX.",0,1,1,0,0,0,
06/12/2021,CHIS.,"REFORMA, CHIS.",0,1,1,0,0,0,
06/12/2021,CHIS.,"YAJALÓN, CHIS.",1,0,1,0,0,18,
06/12/2021,CD. MÉX.,"AZCAPOTZALCO, CD. MÉX.",1,0,1,0,0,0,
06/12/2021,CHIS.,"TUXTLA GUTIÉRREZ, CHIS.",0,0,0,0,0,109,
07/12/2021,CHIH.,"JUÁREZ, CHIH.",3,1,4,4,0,1141,
07/12/2021,SON.,"HERMOSILLO, SON.",1,3,4,0,1,42,
07/12/2021,CHIS.,"REFORMA, CHIS.",2,1,3,0,0,0,
07/12/2021,CHIS.,"TUXTLA GUTIÉRREZ, CHIS.",1,1,2,0,0,60,
07/12/2021,CHIH.,"CHIH., CHIH.",2,0,2,0,1,754,
07/12/2021,TLAX.,"HUEYOTLIPAN, TLAX.",0,2,2,0,0,0,
07/12/2021,CHIS.,"COMITAN DE DOMÍNGUEZ, CHIS.",1,0,1,0,0,0,
07/12/2021,CHIS.,"TONALÁ, CHIS.",1,0,1,0,0,0,
07/12/2021,OAX.,"OAX. DE JUAREZ, OAX.",1,0,1,0,0,151,
07/12/2021,CHIS.,"CHIAPA DE CORZO, CHIS.",0,0,0,0,0,111,
08/12/2021,CHIH.,"JUÁREZ, CHIH.",7,0,7,9,0,908,
08/12/2021,CHIH.,"CHIH., CHIH.",4,2,6,0,0,355,
08/12/2021,SON.,"HERMOSILLO, SON.",5,0,5,1,0,17,
08/12/2021,TLAX.,"PAPALOTLA DE XICOHTENCATL, TLAX.",1,2,3,0,0,0,
08/12/2021,CHIS.,"COMITAN DE DOMÍNGUEZ, CHIS.",2,0,2,0,0,8,
08/12/2021,CHIS.,"TUXTLA GUTIÉRREZ, CHIS.",0,1,1,0,0,214,
08/12/2021,CHIS.,"CHIAPA DE CORZO, CHIS.",0,1,1,0,0,9,
08/12/2021,CD. MÉX.,"IZTAPALAPA, CD. MÉX.",0,1,1,0,0,361,
08/12/2021,TLAX.,"EMILIANO ZAPATA, TLAX.",0,1,1,0,0,0,
08/12/2021,CD. MÉX.,"AZCAPOTZALCO, CD. MÉX.",0,0,0,0,0,45,
08/12/2021,OAX.,"OAX. DE JUAREZ, OAX.",0,0,0,0,0,192,
09/12/2021,CHIH.,"JUÁREZ, CHIH.",7,0,7,1,0,1977,
09/12/2021,SON.,"HERMOSILLO, SON.",3,2,5,2,0,0,
09/12/2021,CHIH.,"CHIH., CHIH.",5,0,5,0,1,499,
09/12/2021,CHIS.,"CHIAPA DE CORZO, CHIS.",0,1,1,0,0,153,
09/12/2021,CD. MÉX.,"ALVARO OBREGON, CD. MÉX.",1,0,1,0,0,392,
09/12/2021,OAX.,"OAX. DE JUAREZ, OAX.",1,0,1,0,0,51,
09/12/2021,CD. MÉX.,"IZTAPALAPA, CD. MÉX.",0,0,0,0,0,291,
09/12/2021,CHIS.,"COMITAN DE DOMÍNGUEZ, CHIS.",0,0,0,0,0,305,
10/12/2021,CHIH.,"CHIH., CHIH.",10,2,12,0,1,572,
10/12/2021,CHIH.,"JUÁREZ, CHIH.",6,0,6,1,1,908,
10/12/2021,CHIS.,"PUEBLO NUEVO SOLISTAHUACÁN, CHIS.",4,0,4,0,0,0,
10/12/2021,CHIS.,"COMITAN DE DOMÍNGUEZ, CHIS.",1,1,2,0,0,139,
10/12/2021,CHIS.,"CHIAPA DE CORZO, CHIS.",1,0,1,0,0,398,
10/12/2021,CHIS.,"TUXTLA GUTIÉRREZ, CHIS.",0,0,0,0,0,50,
10/12/2021,SON.,"HERMOSILLO, SON.",0,0,0,0,1,32,
11/12/2021,CHIS.,"PUEBLO NUEVO SOLISTAHUACÁN, CHIS.",3,1,4,0,0,0,
11/12/2021,CHIH.,"CHIH., CHIH.",1,0,1,0,0,217,
11/12/2021,CHIS.,"COMITAN DE DOMÍNGUEZ, CHIS.",1,0,1,0,0,348,
11/12/2021,CHIS.,"BENEMÉRITO DE LAS AMÉRICAS, CHIS.",0,0,0,0,0,10,
11/12/2021,CHIS.,"OCOSINGO, CHIS.",0,0,0,0,0,71,
12/12/2021,CHIS.,"PUEBLO NUEVO SOLISTAHUACÁN, CHIS.",3,0,3,0,0,0,
12/12/2021,OAX.,"OAX. DE JUAREZ, OAX.",1,1,2,0,0,171,
12/12/2021,CHIS.,"TUXTLA GUTIÉRREZ, CHIS.",0,0,0,0,0,241,
12/12/2021,CHIH.,"CHIH., CHIH.",0,0,0,0,0,445,
12/12/2021,CHIS.,"OCOSINGO, CHIS.",0,0,0,0,0,105,
13/12/2021,CHIH.,"JUÁREZ, CHIH.",3,2,5,2,0,948,
13/12/2021,CHIS.,"CHENALHÓ, CHIS.",0,3,3,0,0,0,
13/12/2021,SON.,"HERMOSILLO, SON.",2,0,2,0,0,0,
13/12/2021,CHIH.,"NUEVO CASAS GRANDES, CHIH.",2,0,2,0,0,33,
13/12/2021,CHIS.,"JUÁREZ, CHIS.",1,1,2,0,0,0,
13/12/2021,CHIH.,"CHIH., CHIH.",0,1,1,0,0,703,
13/12/2021,OAX.,"OAX. DE JUAREZ, OAX.",1,0,1,0,0,205,
13/12/2021,CHIS.,"TUXTLA GUTIÉRREZ, CHIS.",0,0,0,0,0,20,
14/12/2021,CHIH.,"JUÁREZ, CHIH.",9,3,12,21,0,1000,
14/12/2021,SON.,"HERMOSILLO, SON.",1,1,2,0,0,11,
14/12/2021,CHIS.,"OCOZOCOAUTLA DE ESPINOSA, CHIS.",1,1,2,0,0,95,
14/12/2021,OAX.,"SANTA LUCIA DEL CAMINO, OAX.",2,0,2,0,0,556,
14/12/2021,CHIS.,"TUXTLA GUTIÉRREZ, CHIS.",1,0,1,0,0,50,
14/12/2021,CHIS.,"SAN CRISTOBAL DE LAS CASAS, CHIS.",0,1,1,0,0,205,
14/12/2021,CHIH.,"CHIH., CHIH.",0,1,1,0,0,968,
14/12/2021,CD. MÉX.,"IZTAPALAPA, CD. MÉX.",0,0,0,0,0,27,
15/12/2021,CHIH.,"JUÁREZ, CHIH.",6,1,7,0,1,775,
15/12/2021,SON.,"HERMOSILLO, SON.",1,2,3,1,0,120,
15/12/2021,CD. MÉX.,"IZTACALCO, CD. MÉX.",3,0,3,0,0,6,
15/12/2021,CHIS.,"CHENALHÓ, CHIS.",0,2,2,0,0,239,
15/12/2021,CHIS.,"SAN CRISTOBAL DE LAS CASAS, CHIS.",1,0,1,0,0,0,
15/12/2021,CHIS.,"TUXTLA GUTIÉRREZ, CHIS.",0,0,0,1,0,388,
15/12/2021,CHIH.,"CHIH., CHIH.",0,0,0,0,0,398,
15/12/2021,CD. MÉX.,"IZTAPALAPA, CD. MÉX.",0,0,0,0,0,44,
16/12/2021,CHIH.,"JUÁREZ, CHIH.",4,1,5,0,0,975,
16/12/2021,CHIH.,"CHIH., CHIH.",1,0,1,0,0,298,
16/12/2021,CD. MÉX.,"IZTAPALAPA, CD. MÉX.",1,0,1,0,0,0,
16/12/2021,CHIS.,"OCOZOCOAUTLA DE ESPINOSA, CHIS.",1,0,1,0,0,610,
16/12/2021,CHIS.,"SAN CRISTOBAL DE LAS CASAS, CHIS.",0,0,0,0,0,139,
16/12/2021,CHIS.,"LA TRINITARIA, CHIS.",0,0,0,0,0,226,
17/12/2021,OAX.,"JUCHITAN DE ZARAGOZA, OAX.",13,1,14,0,0,199,
17/12/2021,CHIH.,"JUÁREZ, CHIH.",6,1,7,9,1,1131,
17/12/2021,CHIS.,"OCOZOCOAUTLA DE ESPINOSA, CHIS.",4,2,6,0,0,866,
17/12/2021,OAX.,"JUCHITAN DE ZARAGOZA, OAX.",6,0,6,0,0,122,
17/12/2021,SON.,"HERMOSILLO, SON.",1,3,4,0,0,13,
17/12/2021,CHIS.,"SAN CRISTOBAL DE LAS CASAS, CHIS.",1,3,4,0,0,1,
17/12/2021,CHIS.,"BOCHIL, CHIS.",1,2,3,0,0,0,
17/12/2021,CHIH.,"CHIH., CHIH.",1,0,1,0,0,379,
17/12/2021,CD. MÉX.,"CUAUHTEMOC, CD. MÉX.",1,0,1,0,0,0,
17/12/2021,CD. MÉX.,"IZTACALCO, CD. MÉX.",1,0,1,0,0,74,
17/12/2021,B.C.,"SAN FELIPE, B.C.",0,0,0,0,0,400,
18/12/2021,CHIS.,"LA TRINITARIA, CHIS.",0,2,2,0,0,0,
18/12/2021,CHIS.,"TUXTLA GUTIÉRREZ, CHIS.",1,0,1,0,0,246,
18/12/2021,CHIS.,"BOCHIL, CHIS.",0,1,1,0,0,0,
18/12/2021,CHIH.,"CHIH., CHIH.",0,0,0,0,0,652,
18/12/2021,CHIS.,"OCOSINGO, CHIS.",0,0,0,0,0,47,
19/12/2021,CHIH.,"CHIH., CHIH.",2,0,2,0,0,1003,
19/12/2021,B.C.,"ENSENADA, B.C.",1,0,1,3,0,0,
19/12/2021,CHIS.,"TUXTLA GUTIÉRREZ, CHIS.",0,0,0,1,0,236,
19/12/2021,CHIS.,"BENEMÉRITO DE LAS AMÉRICAS, CHIS.",0,0,0,0,0,10,
20/12/2021,CHIH.,"JUÁREZ, CHIH.",6,4,10,4,1,1914,
20/12/2021,CHIS.,"MEZCALAPA, CHIS.",2,1,3,0,0,0,
20/12/2021,SON.,"HERMOSILLO, SON.",1,1,2,0,0,0,
20/12/2021,CHIH.,"CHIH., CHIH.",0,0,0,0,0,731,
21/12/2021,CHIS.,"TECPATÁN, CHIS.",2,1,3,0,0,0,
22/12/2021,CHIH.,"JUÁREZ, CHIH.",5,2,7,1,0,1150,
04/01/2022,B.C.,"SAN QUINTÍN, B.C.",1,0,1,0,0,0,
14/01/2022,B.C.,"SAN QUINTÍN, B.C.",1,0,1,0,0,0,
18/01/2022,CD. MÉX.,"CUAUHTEMOC, CD. MÉX.",2,0,2,0,0,27,
19/01/2022,CD. MÉX.,"CUAUHTEMOC, CD. MÉX.",0,2,2,0,0,0,
20/01/2022,CD. MÉX.,"MIGUEL HGO., CD. MÉX.",3,3,6,0,0,114,
21/01/2022,CD. MÉX.,"CUAUHTEMOC, CD. MÉX.",2,1,3,0,0,77,
21/01/2022,CD. MÉX.,"MIGUEL HGO., CD. MÉX.",1,0,1,0,0,78,
24/01/2022,CD. MÉX.,"VENUSTIANO CARRANZA, CD. MÉX.",1,0,1,0,0,0,
25/01/2022,CD. MÉX.,"CUAUHTEMOC, CD. MÉX.",4,3,7,0,0,557,
25/01/2022,CD. MÉX.,"MIGUEL HGO., CD. MÉX.",2,0,2,0,0,38,
25/01/2022,CD. MÉX.,"CUAUHTEMOC, CD. MÉX.",1,0,1,0,0,0,
26/01/2022,CD. MÉX.,"CUAUHTEMOC, CD. MÉX.",1,0,1,0,0,0,
26/01/2022,CD. MÉX.,"VENUSTIANO CARRANZA, CD. MÉX.",1,0,1,0,0,0,
27/01/2022,CD. MÉX.,"CUAUHTEMOC, CD. MÉX.",5,3,8,0,0,216,
27/01/2022,CD. MÉX.,"VENUSTIANO CARRANZA, CD. MÉX.",1,0,1,0,10,949,
27/01/2022,CHIH.,"NUEVO CASAS GRANDES, CHIH.",1,0,1,6,0,115,
28/01/2022,CD. MÉX.,"MIGUEL HGO., CD. MÉX.",10,2,12,0,0,456,
28/01/2022,CD. MÉX.,"IZTAPALAPA, CD. MÉX.",6,1,7,0,0,101,
28/01/2022,CD. MÉX.,"VENUSTIANO CARRANZA, CD. MÉX.",0,0,0,0,0,49,
31/01/2022,CD. MÉX.,"MIGUEL HGO., CD. MÉX.",9,2,11,0,0,1661,
31/01/2022,CD. MÉX.,"IZTAPALAPA, CD. MÉX.",2,1,3,0,0,0,
01/02/2022,CD. MÉX.,"IZTAPALAPA, CD. MÉX.",2,0,2,0,0,0,
01/02/2022,CD. MÉX.,"IZTACALCO, CD. MÉX.",1,0,1,0,0,0,
02/02/2022,CD. MÉX.,"IZTAPALAPA, CD. MÉX.",2,1,3,0,0,47,
02/02/2022,CD. MÉX.,"IZTACALCO, CD. MÉX.",1,0,1,0,0,70,
02/02/2022,CD. MÉX.,"VENUSTIANO CARRANZA, CD. MÉX.",0,0,0,0,2,0,
03/02/2022,GTO.,"PURISIMA DEL RINCON, GTO.",2,8,10,0,0,0,
03/02/2022,CD. MÉX.,"IZTACALCO, CD. MÉX.",2,0,2,0,0,0,
03/02/2022,CD. MÉX.,"IZTAPALAPA, CD. MÉX.",1,0,1,0,0,129,
03/02/2022,CD. MÉX.,"VENUSTIANO CARRANZA, CD. MÉX.",0,0,0,0,0,99,
04/02/2022,GTO.,"PURISIMA DEL RINCON, GTO.",2,3,5,0,0,0,
04/02/2022,CD. MÉX.,"IZTACALCO, CD. MÉX.",3,0,3,0,0,12,
04/02/2022,CD. MÉX.,"IZTAPALAPA, CD. MÉX.",1,0,1,0,0,145,
04/02/2022,CD. MÉX.,"BENITO JUAREZ, CD. MÉX.",1,0,1,0,0,6,
06/02/2022,GTO.,"PURISIMA DEL RINCON, GTO.",1,1,2,0,0,0,
07/02/2022,GTO.,"PURISIMA DEL RINCON, GTO.",1,0,1,0,0,0,
08/02/2022,CD. MÉX.,"IZTAPALAPA, CD. MÉX.",2,1,3,0,1,193,
08/02/2022,CD. MÉX.,"IZTACALCO, CD. MÉX.",2,0,2,0,0,514,
08/02/2022,CD. MÉX.,"BENITO JUAREZ, CD. MÉX.",0,0,0,0,0,24,
09/02/2022,CD. MÉX.,"BENITO JUAREZ, CD. MÉX.",2,1,3,0,0,0,
09/02/2022,CD. MÉX.,"IZTAPALAPA, CD. MÉX.",1,0,1,0,0,0,
10/02/2022,CD. MÉX.,"BENITO JUAREZ, CD. MÉX.",0,5,5,0,0,78,
10/02/2022,CD. MÉX.,"IZTACALCO, CD. MÉX.",1,0,1,0,0,0,
10/02/2022,CD. MÉX.,"IZTAPALAPA, CD. MÉX.",1,0,1,0,0,14,
11/02/2022,CD. MÉX.,"IZTACALCO, CD. MÉX.",6,1,7,0,0,522,
11/02/2022,CD. MÉX.,"COYOACAN, CD. MÉX.",2,4,6,0,0,143,
11/02/2022,CD. MÉX.,"BENITO JUAREZ, CD. MÉX.",1,0,1,0,0,0,
29/03/2022,CD. MÉX.,"CUAUHTEMOC, CD. MÉX.",2,0,2,0,0,0,
29/03/2022,CD. MÉX.,"TLAHUAC, CD. MÉX.",0,0,0,0,0,22,
30/03/2022,CD. MÉX.,"CUAUHTEMOC, CD. MÉX.",1,0,1,0,0,198,
30/03/2022,CD. MÉX.,"TLAHUAC, CD. MÉX.",0,0,0,0,0,11,
31/03/2022,CD. MÉX.,"TLAHUAC, CD. MÉX.",2,0,2,0,0,102,
01/04/2022,CD. MÉX.,"CUAUHTEMOC, CD. MÉX.",2,0,2,0,0,0,
02/04/2022,CD. MÉX.,"CUAUHTEMOC, CD. MÉX.",32,19,51,0,3,3205,
04/04/2022,CD. MÉX.,"TLAHUAC, CD. MÉX.",0,0,0,0,0,50,
05/04/2022,CD. MÉX.,"CUAUHTEMOC, CD. MÉX.",1,0,1,0,0,0,
05/04/2022,CD. MÉX.,"CUAUHTEMOC, CD. MÉX.",0,0,0,0,0,146,
06/04/2022,CD. MÉX.,"CUAUHTEMOC, CD. MÉX.",1,0,1,0,0,167,
08/04/2022,CD. MÉX.,"TLAHUAC, CD. MÉX.",1,1,2,0,0,478,
08/04/2022,CD. MÉX.,"CUAUHTEMOC, CD. MÉX.",1,0,1,0,0,51,
11/04/2022,CD. MÉX.,"CUAUHTEMOC, CD. MÉX.",4,0,4,0,0,79,
12/04/2022,CD. MÉX.,"CUAUHTEMOC, CD. MÉX.",1,0,1,0,0,0,
12/04/2022,CD. MÉX.,"CUAUHTEMOC, CD. MÉX.",0,0,0,0,1,0,
18/04/2022,CD. MÉX.,"CUAUHTEMOC, CD. MÉX.",3,0,3,0,0,542,
19/04/2022,CD. MÉX.,"CUAUHTEMOC, CD. MÉX.",2,0,2,0,0,0,
20/04/2022,CD. MÉX.,"CUAUHTEMOC, CD. MÉX.",5,1,6,0,0,775,
21/04/2022,CD. MÉX.,"CUAUHTEMOC, CD. MÉX.",0,3,3,0,0,23,
21/04/2022,CD. MÉX.,"TLAHUAC, CD. MÉX.",1,0,1,0,0,0,
22/04/2022,CD. MÉX.,"CUAUHTEMOC, CD. MÉX.",5,1,6,0,0,250,
22/04/2022,S.L.P.,"SOLEDAD DE GRACIANO SANCHEZ, S.L.P.",1,0,1,0,0,0,
22/04/2022,CD. MÉX.,"TLAHUAC, CD. MÉX.",0,1,1,0,0,0,
23/04/2022,S.L.P.,"SOLEDAD DE GRACIANO SANCHEZ, S.L.P.",3,1,4,0,0,0,
25/04/2022,CD. MÉX.,"CUAUHTEMOC, CD. MÉX.",4,3,7,0,0,35,
25/04/2022,S.L.P.,"SOLEDAD DE GRACIANO SANCHEZ, S.L.P.",1,0,1,11,0,0,
25/04/2022,CD. MÉX.,"CUAUHTEMOC, CD. MÉX.",0,0,0,0,0,82,
26/04/2022,S.L.P.,"SOLEDAD DE GRACIANO SANCHEZ, S.L.P.",3,0,3,0,0,0,
26/04/2022,CD. MÉX.,"CUAUHTEMOC, CD. MÉX.",1,0,1,0,0,249,
27/04/2022,S.L.P.,"CIUDAD VALLES, S.L.P.",1,0,1,0,0,4,
27/04/2022,CD. MÉX.,"CUAUHTEMOC, CD. MÉX.",1,0,1,0,0,17,
27/04/2022,CD. MÉX.,"TLAHUAC, CD. MÉX.",1,0,1,0,0,0,
28/04/2022,S.L.P.,"SAN LUIS POTOSI, S.L.P.",2,1,3,0,0,0,
28/04/2022,CD. MÉX.,"CUAUHTEMOC, CD. MÉX.",0,1,1,0,0,110,
29/04/2022,S.L.P.,"CIUDAD VALLES, S.L.P.",3,1,4,0,0,79,
29/04/2022,CD. MÉX.,"CUAUHTEMOC, CD. MÉX.",2,1,3,0,0,37,
01/05/2022,S.L.P.,"CIUDAD VALLES, S.L.P.",1,2,3,0,0,0,
03/05/2022,S.L.P.,"SOLEDAD DE GRACIANO SANCHEZ, S.L.P.",6,0,6,0,0,0,
03/05/2022,CD. MÉX.,"CUAUHTEMOC, CD. MÉX.",2,1,3,0,0,42,
04/05/2022,S.L.P.,"SOLEDAD DE GRACIANO SANCHEZ, S.L.P.",0,3,3,0,0,0,
04/05/2022,CD. MÉX.,"CUAUHTEMOC, CD. MÉX.",2,0,2,0,0,40,
06/05/2022,CD. MÉX.,"CUAUHTEMOC, CD. MÉX.",1,0,1,0,0,919,
07/05/2022,S.L.P.,"SAN LUIS POTOSI, S.L.P.",0,1,1,0,0,0,
09/05/2022,CD. MÉX.,"CUAUHTEMOC, CD. MÉX.",0,0,0,0,2,634,
09/05/2022,CD. MÉX.,"TLAHUAC, CD. MÉX.",0,0,0,0,19,20,
10/05/2022,S.L.P.,"SAN LUIS POTOSI, S.L.P.",1,1,2,0,4,0,
11/05/2022,SIN.,"EL FUERTE, SIN.",1,2,3,0,0,0,
11/05/2022,SIN.,"CHOIX, SIN.",0,1,1,0,0,0,
11/05/2022,SIN.,"SIN., SIN.",1,0,1,0,0,0,
11/05/2022,CD. MÉX.,"CUAUHTEMOC, CD. MÉX.",1,0,1,0,2,1258,
11/05/2022,CD. MÉX.,"TLAHUAC, CD. MÉX.",0,0,0,0,19,0,
12/05/2022,SIN.,"SIN., SIN.",2,1,3,0,0,0,
12/05/2022,CD. MÉX.,"CUAUHTEMOC, CD. MÉX.",1,2,3,0,0,6,
12/05/2022,SIN.,"CHOIX, SIN.",2,0,2,0,0,0,
12/05/2022,SIN.,"EL FUERTE, SIN.",1,0,1,0,0,0,
13/05/2022,CD. MÉX.,"CUAUHTEMOC, CD. MÉX.",6,0,6,0,0,892,
13/05/2022,SIN.,"EL FUERTE, SIN.",1,3,4,0,0,0,
13/05/2022,SIN.,"SIN., SIN.",3,1,4,0,0,0,
13/05/2022,CD. MÉX.,"TLAHUAC, CD. MÉX.",1,0,1,0,0,291,
14/05/2022,S.L.P.,"SAN LUIS POTOSI, S.L.P.",5,0,5,0,0,0,
14/05/2022,SIN.,"EL FUERTE, SIN.",2,2,4,1,2,0,
14/05/2022,SIN.,"CHOIX, SIN.",0,2,2,0,0,0,
15/05/2022,SIN.,"CHOIX, SIN.",3,0,3,0,3,0,
15/05/2022,SIN.,"EL FUERTE, SIN.",0,3,3,0,0,0,
16/05/2022,CD. MÉX.,"CUAUHTEMOC, CD. MÉX.",3,0,3,0,0,55,
16/05/2022,SIN.,"EL FUERTE, SIN.",2,0,2,0,0,0,
16/05/2022,SIN.,"CHOIX, SIN.",0,1,1,0,0,0,
17/05/2022,CD. MÉX.,"CUAUHTEMOC, CD. MÉX.",2,0,2,0,4,32,
17/05/2022,S.L.P.,"SAN LUIS POTOSI, S.L.P.",2,0,2,0,0,0,
17/05/2022,SIN.,"CHOIX, SIN.",0,1,1,0,0,0,
18/05/2022,CD. MÉX.,"VENUSTIANO CARRANZA, CD. MÉX.",36,7,43,0,0,1539,
18/05/2022,SIN.,"EL FUERTE, SIN.",1,2,3,0,0,0,
18/05/2022,SIN.,"SIN., SIN.",1,0,1,0,0,0,
18/05/2022,CD. MÉX.,"CUAUHTEMOC, CD. MÉX.",0,0,0,0,2,342,
19/05/2022,SIN.,"EL FUERTE, SIN.",5,1,6,0,12,0,
19/05/2022,CD. MÉX.,"VENUSTIANO CARRANZA, CD. MÉX.",3,0,3,0,0,691,
19/05/2022,CD. MÉX.,"CUAUHTEMOC, CD. MÉX.",1,0,1,0,0,0,
19/05/2022,S.L.P.,"SAN LUIS POTOSI, S.L.P.",1,0,1,0,0,0,
19/05/2022,S.L.P.,"CIUDAD VALLES, S.L.P.",1,0,1,0,0,0,
19/05/2022,SIN.,"CHOIX, SIN.",1,0,1,0,0,0,
19/05/2022,SIN.,"SIN., SIN.",1,0,1,0,0,0,
20/05/2022,CD. MÉX.,"GUSTAVO A. MADERO, CD. MÉX.",42,10,52,0,12,3270,
20/05/2022,SIN.,"CHOIX, SIN.",0,5,5,0,0,0,
20/05/2022,SIN.,"EL FUERTE, SIN.",4,1,5,0,0,0,
20/05/2022,VER.,"XALAPA, VER.",5,0,5,18,0,363,
20/05/2022,VER.,"COATZACOALCOS, VER.",0,2,2,0,0,258,
20/05/2022,CD. MÉX.,"CUAUHTEMOC, CD. MÉX.",0,1,1,0,0,307,
21/05/2022,VER.,"COATZACOALCOS, VER.",4,0,4,16,0,86,
21/05/2022,VER.,"XALAPA, VER.",4,0,4,0,0,219,
21/05/2022,SIN.,"EL FUERTE, SIN.",3,0,3,0,0,0,
21/05/2022,SIN.,"CHOIX, SIN.",1,1,2,0,0,0,
21/05/2022,S.L.P.,"SAN LUIS POTOSI, S.L.P.",0,0,0,0,4,0,
22/05/2022,SIN.,"CHOIX, SIN.",4,2,6,0,0,0,
22/05/2022,VER.,"COATZACOALCOS, VER.",0,1,1,2,0,13,
22/05/2022,SIN.,"EL FUERTE, SIN.",1,0,1,0,0,0,
22/05/2022,VER.,"XALAPA, VER.",0,0,0,42,0,481,
23/05/2022,VER.,"XALAPA, VER.",4,1,5,28,0,959,
23/05/2022,VER.,"COATZACOALCOS, VER.",3,0,3,6,1,714,
23/05/2022,CD. MÉX.,"CUAUHTEMOC, CD. MÉX.",2,0,2,0,0,3,
23/05/2022,CD. MÉX.,"GUSTAVO A. MADERO, CD. MÉX.",1,0,1,0,0,479,
23/05/2022,CD. MÉX.,"VENUSTIANO CARRANZA, CD. MÉX.",0,0,0,0,0,20,
24/05/2022,CD. MÉX.,"GUSTAVO A. MADERO, CD. MÉX.",3,1,4,0,0,467,
24/05/2022,VER.,"COATZACOALCOS, VER.",2,0,2,0,0,123,
24/05/2022,CD. MÉX.,"VENUSTIANO CARRANZA, CD. MÉX.",1,0,1,0,0,3,
24/05/2022,VER.,"XALAPA, VER.",0,1,1,3,0,26,
24/05/2022,CD. MÉX.,"IZTAPALAPA, CD. MÉX.",0,0,0,0,0,111,
25/05/2022,CD. MÉX.,"CUAUHTEMOC, CD. MÉX.",2,0,2,0,0,3,
25/05/2022,VER.,"XALAPA, VER.",2,0,2,31,0,517,
25/05/2022,VER.,"COATZACOALCOS, VER.",1,1,2,15,0,65,
25/05/2022,CD. MÉX.,"GUSTAVO A. MADERO, CD. MÉX.",1,0,1,0,0,479,
25/05/2022,CD. MÉX.,"VENUSTIANO CARRANZA, CD. MÉX.",0,0,0,0,0,20,
26/05/2022,CD. MÉX.,"VENUSTIANO CARRANZA, CD. MÉX.",2,6,8,0,0,198,
26/05/2022,CD. MÉX.,"IZTAPALAPA, CD. MÉX.",4,0,4,0,0,315,
26/05/2022,CD. MÉX.,"VENUSTIANO CARRANZA, CD. MÉX.",2,2,4,0,0,89,
26/05/2022,VER.,"COATZACOALCOS, VER.",4,0,4,2,0,139,
26/05/2022,S.L.P.,"SAN LUIS POTOSI, S.L.P.",1,2,3,0,1,0,
26/05/2022,CD. MÉX.,"GUSTAVO A. MADERO, CD. MÉX.",2,0,2,0,0,35,
26/05/2022,CD. MÉX.,"GUSTAVO A. MADERO, CD. MÉX.",1,1,2,0,39,0,
26/05/2022,VER.,"XALAPA, VER.",1,0,1,23,0,443,
26/05/2022,S.L.P.,"SAN LUIS POTOSI, S.L.P.",0,0,0,0,1,0,
27/05/2022,CD. MÉX.,"MIGUEL HGO., CD. MÉX.",4,1,5,0,0,321,
27/05/2022,CD. MÉX.,"IZTAPALAPA, CD. MÉX.",1,1,2,0,1,24,
27/05/2022,VER.,"XALAPA, VER.",0,1,1,30,0,134,
28/05/2022,S.L.P.,"SAN LUIS POTOSI, S.L.P.",1,2,3,0,12,0,
28/05/2022,VER.,"COATZACOALCOS, VER.",2,0,2,1,0,68,
28/05/2022,VER.,"XALAPA, VER.",1,0,1,1,0,33,
29/05/2022,VER.,"COATZACOALCOS, VER.",2,1,3,28,0,305,
29/05/2022,VER.,"XALAPA, VER.",2,0,2,45,0,0,
29/05/2022,S.L.P.,"SAN LUIS POTOSI, S.L.P.",1,0,1,0,0,0,
29/05/2022,S.L.P.,"TAMUIN, S.L.P.",0,1,1,0,0,0,
30/05/2022,VER.,"COATZACOALCOS, VER.",5,0,5,9,0,210,
30/05/2022,VER.,"XALAPA, VER.",4,0,4,2,0,13,
30/05/2022,VER.,"COATZACOALCOS, VER.",2,1,3,9,0,494,
30/05/2022,S.L.P.,"SAN LUIS POTOSI, S.L.P.",2,0,2,0,0,0,
30/05/2022,CD. MÉX.,"GUSTAVO A. MADERO, CD. MÉX.",1,0,1,0,0,208,
30/05/2022,CD. MÉX.,"MIGUEL HGO., CD. MÉX.",1,0,1,0,0,0,
31/05/2022,CD. MÉX.,"GUSTAVO A. MADERO, CD. MÉX.",7,0,7,0,0,35,
31/05/2022,CD. MÉX.,"MIGUEL HGO., CD. MÉX.",3,0,3,0,0,38,
31/05/2022,VER.,"XALAPA, VER.",2,0,2,12,0,66,
31/05/2022,CD. MÉX.,"IZTAPALAPA, CD. MÉX.",0,1,1,0,0,0,
01/06/2022,VER.,"XALAPA, VER.",6,2,8,60,0,2030,
01/06/2022,B.C.,"TIJUANA, B.C.",1,3,4,0,0,0,
01/06/2022,CD. MÉX.,"GUSTAVO A. MADERO, CD. MÉX.",1,1,2,0,6,17,
01/06/2022,CD. MÉX.,"IZTAPALAPA, CD. MÉX.",1,0,1,0,0,0,
01/06/2022,CD. MÉX.,"MIGUEL HGO., CD. MÉX.",0,0,0,0,0,104,
02/06/2022,VER.,"XALAPA, VER.",0,2,2,0,0,18,
02/06/2022,CD. MÉX.,"MIGUEL HGO., CD. MÉX.",2,0,2,0,0,0,
02/06/2022,CD. MÉX.,"GUSTAVO A. MADERO, CD. MÉX.",1,0,1,0,0,43,
02/06/2022,CD. MÉX.,"IZTAPALAPA, CD. MÉX.",0,0,0,0,0,20,
03/06/2022,CD. MÉX.,"AZCAPOTZALCO, CD. MÉX.",1,1,2,0,0,26,
03/06/2022,VER.,"XALAPA, VER.",1,0,1,48,1,200,
03/06/2022,S.L.P.,"EBANO, S.L.P.",0,1,1,2,0,30,
03/06/2022,B.C.,"TIJUANA, B.C.",0,1,1,0,0,0,
03/06/2022,CD. MÉX.,"MIGUEL HGO., CD. MÉX.",0,0,0,0,0,45,
04/06/2022,S.L.P.,"SAN LUIS POTOSI, S.L.P.",1,0,1,0,0,0,
06/06/2022,SIN.,"GUASAVE, SIN.",6,1,7,0,0,15,
06/06/2022,SIN.,"AHOME, SIN.",4,0,4,0,0,0,
06/06/2022,TLAX.,"APIZACO, TLAX.",4,0,4,0,0,0,
06/06/2022,CD. MÉX.,"AZCAPOTZALCO, CD. MÉX.",2,0,2,0,0,11,
06/06/2022,CD. MÉX.,"IZTAPALAPA, CD. MÉX.",2,0,2,0,7,6,
06/06/2022,TLAX.,"TLAX., TLAX.",2,0,2,0,0,0,
06/06/2022,SIN.,"ANGOSTURA, SIN.",0,1,1,0,0,0,
06/06/2022,CD. MÉX.,"MIGUEL HGO., CD. MÉX.",0,0,0,0,0,2137,
07/06/2022,SIN.,"AHOME, SIN.",8,4,12,4,0,109,
07/06/2022,TLAX.,"TLAX., TLAX.",3,1,4,0,0,0,
07/06/2022,SIN.,"GUASAVE, SIN.",3,0,3,0,0,0,
07/06/2022,SIN.,"ANGOSTURA, SIN.",3,0,3,0,0,12,
07/06/2022,S.L.P.,"SAN LUIS POTOSI, S.L.P.",1,0,1,0,0,0,
07/06/2022,CD. MÉX.,"AZCAPOTZALCO, CD. MÉX.",1,0,1,0,0,119,
07/06/2022,CD. MÉX.,"MIGUEL HGO., CD. MÉX.",1,0,1,0,0,20,
07/06/2022,TLAX.,"PANOTLA, TLAX.",1,0,1,0,0,0,
07/06/2022,CD. MÉX.,"VENUSTIANO CARRANZA, CD. MÉX.",0,0,0,0,0,48,
08/06/2022,SIN.,"AHOME, SIN.",4,2,6,1,0,107,
08/06/2022,SIN.,"GUASAVE, SIN.",3,0,3,0,0,0,
08/06/2022,SIN.,"ANGOSTURA, SIN.",2,0,2,0,0,0,
08/06/2022,TLAX.,"TLAX., TLAX.",1,1,2,2,0,0,
08/06/2022,CD. MÉX.,"VENUSTIANO CARRANZA, CD. MÉX.",1,0,1,0,0,233,
08/06/2022,TLAX.,"APIZACO, TLAX.",1,0,1,1,0,30,
08/06/2022,TLAX.,"PANOTLA, TLAX.",0,1,1,0,0,0,
08/06/2022,CD. MÉX.,"MIGUEL HGO., CD. MÉX.",0,0,0,0,0,299,
09/06/2022,SIN.,"AHOME, SIN.",8,2,10,1,0,12,
09/06/2022,SIN.,"GUASAVE, SIN.",5,1,6,0,0,0,
09/06/2022,CD. MÉX.,"AZCAPOTZALCO, CD. MÉX.",2,0,2,0,0,626,
09/06/2022,TLAX.,"TLAX., TLAX.",1,0,1,0,0,0,
09/06/2022,TLAX.,"PANOTLA, TLAX.",1,0,1,0,0,0,
09/06/2022,SIN.,"ANGOSTURA, SIN.",0,1,1,0,0,0,
09/06/2022,CD. MÉX.,"VENUSTIANO CARRANZA, CD. MÉX.",0,0,0,0,7,0,
09/06/2022,CD. MÉX.,"ALVARO OBREGON, CD. MÉX.",0,0,0,0,0,1,
09/06/2022,S.L.P.,"SAN LUIS POTOSI, S.L.P.",0,0,0,0,1,0,
10/06/2022,SIN.,"AHOME, SIN.",13,2,15,0,0,127,
10/06/2022,CD. MÉX.,"ALVARO OBREGON, CD. MÉX.",3,2,5,0,0,180,
10/06/2022,SIN.,"ANGOSTURA, SIN.",3,0,3,0,0,0,
10/06/2022,TLAX.,"TLAX., TLAX.",1,0,1,0,0,42,
10/06/2022,CD. MÉX.,"VENUSTIANO CARRANZA, CD. MÉX.",1,0,1,0,0,118,
10/06/2022,TLAX.,"APIZACO, TLAX.",0,0,0,0,0,30,
11/06/2022,TLAX.,"TETLA DE LA SOLIDARIDAD, TLAX.",0,2,2,0,0,0,
11/06/2022,SIN.,"AHOME, SIN.",2,0,2,0,0,0,
11/06/2022,SIN.,"GUASAVE, SIN.",2,0,2,0,0,0,
11/06/2022,TLAX.,"TLAX., TLAX.",1,0,1,1,0,10,
11/06/2022,TLAX.,"APIZACO, TLAX.",1,0,1,0,0,0,
11/06/2022,SIN.,"ANGOSTURA, SIN.",0,0,0,0,0,305,
12/06/2022,SIN.,"GUASAVE, SIN.",1,0,1,0,0,0,
12/06/2022,S.L.P.,"SAN LUIS POTOSI, S.L.P.",1,0,1,0,0,0,
13/06/2022,SIN.,"AHOME, SIN.",4,5,9,0,0,64,
13/06/2022,CD. MÉX.,"AZCAPOTZALCO, CD. MÉX.",4,0,4,0,0,400,
13/06/2022,SIN.,"GUASAVE, SIN.",1,1,2,0,0,0,
13/06/2022,S.L.P.,"SAN LUIS POTOSI, S.L.P.",1,1,2,0,0,0,
13/06/2022,SIN.,"ANGOSTURA, SIN.",0,1,1,0,3,0,
14/06/2022,SIN.,"AHOME, SIN.",3,1,4,0,0,0,
14/06/2022,SIN.,"ANGOSTURA, SIN.",2,2,4,0,0,0,
14/06/2022,TLAX.,"CUAPIAXTLA, TLAX.",1,1,2,0,0,0,
14/06/2022,JAL.,"TLAJOMULCO DE ZUÑIGA, JAL.",2,0,2,1,0,47,
14/06/2022,TLAX.,"NANACAMILPA DE MARIANO ARISTA, TLAX.",0,1,1,0,0,0,
14/06/2022,TLAX.,"EL CARMEN TEQUEXQUITLA, TLAX.",0,1,1,0,0,0,
14/06/2022,CD. MÉX.,"CUAUHTEMOC, CD. MÉX.",1,0,1,0,0,44,
14/06/2022,CD. MÉX.,"VENUSTIANO CARRANZA, CD. MÉX.",0,1,1,0,0,0,
14/06/2022,CD. MÉX.,"ALVARO OBREGON, CD. MÉX.",1,0,1,0,0,115,
15/06/2022,CD. MÉX.,"ALVARO OBREGON, CD. MÉX.",6,3,9,0,0,288,
15/06/2022,SIN.,"AHOME, SIN.",4,1,5,0,1,0,
15/06/2022,CD. MÉX.,"CUAUHTEMOC, CD. MÉX.",1,2,3,0,0,0,
15/06/2022,SIN.,"GUASAVE, SIN.",2,0,2,0,0,0,
15/06/2022,TLAX.,"NANACAMILPA DE MARIANO ARISTA, TLAX.",0,2,2,0,0,0,
15/06/2022,JAL.,"TLAJOMULCO DE ZUÑIGA, JAL.",0,0,0,1,0,6,
16/06/2022,CD. MÉX.,"ALVARO OBREGON, CD. MÉX.",7,1,8,0,0,94,
16/06/2022,SIN.,"AHOME, SIN.",3,1,4,0,0,32,
16/06/2022,SIN.,"GUASAVE, SIN.",1,1,2,0,0,0,
16/06/2022,SIN.,"ANGOSTURA, SIN.",0,1,1,0,0,0,
16/06/2022,TLAX.,"CALPULALPAN, TLAX.",1,0,1,0,0,0,
16/06/2022,CD. MÉX.,"CUAUHTEMOC, CD. MÉX.",0,0,0,0,0,10,
17/06/2022,N.L.,"MONTERREY, N.L.",14,5,19,8,0,474,
17/06/2022,CD. MÉX.,"TLALPAN, CD. MÉX.",5,3,8,0,0,490,
17/06/2022,SIN.,"GUASAVE, SIN.",4,0,4,0,0,0,
17/06/2022,CD. MÉX.,"ALVARO OBREGON, CD. MÉX.",1,2,3,0,0,0,
17/06/2022,CHIH.,"JUÁREZ, CHIH.",2,1,3,0,0,0,
17/06/2022,JAL.,"TLAJOMULCO DE ZUÑIGA, JAL.",1,0,1,1,0,5,
17/06/2022,SIN.,"AHOME, SIN.",1,0,1,0,0,0,
17/06/2022,S.L.P.,"SAN LUIS POTOSI, S.L.P.",1,0,1,0,0,0,
17/06/2022,TLAX.,"CALPULALPAN, TLAX.",0,1,1,0,0,0,
17/06/2022,TLAX.,"CUAPIAXTLA, TLAX.",1,0,1,0,0,0,
18/06/2022,SIN.,"AHOME, SIN.",7,2,9,0,0,0,
18/06/2022,CHIH.,,4,0,4,17,0,156,
18/06/2022,SIN.,"GUASAVE, SIN.",1,1,2,0,0,0,
18/06/2022,SIN.,"ANGOSTURA, SIN.",0,1,1,0,0,0,
18/06/2022,S.L.P.,"SAN LUIS POTOSI, S.L.P.",1,0,1,0,0,0,
19/06/2022,SIN.,"AHOME, SIN.",1,0,1,0,0,0,
19/06/2022,SIN.,"GUASAVE, SIN.",1,0,1,0,0,0,
19/06/2022,QRO.,"JALPAN DE SERRA, QRO.",1,0,1,0,0,0,
20/06/2022,CD. MÉX.,"TLALPAN, CD. MÉX.",5,1,6,0,0,210,
20/06/2022,CHIH.,"JUÁREZ, CHIH.",3,2,5,6,0,378,
20/06/2022,TLAX.,"TENANCINGO, TLAX.",2,0,2,0,0,0,
20/06/2022,JAL.,"GUADALAJARA, JAL.",0,0,0,0,1,0,
21/06/2022,N.L.,"MONTERREY, N.L.",9,8,17,1,0,517,
21/06/2022,N.L.,"MONTERREY, N.L.",7,2,9,2,0,272,
21/06/2022,CHIH.,"JUÁREZ, CHIH.",6,2,8,9,0,422,
21/06/2022,CD. MÉX.,"BENITO JUAREZ, CD. MÉX.",3,0,3,0,0,4,
21/06/2022,CD. MÉX.,"TLALPAN, CD. MÉX.",3,0,3,0,0,0,
21/06/2022,JAL.,"SAYULA, JAL.",0,3,3,0,0,0,
21/06/2022,JAL.,"GUADALAJARA, JAL.",2,0,2,1,0,43,
21/06/2022,JAL.,"TECALITLAN, JAL.",0,2,2,0,0,19,
21/06/2022,JAL.,"LA BARCA, JAL.",0,2,2,0,0,0,
21/06/2022,S.L.P.,"SAN LUIS POTOSI, S.L.P.",1,0,1,0,0,0,
21/06/2022,TLAX.,"TENANCINGO, TLAX.",1,0,1,0,0,0,
21/06/2022,TLAX.,"CHIAUTEMPAN, TLAX.",1,0,1,0,0,0,
21/06/2022,TLAX.,"SANTA CRUZ TLAX., TLAX.",1,0,1,0,0,0,
22/06/2022,JAL.,"GUADALAJARA, JAL.",12,0,12,4,0,371,
22/06/2022,N.L.,"MONTERREY, N.L.",3,1,4,3,0,196,
22/06/2022,TLAX.,"SANTA CRUZ TLAX., TLAX.",2,1,3,0,0,16,
22/06/2022,CD. MÉX.,"BENITO JUAREZ, CD. MÉX.",0,3,3,0,0,47,
22/06/2022,CD. MÉX.,"TLALPAN, CD. MÉX.",3,0,3,0,0,24,
22/06/2022,CD. MÉX.,"CUAUHTEMOC, CD. MÉX.",0,2,2,0,0,474,
22/06/2022,CHIH.,"JUÁREZ, CHIH.",1,1,2,22,0,184,
22/06/2022,TLAX.,"TENANCINGO, TLAX.",0,1,1,0,0,0,
22/06/2022,TLAX.,"CHIAUTEMPAN, TLAX.",1,0,1,0,0,1030,
23/06/2022,JAL.,"GUADALAJARA, JAL.",8,2,10,8,0,291,
23/06/2022,GRO.,"ATOYAC DE ALVAREZ, GRO.",6,4,10,0,0,0,
23/06/2022,JAL.,"GUADALAJARA, JAL.",5,3,8,1,0,188,
23/06/2022,B.C.,"SAN FELIPE, B.C.",3,5,8,15,0,3253,
23/06/2022,CD. MÉX.,"BENITO JUAREZ, CD. MÉX.",2,0,2,0,0,79,
23/06/2022,GRO.,"JUAN R. ESCUDERO, GRO.",0,2,2,0,0,0,
23/06/2022,CHIH.,"JUÁREZ, CHIH.",1,1,2,0,0,92,
23/06/2022,JAL.,"LA BARCA, JAL.",2,0,2,0,0,0,
23/06/2022,CD. MÉX.,"ALVARO OBREGON, CD. MÉX.",1,0,1,0,0,16,
23/06/2022,CD. MÉX.,"TLALPAN, CD. MÉX.",1,0,1,0,0,278,
23/06/2022,TLAX.,"CHIAUTEMPAN, TLAX.",1,0,1,0,0,0,
23/06/2022,TLAX.,"SANTA CRUZ TLAX., TLAX.",1,0,1,1,0,20,
23/06/2022,B.C.,"SAN QUINTÍN, B.C.",0,0,0,1,0,22,
23/06/2022,N.L.,"MONTERREY, N.L.",0,0,0,4,0,131,
24/06/2022,N.L.,"MONTERREY, N.L.",5,2,7,12,0,776,
24/06/2022,CD. MÉX.,"TLALPAN, CD. MÉX.",1,5,6,0,0,0,
24/06/2022,CD. MÉX.,"BENITO JUAREZ, CD. MÉX.",5,0,5,0,0,218,
24/06/2022,TLAX.,"ZACATELCO, TLAX.",2,0,2,0,0,0,
24/06/2022,CHIH.,"JUÁREZ, CHIH.",1,0,1,6,0,122,
24/06/2022,TLAX.,"SANTA CRUZ TLAX., TLAX.",0,0,0,0,0,3,
25/06/2022,GRO.,"JUAN R. ESCUDERO, GRO.",0,2,2,0,1,0,
25/06/2022,CHIH.,"JUÁREZ, CHIH.",2,0,2,13,0,274,
25/06/2022,TLAX.,"ZACATELCO, TLAX.",1,0,1,0,0,0,
25/06/2022,TLAX.,"CHIAUTEMPAN, TLAX.",1,0,1,0,0,20,
25/06/2022,TLAX.,"SANTA CRUZ TLAX., TLAX.",1,0,1,0,0,5,
25/06/2022,JAL.,"GUADALAJARA, JAL.",0,0,0,0,1,71,
26/06/2022,QRO.,"LANDA DE MATAMOROS, QRO.",1,1,2,0,0,0,
27/06/2022,CD. MÉX.,"TLALPAN, CD. MÉX.",3,2,5,0,0,14,
27/06/2022,JAL.,"ZAPOPAN, JAL.",3,2,5,1,0,78,
27/06/2022,CHIH.,"JUÁREZ, CHIH.",3,0,3,10,0,284,
27/06/2022,JAL.,"OCOTLAN, JAL.",3,0,3,2,0,0,
27/06/2022,TLAX.,"TEOLOCHOLCO, TLAX.",2,0,2,0,0,0,
27/06/2022,TLAX.,"ATLANGATEPEC, TLAX.",1,0,1,0,0,0,
27/06/2022,TLAX.,"SAN PABLO DEL MONTE, TLAX.",0,1,1,0,0,0,
27/06/2022,TAMPS.,"MIGUEL ALEMAN, TAMPS.",1,0,1,1,0,0,
27/06/2022,CD. MÉX.,"ALVARO OBREGON, CD. MÉX.",0,0,0,0,0,132,
27/06/2022,CD. MÉX.,"BENITO JUAREZ, CD. MÉX.",0,0,0,0,0,49,
28/06/2022,S.L.P.,"SAN LUIS POTOSI, S.L.P.",5,0,5,0,0,0,
28/06/2022,CD. MÉX.,"BENITO JUAREZ, CD. MÉX.",3,1,4,0,0,60,
28/06/2022,JAL.,"ZAPOPAN, JAL.",4,0,4,2,0,1126,
28/06/2022,TLAX.,"SAN PABLO DEL MONTE, TLAX.",2,1,3,0,0,0,
28/06/2022,CD. MÉX.,"CUAJIMALPA DE MOR., CD. MÉX.",2,1,3,0,0,0,
28/06/2022,CD. MÉX.,"ALVARO OBREGON, CD. MÉX.",2,0,2,0,0,112,
28/06/2022,CHIH.,"JUÁREZ, CHIH.",0,1,1,0,0,0,
28/06/2022,B.C.,"SAN QUINTÍN, B.C.",0,1,1,11,0,30,
28/06/2022,JAL.,"TECALITLAN, JAL.",0,1,1,0,0,0,
28/06/2022,JAL.,"SAYULA, JAL.",0,0,0,0,0,43,
29/06/2022,CHIH.,"JUÁREZ, CHIH.",9,0,9,26,0,335,
29/06/2022,CD. MÉX.,"ALVARO OBREGON, CD. MÉX.",0,4,4,0,0,0,
29/06/2022,S.L.P.,"SAN LUIS POTOSI, S.L.P.",3,0,3,0,0,0,
29/06/2022,TLAX.,"EMILIANO ZAPATA, TLAX.",1,1,2,0,0,0,
29/06/2022,TLAX.,"SAN PABLO DEL MONTE, TLAX.",0,2,2,0,0,0,
29/06/2022,JAL.,"ZAPOPAN, JAL.",2,0,2,0,0,107,
29/06/2022,CD. MÉX.,"BENITO JUAREZ, CD. MÉX.",2,0,2,0,0,151,
29/06/2022,TLAX.,"ATLANGATEPEC, TLAX.",0,1,1,0,0,0,
29/06/2022,TLAX.,"TEOLOCHOLCO, TLAX.",1,0,1,1,0,155,
29/06/2022,CD. MÉX.,"CUAJIMALPA DE MOR., CD. MÉX.",0,0,0,0,20,0,
30/06/2022,JAL.,"ZAPOTLAN EL GRANDE, JAL.",4,4,8,2,0,73,
30/06/2022,CD. MÉX.,"ALVARO OBREGON, CD. MÉX.",4,2,6,0,0,674,
30/06/2022,CD. MÉX.,"BENITO JUAREZ, CD. MÉX.",3,1,4,0,0,812,
30/06/2022,JAL.,"ZAPOPAN, JAL.",3,0,3,1,0,40,
30/06/2022,CHIH.,"JUÁREZ, CHIH.",1,2,3,0,0,15,
30/06/2022,CD. MÉX.,"CUAJIMALPA DE MOR., CD. MÉX.",1,0,1,0,0,571,
30/06/2022,JAL.,"TECALITLAN, JAL.",0,0,0,1,0,13,
01/07/2022,CD. MÉX.,"ALVARO OBREGON, CD. MÉX.",2,1,3,0,0,405,
01/07/2022,CHIH.,"JUÁREZ, CHIH.",2,1,3,0,0,308,
01/07/2022,JAL.,"ZAPOPAN, JAL.",0,1,1,3,0,649,
01/07/2022,CD. MÉX.,"CUAJIMALPA DE MOR., CD. MÉX.",1,0,1,0,0,0,
01/07/2022,TAMPS.,"MIGUEL ALEMAN, TAMPS.",1,0,1,0,0,0,
01/07/2022,TLAX.,"TEOLOCHOLCO, TLAX.",0,0,0,1,0,0,
02/07/2022,CHIH.,"JUÁREZ, CHIH.",5,0,5,14,0,298,
02/07/2022,TLAX.,"TEOLOCHOLCO, TLAX.",1,0,1,0,0,0,
02/07/2022,TLAX.,,1,0,1,0,0,0,
03/07/2022,S.L.P.,"SAN LUIS POTOSI, S.L.P.",0,0,0,0,3,0,
04/07/2022,CD. MÉX.,"ALVARO OBREGON, CD. MÉX.",2,2,4,0,0,534,
04/07/2022,JAL.,"ZAPOPAN, JAL.",2,2,4,0,1,116,
04/07/2022,SIN.,"SALVADOR ALVARADO, SIN.",3,0,3,0,0,0,
04/07/2022,SIN.,"MOCORITO, SIN.",2,1,3,0,0,0,
04/07/2022,SIN.,"BADIRAGUATO, SIN.",1,1,2,0,1,0,
04/07/2022,CD. MÉX.,"BENITO JUAREZ, CD. MÉX.",1,0,1,0,0,258,
04/07/2022,CD. MÉX.,"CUAJIMALPA DE MOR., CD. MÉX.",1,0,1,0,0,38,
04/07/2022,CHIH.,"JUÁREZ, CHIH.",1,0,1,7,0,345,
04/07/2022,B.C.,"MEXICALI, B.C.",0,0,0,39,0,0,
05/07/2022,JAL.,"TLAQUEPAQUE, JAL.",7,1,8,0,0,21,
05/07/2022,CD. MÉX.,"ALVARO OBREGON, CD. MÉX.",3,2,5,0,0,465,
05/07/2022,TAMPS.,"CIUDAD MADERO, TAMPS.",3,0,3,0,0,18,
05/07/2022,TAMPS.,"VICTORIA, TAMPS.",2,0,2,0,1,0,
05/07/2022,SIN.,"BADIRAGUATO, SIN.",1,1,2,0,1,0,
05/07/2022,JAL.,"SAYULA, JAL.",1,1,2,0,0,91,
05/07/2022,CD. MÉX.,"COYOACAN, CD. MÉX.",0,1,1,0,0,17,
05/07/2022,CD. MÉX.,"MIGUEL HGO., CD. MÉX.",1,0,1,0,0,27,
05/07/2022,SIN.,"MOCORITO, SIN.",1,0,1,0,1,0,
05/07/2022,CHIH.,"JUÁREZ, CHIH.",0,0,0,0,0,77,
06/07/2022,JAL.,"TLAQUEPAQUE, JAL.",4,4,8,5,2,122,
06/07/2022,CD. MÉX.,"MIGUEL HGO., CD. MÉX.",5,0,5,0,6,242,
06/07/2022,DGO.,"DGO., DGO.",4,1,5,1,1,0,
06/07/2022,CHIH.,"JUÁREZ, CHIH.",1,2,3,0,0,31,
06/07/2022,MICH.,"MORELIA, MICH.",3,0,3,0,0,0,
06/07/2022,CD. MÉX.,"COYOACAN, CD. MÉX.",1,0,1,0,0,26,
06/07/2022,CD. MÉX.,"ALVARO OBREGON, CD. MÉX.",1,0,1,0,0,209,
06/07/2022,SIN.,"SALVADOR ALVARADO, SIN.",1,0,1,0,0,0,
06/07/2022,B.C.,"SAN QUINTÍN, B.C.",0,0,0,0,0,140,
06/07/2022,TAMPS.,"CIUDAD MADERO, TAMPS.",0,0,0,0,1,0,
07/07/2022,TAMPS.,"CIUDAD MADERO, TAMPS.",5,1,6,0,0,90,
07/07/2022,DGO.,"DGO., DGO.",4,1,5,1,1,0,
07/07/2022,SIN.,"BADIRAGUATO, SIN.",3,1,4,0,1,0,
07/07/2022,JAL.,"TLAQUEPAQUE, JAL.",2,2,4,3,0,36,
07/07/2022,CD. MÉX.,"COYOACAN, CD. MÉX.",3,0,3,0,0,510,
07/07/2022,TAMPS.,"VICTORIA, TAMPS.",2,0,2,0,0,50,
07/07/2022,JAL.,"TAMAZULA DE GORDIANO, JAL.",1,1,2,0,0,0,
07/07/2022,S.L.P.,"SAN LUIS POTOSI, S.L.P.",2,0,2,0,0,0,
07/07/2022,CD. MÉX.,"MIGUEL HGO., CD. MÉX.",0,1,1,0,0,284,
07/07/2022,B.C.,"SAN QUINTÍN, B.C.",1,0,1,7,0,0,
07/07/2022,SIN.,"SALVADOR ALVARADO, SIN.",1,0,1,0,0,0,
07/07/2022,CHIH.,"JUÁREZ, CHIH.",0,1,1,1,0,0,
07/07/2022,JAL.,"JAMAY, JAL.",0,1,1,0,0,0,
07/07/2022,SIN.,"BADIRAGUATO, SIN.",0,1,1,0,0,0,
07/07/2022,CD. MÉX.,"BENITO JUAREZ, CD. MÉX.",0,0,0,0,0,313,
08/07/2022,DGO.,"DGO., DGO.",11,0,11,0,2,0,
08/07/2022,CHIH.,"JUÁREZ, CHIH.",1,3,4,24,0,116,
08/07/2022,S.L.P.,"SAN LUIS POTOSI, S.L.P.",3,1,4,0,0,0,
08/07/2022,MICH.,"MORELIA, MICH.",0,3,3,0,0,0,
08/07/2022,TAMPS.,"CIUDAD MADERO, TAMPS.",3,0,3,0,0,115,
08/07/2022,DGO.,"SANTIAGO PAPASQUIARO, DGO.",1,1,2,0,0,0,
08/07/2022,JAL.,"TAMAZULA DE GORDIANO, JAL.",1,0,1,0,0,0,
08/07/2022,SIN.,"SALVADOR ALVARADO, SIN.",0,1,1,0,0,7,
08/07/2022,SIN.,"MOCORITO, SIN.",0,1,1,0,0,0,
08/07/2022,CD. MÉX.,"COYOACAN, CD. MÉX.",1,0,1,0,0,0,
08/07/2022,CD. MÉX.,"BENITO JUAREZ, CD. MÉX.",0,1,1,0,0,0,
08/07/2022,CD. MÉX.,"CUAJIMALPA DE MOR., CD. MÉX.",0,1,1,0,0,0,
08/07/2022,SIN.,"BADIRAGUATO, SIN.",0,0,0,0,1,0,
09/07/2022,JAL.,"TAMAZULA DE GORDIANO, JAL.",4,3,7,0,0,0,
09/07/2022,SIN.,"MOCORITO, SIN.",2,1,3,0,0,0,
09/07/2022,DGO.,"GOMEZ PALACIO, DGO.",2,0,2,0,0,0,
09/07/2022,SIN.,"BADIRAGUATO, SIN.",0,2,2,0,0,0,
09/07/2022,CHIH.,"JUÁREZ, CHIH.",0,1,1,1,0,437,
09/07/2022,DGO.,"DGO., DGO.",0,1,1,0,0,0,
09/07/2022,DGO.,"SANTIAGO PAPASQUIARO, DGO.",1,0,1,0,0,0,
09/07/2022,SIN.,"SALVADOR ALVARADO, SIN.",0,1,1,0,0,0,
10/07/2022,B.C.,"TIJUANA, B.C.",0,1,1,0,0,0,
10/07/2022,S.L.P.,"SAN LUIS POTOSI, S.L.P.",0,1,1,0,0,0,
10/07/2022,SIN.,"SALVADOR ALVARADO, SIN.",1,0,1,0,0,0,
10/07/2022,SIN.,"BADIRAGUATO, SIN.",0,0,0,0,1,0,
11/07/2022,TAMPS.,"CIUDAD MADERO, TAMPS.",6,3,9,0,0,0,
11/07/2022,CD. MÉX.,"BENITO JUAREZ, CD. MÉX.",4,4,8,0,0,138,
11/07/2022,VER.,"TUXPAM, VER.",3,2,5,0,0,76,
11/07/2022,CD. MÉX.,"COYOACAN, CD. MÉX.",3,0,3,0,0,0,
11/07/2022,CHIH.,"JUÁREZ, CHIH.",3,0,3,11,0,139,
11/07/2022,TAMPS.,"VICTORIA, TAMPS.",3,0,3,0,0,0,
11/07/2022,SIN.,"MOCORITO, SIN.",0,1,1,0,0,0,
11/07/2022,SIN.,"BADIRAGUATO, SIN.",0,1,1,0,0,0,
11/07/2022,JAL.,"TLAQUEPAQUE, JAL.",0,1,1,0,0,103,
12/07/2022,CHIH.,"JUÁREZ, CHIH.",6,1,7,4,0,284,
12/07/2022,VER.,"VER., VER.",5,2,7,8,0,3726,
12/07/2022,CD. MÉX.,"BENITO JUAREZ, CD. MÉX.",5,1,6,0,0,69,
12/07/2022,MICH.,"MORELIA, MICH.",3,3,6,0,0,42,
12/07/2022,JAL.,"TLAQUEPAQUE, JAL.",2,2,4,4,2,46,
12/07/2022,TAMPS.,"CIUDAD MADERO, TAMPS.",2,1,3,0,0,38,
12/07/2022,CD. MÉX.,"MIGUEL HGO., CD. MÉX.",2,0,2,0,0,284,
12/07/2022,CD. MÉX.,"AZCAPOTZALCO, CD. MÉX.",2,0,2,0,0,120,
12/07/2022,SIN.,"MOCORITO, SIN.",2,0,2,0,0,0,
12/07/2022,VER.,"TUXPAM, VER.",1,0,1,0,0,179,
12/07/2022,CD. MÉX.,"COYOACAN, CD. MÉX.",1,0,1,0,0,10,
12/07/2022,SIN.,"BADIRAGUATO, SIN.",1,0,1,0,0,0,
12/07/2022,S.L.P.,"SAN LUIS POTOSI, S.L.P.",1,0,1,0,0,0,
12/07/2022,TAMPS.,"VICTORIA, TAMPS.",1,0,1,0,1,0,
13/07/2022,CD. MÉX.,"MIGUEL HGO., CD. MÉX.",5,0,5,0,0,109,
13/07/2022,SIN.,"BADIRAGUATO, SIN.",2,2,4,0,0,0,
13/07/2022,CHIH.,"JUÁREZ, CHIH.",2,1,3,31,0,432,
13/07/2022,TAMPS.,"CIUDAD MADERO, TAMPS.",3,0,3,0,1,29,
13/07/2022,SIN.,"SALVADOR ALVARADO, SIN.",2,0,2,0,1,0,
13/07/2022,VER.,"VER., VER.",1,1,2,0,0,1758,
13/07/2022,CD. MÉX.,"COYOACAN, CD. MÉX.",2,0,2,0,0,0,
13/07/2022,S.L.P.,"SAN LUIS POTOSI, S.L.P.",1,0,1,0,0,0,
13/07/2022,VER.,"TUXPAM, VER.",1,0,1,0,1,140,
14/07/2022,GRO.,"TECPAN DE GALEANA, GRO.",5,3,8,0,0,0,
14/07/2022,CHIH.,"JUÁREZ, CHIH.",2,2,4,3,0,197,
14/07/2022,CD. MÉX.,"BENITO JUAREZ, CD. MÉX.",3,0,3,0,0,11,
14/07/2022,TAMPS.,"CIUDAD MADERO, TAMPS.",3,0,3,1,0,14,
14/07/2022,CD. MÉX.,"BENITO JUAREZ, CD. MÉX.",2,0,2,0,0,120,
14/07/2022,CD. MÉX.,"AZCAPOTZALCO, CD. MÉX.",2,0,2,0,0,0,
14/07/2022,JAL.,"JAMAY, JAL.",2,0,2,0,0,0,
14/07/2022,CD. MÉX.,"BENITO JUAREZ, CD. MÉX.",0,1,1,0,0,525,
14/07/2022,SIN.,"SALVADOR ALVARADO, SIN.",0,1,1,0,0,0,
14/07/2022,JAL.,"TLAQUEPAQUE, JAL.",0,1,1,0,2,381,
14/07/2022,VER.,"TUXPAM, VER.",1,0,1,0,1,140,
14/07/2022,VER.,"VER., VER.",1,0,1,0,0,844,
14/07/2022,JAL.,"TECALITLAN, JAL.",1,0,1,0,0,0,
15/07/2022,CD. MÉX.,"BENITO JUAREZ, CD. MÉX.",8,2,10,0,0,775,
15/07/2022,CHIH.,"JUÁREZ, CHIH.",7,3,10,7,0,442,
15/07/2022,VER.,"VER., VER.",3,1,4,3,0,39,
15/07/2022,JAL.,"TLAQUEPAQUE, JAL.",1,2,3,4,2,367,
15/07/2022,CD. MÉX.,"AZCAPOTZALCO, CD. MÉX.",1,1,2,0,0,6,
15/07/2022,VER.,"TUXPAM, VER.",2,0,2,0,0,169,
15/07/2022,SIN.,"SALVADOR ALVARADO, SIN.",1,0,1,0,0,100,
15/07/2022,SIN.,"MOCORITO, SIN.",1,0,1,0,0,0,
15/07/2022,S.L.P.,"SAN LUIS POTOSI, S.L.P.",1,0,1,0,5,0,
15/07/2022,VER.,"TUXPAM, VER.",1,0,1,0,1,140,
15/07/2022,TAMPS.,"CIUDAD MADERO, TAMPS.",0,0,0,10,0,73,
16/07/2022,VER.,"VER., VER.",4,0,4,8,0,0,
16/07/2022,SIN.,"BADIRAGUATO, SIN.",0,1,1,0,0,0,
16/07/2022,VER.,"TUXPAM, VER.",0,0,0,0,0,430,
17/07/2022,VER.,"VER., VER.",3,0,3,0,0,164,
17/07/2022,SIN.,"MOCORITO, SIN.",2,0,2,0,0,0,
17/07/2022,SIN.,"SALVADOR ALVARADO, SIN.",1,0,1,0,2,0,
17/07/2022,VER.,"TUXPAM, VER.",0,0,0,0,0,449,
18/07/2022,CD. MÉX.,"AZCAPOTZALCO, CD. MÉX.",1,1,2,0,0,0,
18/07/2022,TAMPS.,"CIUDAD MADERO, TAMPS.",1,1,2,0,0,0,
18/07/2022,VER.,"TUXPAM, VER.",1,0,1,0,0,205,
18/07/2022,JAL.,"TLAQUEPAQUE, JAL.",0,0,0,0,0,86,
19/07/2022,JAL.,"TLAQUEPAQUE, JAL.",0,0,0,0,0,14,
20/07/2022,JAL.,"TLAQUEPAQUE, JAL.",4,2,6,0,0,58,
20/07/2022,VER.,"VER., VER.",4,0,4,7,3,447,
20/07/2022,TAMPS.,"CIUDAD MADERO, TAMPS.",4,0,4,0,0,110,
20/07/2022,COL.,"TECOMÁN, COL.",0,2,2,0,0,0,
20/07/2022,CD. MÉX.,"BENITO JUAREZ, CD. MÉX.",2,0,2,0,0,25,
20/07/2022,CD. MÉX.,"BENITO JUAREZ, CD. MÉX.",2,0,2,0,0,0,
20/07/2022,CD. MÉX.,"AZCAPOTZALCO, CD. MÉX.",2,0,2,0,0,0,
20/07/2022,VER.,"TUXPAM, VER.",0,0,0,3,0,293,
20/07/2022,MICH.,"MORELIA, MICH.",0,0,0,0,0,1085,
21/07/2022,VER.,"VER., VER.",2,9,11,0,0,0,
21/07/2022,CD. MÉX.,"BENITO JUAREZ, CD. MÉX.",2,3,5,0,0,7,
21/07/2022,TAMPS.,"CIUDAD MADERO, TAMPS.",4,0,4,0,0,268,
21/07/2022,CD. MÉX.,"AZCAPOTZALCO, CD. MÉX.",2,0,2,0,0,8,
21/07/2022,VER.,"TUXPAM, VER.",2,0,2,3,0,540,
21/07/2022,JAL.,"TONALA, JAL.",0,1,1,8,3,201,
21/07/2022,COL.,"TECOMÁN, COL.",1,0,1,0,0,0,
22/07/2022,CD. MÉX.,"BENITO JUAREZ, CD. MÉX.",2,3,5,0,0,8,
22/07/2022,JAL.,"TONALA, JAL.",4,0,4,8,0,215,
22/07/2022,MICH.,"MORELIA, MICH.",2,0,2,0,0,0,
22/07/2022,CD. MÉX.,"AZCAPOTZALCO, CD. MÉX.",1,0,1,0,22,59,
22/07/2022,TAMPS.,"EL MANTE, TAMPS.",1,0,1,0,0,0,
22/07/2022,VER.,"TUXPAM, VER.",0,0,0,6,0,569,
23/07/2022,VER.,"VER., VER.",3,0,3,0,0,176,
23/07/2022,VER.,"TUXPAM, VER.",2,0,2,16,0,0,
24/07/2022,QRO.,"ARROYO SECO, QRO.",2,0,2,0,0,6,
24/07/2022,VER.,"TUXPAM, VER.",1,0,1,5,0,168,
24/07/2022,VER.,"VER., VER.",1,0,1,8,0,141,
25/07/2022,CD. MÉX.,"BENITO JUAREZ, CD. MÉX.",7,0,7,0,0,347,
25/07/2022,CD. MÉX.,"AZCAPOTZALCO, CD. MÉX.",2,0,2,0,0,444,
25/07/2022,CHIS.,"LA TRINITARIA, CHIS.",1,0,1,0,0,16,
25/07/2022,VER.,"TUXPAM, VER.",0,1,1,8,0,476,
25/07/2022,B.C.,"SAN FELIPE, B.C.",1,0,1,0,0,4,
25/07/2022,VER.,"VER., VER.",0,0,0,0,0,269,
26/07/2022,CD. MÉX.,"BENITO JUAREZ, CD. MÉX.",6,3,9,0,1,1,
26/07/2022,B.C.S.,"LA PAZ, B.C.S.",1,0,1,0,0,252,
27/07/2022,CD. MÉX.,"BENITO JUAREZ, CD. MÉX.",1,2,3,0,30,0,
27/07/2022,B.C.S.,"LA PAZ, B.C.S.",1,0,1,0,0,2,
27/07/2022,JAL.,"TONALA, JAL.",1,0,1,2,0,9,
27/07/2022,PUE.,"ATLIXCO, PUE.",0,0,0,2,1,18,
28/07/2022,PUE.,"ATLIXCO, PUE.",2,1,3,0,1,0,
28/07/2022,JAL.,"ZAPOTLANEJO, JAL.",1,0,1,1,0,90,
29/07/2022,TAMPS.,"CIUDAD MADERO, TAMPS.",4,0,4,0,0,54,
29/07/2022,CD. MÉX.,"BENITO JUAREZ, CD. MÉX.",2,1,3,0,28,141,
29/07/2022,JAL.,"ZAPOTLANEJO, JAL.",1,0,1,0,0,0,
29/07/2022,CHIS.,"TECPATÁN, CHIS.",1,0,1,52,0,0,
30/07/2022,B.C.,"SAN FELIPE, B.C.",1,0,1,0,0,0,
30/07/2022,CHIS.,"LA TRINITARIA, CHIS.",0,0,0,17,0,0,
31/07/2022,QRO.,"QUERETARO, QRO.",1,0,1,0,2,0,
01/08/2022,CD. MÉX.,"BENITO JUAREZ, CD. MÉX.",2,1,3,0,0,639,
01/08/2022,CHIS.,"CHIAPA DE CORZO, CHIS.",2,0,2,0,0,0,
01/08/2022,CHIS.,"BERRIOZÁBAL, CHIS.",2,0,2,0,0,0,
01/08/2022,CHIS.,"LA TRINITARIA, CHIS.",1,0,1,51,0,0,
02/08/2022,CD. MÉX.,"BENITO JUAREZ, CD. MÉX.",4,0,4,0,0,172,
02/08/2022,PUE.,"ATLIXCO, PUE.",4,0,4,0,0,0,
02/08/2022,TAMPS.,"ALTAMIRA, TAMPS.",1,1,2,0,0,0,
02/08/2022,CD. MÉX.,"COYOACAN, CD. MÉX.",1,0,1,0,0,22,
02/08/2022,COAH.,"MONCLOVA, COAH.",1,0,1,0,0,270,
02/08/2022,TAB.,"CARDENAS, TAB.",1,0,1,0,0,32,
02/08/2022,CHIS.,"CHIAPA DE CORZO, CHIS.",0,0,0,0,0,150,
02/08/2022,CHIS.,"TAPACHULA, CHIS.",0,0,0,0,1,0,
03/08/2022,COAH.,"FRONTERA, COAH.",1,1,2,0,0,0,
03/08/2022,CD. MÉX.,"BENITO JUAREZ, CD. MÉX.",2,0,2,0,0,0,
03/08/2022,TAMPS.,"ALTAMIRA, TAMPS.",2,0,2,0,0,6,
03/08/2022,CD. MÉX.,"COYOACAN, CD. MÉX.",1,0,1,0,0,101,
03/08/2022,CHIS.,"CHENALHÓ, CHIS.",0,1,1,0,0,0,
03/08/2022,TAB.,"CARDENAS, TAB.",0,0,0,0,0,149,
03/08/2022,CHIS.,"TAPACHULA, CHIS.",0,0,0,0,1,290,
03/08/2022,CHIS.,"FRONTERA COMALAPA, CHIS.",0,0,0,30,0,0,
04/08/2022,COAH.,"MONCLOVA, COAH.",1,2,3,0,0,0,
04/08/2022,CD. MÉX.,"COYOACAN, CD. MÉX.",0,2,2,0,0,0,
04/08/2022,TAMPS.,"VICTORIA, TAMPS.",2,0,2,0,0,0,
04/08/2022,CD. MÉX.,"BENITO JUAREZ, CD. MÉX.",1,0,1,0,0,126,
04/08/2022,TAMPS.,"ALTAMIRA, TAMPS.",1,0,1,0,0,0,
04/08/2022,JAL.,"ZAPOTLANEJO, JAL.",0,0,0,0,0,37,
04/08/2022,CHIS.,"TAPACHULA, CHIS.",0,0,0,0,0,485,
04/08/2022,COAH.,"FRONTERA, COAH.",0,0,0,0,0,22,
05/08/2022,CD. MÉX.,"BENITO JUAREZ, CD. MÉX.",4,0,4,0,1,242,
05/08/2022,CHIS.,"CHIAPA DE CORZO, CHIS.",1,1,2,0,0,534,
05/08/2022,COAH.,"MONCLOVA, COAH.",2,0,2,0,0,0,
05/08/2022,COAH.,"FRONTERA, COAH.",2,0,2,0,0,0,
05/08/2022,COAH.,"CUATROCIÉNEGAS, COAH.",2,0,2,0,0,0,
05/08/2022,TAB.,"CARDENAS, TAB.",1,0,1,0,0,191,
05/08/2022,CHIS.,"TAPACHULA, CHIS.",0,1,1,4,0,608,
05/08/2022,CHIS.,"TONALÁ, CHIS.",1,0,1,0,0,99,
05/08/2022,CHIS.,"CINTALAPA, CHIS.",1,0,1,0,0,0,
05/08/2022,CD. MÉX.,"ALVARO OBREGON, CD. MÉX.",0,0,0,0,2,1675,
05/08/2022,CD. MÉX.,"COYOACAN, CD. MÉX.",0,0,0,0,0,20,
05/08/2022,TAMPS.,"ALTAMIRA, TAMPS.",0,0,0,0,0,34,
05/08/2022,CHIS.,"FRONTERA COMALAPA, CHIS.",0,0,0,1,0,64,
06/08/2022,CHIS.,"TAPACHULA, CHIS.",2,1,3,0,0,797,
06/08/2022,CHIS.,"LA TRINITARIA, CHIS.",0,2,2,2,1,486,
07/08/2022,QRO.,"QUERETARO, QRO.",0,3,3,0,2,0,
07/08/2022,CHIS.,"LA TRINITARIA, CHIS.",0,2,2,0,0,207,
07/08/2022,PUE.,"ATLIXCO, PUE.",1,0,1,0,0,0,
08/08/2022,COAH.,"ARTEAGA, COAH.",2,3,5,0,0,39,
08/08/2022,CHIS.,"TUXTLA GUTIÉRREZ, CHIS.",1,3,4,0,0,1369,
08/08/2022,CD. MÉX.,"ALVARO OBREGON, CD. MÉX.",3,0,3,0,0,143,
08/08/2022,COAH.,"FRONTERA, COAH.",2,1,3,0,0,0,
08/08/2022,COAH.,"MONCLOVA, COAH.",1,1,2,0,0,0,
08/08/2022,S.L.P.,"SAN LUIS POTOSI, S.L.P.",1,0,1,0,0,0,
08/08/2022,CHIS.,"CINTALAPA, CHIS.",1,0,1,0,0,0,
08/08/2022,CHIS.,"CHENALHÓ, CHIS.",1,0,1,0,0,0,
08/08/2022,CD. MÉX.,"BENITO JUAREZ, CD. MÉX.",0,0,0,0,0,28,
08/08/2022,CHIS.,"TAPACHULA, CHIS.",0,0,0,0,0,110,
08/08/2022,CHIS.,"TONALÁ, CHIS.",0,0,0,0,0,20,
08/08/2022,TAB.,"TENOSIQUE, TAB.",0,0,0,0,0,52,
09/08/2022,COAH.,"ARTEAGA, COAH.",4,1,5,0,0,4,
09/08/2022,CD. MÉX.,"BENITO JUAREZ, CD. MÉX.",3,1,4,0,0,286,
09/08/2022,CD. MÉX.,"GUSTAVO A. MADERO, CD. MÉX.",3,0,3,0,1,213,
09/08/2022,CD. MÉX.,"COYOACAN, CD. MÉX.",1,1,2,0,0,0,
09/08/2022,CHIS.,"TAPACHULA, CHIS.",1,1,2,2,0,152,
09/08/2022,COAH.,"MONCLOVA, COAH.",1,0,1,0,0,7,
09/08/2022,TAB.,"CARDENAS, TAB.",0,1,1,0,0,0,
09/08/2022,CHIS.,"BERRIOZÁBAL, CHIS.",0,1,1,0,0,752,
09/08/2022,COAH.,"FRONTERA, COAH.",0,0,0,0,0,27,
09/08/2022,CHIS.,"TONALÁ, CHIS.",0,0,0,0,0,30,
09/08/2022,CHIS.,"CINTALAPA, CHIS.",0,0,0,0,0,30,
10/08/2022,GRO.,"ACAPULCO DE JUAREZ, GRO.",1,5,6,0,0,1,
10/08/2022,CD. MÉX.,"GUSTAVO A. MADERO, CD. MÉX.",1,2,3,0,12,421,
10/08/2022,CD. MÉX.,"BENITO JUAREZ, CD. MÉX.",2,0,2,0,0,50,
10/08/2022,CHIS.,"BERRIOZÁBAL, CHIS.",2,0,2,2,0,285,
10/08/2022,CHIS.,"YAJALÓN, CHIS.",1,1,2,0,0,58,
10/08/2022,COAH.,"ARTEAGA, COAH.",1,0,1,0,0,0,
10/08/2022,CD. MÉX.,"COYOACAN, CD. MÉX.",1,0,1,0,0,0,
10/08/2022,TAMPS.,"VICTORIA, TAMPS.",1,0,1,0,0,0,
10/08/2022,TAB.,"CARDENAS, TAB.",0,1,1,0,0,0,
10/08/2022,CHIS.,"LA TRINITARIA, CHIS.",0,1,1,2,0,80,
10/08/2022,TAB.,"CARDENAS, TAB.",1,0,1,0,0,191,
10/08/2022,TAMPS.,"REYNOSA, TAMPS.",0,1,1,0,0,0,
10/08/2022,COAH.,"FRONTERA, COAH.",0,0,0,1,0,47,
10/08/2022,TAMPS.,"ALTAMIRA, TAMPS.",0,0,0,1,1,39,
10/08/2022,CHIS.,"TAPACHULA, CHIS.",0,0,0,0,0,378,
10/08/2022,CHIS.,"TONALÁ, CHIS.",0,0,0,0,0,22,
10/08/2022,CHIS.,"CINTALAPA, CHIS.",0,0,0,0,0,51,
11/08/2022,COAH.,"ARTEAGA, COAH.",5,3,8,0,0,0,
11/08/2022,CHIS.,"PALENQUE, CHIS.",3,0,3,0,0,0,
11/08/2022,CD. MÉX.,"GUSTAVO A. MADERO, CD. MÉX.",1,1,2,0,0,0,
11/08/2022,CHIS.,"BERRIOZÁBAL, CHIS.",1,1,2,0,0,0,
11/08/2022,GRO.,"ACAPULCO DE JUAREZ, GRO.",1,1,2,14,4,355,
11/08/2022,CD. MÉX.,"ALVARO OBREGON, CD. MÉX.",1,0,1,0,0,0,
11/08/2022,CD. MÉX.,"COYOACAN, CD. MÉX.",1,0,1,0,0,0,
11/08/2022,CD. MÉX.,"BENITO JUAREZ, CD. MÉX.",1,0,1,0,0,0,
11/08/2022,TAB.,"CENTRO, TAB.",1,0,1,0,0,0,
11/08/2022,CHIS.,"OSUMACINTA, CHIS.",0,1,1,0,0,169,
11/08/2022,CHIS.,"TAPACHULA, CHIS.",1,0,1,0,0,450,
11/08/2022,CHIS.,"YAJALÓN, CHIS.",0,1,1,0,0,4,
11/08/2022,TAMPS.,"VICTORIA, TAMPS.",1,0,1,0,0,0,
11/08/2022,TAMPS.,"ALTAMIRA, TAMPS.",1,0,1,1,0,47,
11/08/2022,TAMPS.,"REYNOSA, TAMPS.",0,1,1,1,0,70,
11/08/2022,COAH.,"FRONTERA, COAH.",0,0,0,0,0,29,
11/08/2022,CHIS.,"CINTALAPA, CHIS.",0,0,0,0,0,56,
11/08/2022,CHIS.,"LA TRINITARIA, CHIS.",0,0,0,0,0,53,
12/08/2022,GRO.,"ACAPULCO DE JUAREZ, GRO.",4,1,5,22,1,2462,
12/08/2022,CD. MÉX.,"CUAUHTEMOC, CD. MÉX.",4,0,4,0,0,2,
12/08/2022,TAMPS.,"REYNOSA, TAMPS.",2,0,2,1,0,70,
12/08/2022,CHIS.,"TONALÁ, CHIS.",1,0,1,0,0,0,
12/08/2022,CD. MÉX.,"ALVARO OBREGON, CD. MÉX.",1,0,1,0,0,0,
12/08/2022,COAH.,"FRONTERA, COAH.",1,0,1,2,0,190,
12/08/2022,COAH.,"ARTEAGA, COAH.",0,1,1,0,0,303,
12/08/2022,PUE.,"TEHUACAN, PUE.",0,0,0,0,1,140,
12/08/2022,CHIS.,"BERRIOZÁBAL, CHIS.",0,0,0,0,0,365,
12/08/2022,CHIS.,"OSUMACINTA, CHIS.",0,0,0,0,0,79,
12/08/2022,CHIS.,"TAPACHULA, CHIS.",0,0,0,0,0,121,
12/08/2022,TAB.,"TENOSIQUE, TAB.",0,0,0,0,0,52,
12/08/2022,CHIS.,"LA TRINITARIA, CHIS.",0,0,0,0,0,113,
12/08/2022,TAMPS.,"ALTAMIRA, TAMPS.",0,0,0,0,0,25,
13/08/2022,QRO.,"PEDRO ESCOBEDO, QRO.",1,1,2,0,0,0,
13/08/2022,GRO.,"ACAPULCO DE JUAREZ, GRO.",2,0,2,66,1,515,
13/08/2022,CHIS.,"OSUMACINTA, CHIS.",0,0,0,0,0,24,
13/08/2022,CHIS.,"TAPACHULA, CHIS.",0,0,0,0,0,264,
13/08/2022,CHIS.,"TONALÁ, CHIS.",0,0,0,0,0,10,
13/08/2022,CHIS.,"CINTALAPA, CHIS.",0,0,0,0,0,432,
13/08/2022,CHIS.,"LA TRINITARIA, CHIS.",0,0,0,0,0,484,
14/08/2022,CHIS.,"TONALÁ, CHIS.",0,0,0,0,0,10,
14/08/2022,CHIS.,"TONALÁ, CHIS.",0,0,0,2,0,55,
15/08/2022,SIN.,"SIN., SIN.",5,0,5,0,1,0,
15/08/2022,COAH.,"ARTEAGA, COAH.",2,2,4,0,0,0,
15/08/2022,TAMPS.,"REYNOSA, TAMPS.",2,0,2,6,0,57,
15/08/2022,CD. MÉX.,"COYOACAN, CD. MÉX.",1,0,1,0,0,25,
15/08/2022,CD. MÉX.,"GUSTAVO A. MADERO, CD. MÉX.",0,1,1,0,0,213,
15/08/2022,QRO.,"LANDA DE MATAMOROS, QRO.",1,0,1,0,0,0,
15/08/2022,PUE.,"TEHUACAN, PUE.",0,1,1,0,0,0,
15/08/2022,CD. MÉX.,"ALVARO OBREGON, CD. MÉX.",0,0,0,0,12,0,
15/08/2022,QRO.,"QUERETARO, QRO.",0,0,0,0,1,0,
15/08/2022,CHIS.,"TONALÁ, CHIS.",0,0,0,0,0,14,
15/08/2022,CHIS.,"LAS MARGARITAS, CHIS.",0,0,0,0,4,0,
15/08/2022,PUE.,"ATLIXCO, PUE.",0,0,0,1,0,132,
16/08/2022,TAMPS.,"REYNOSA, TAMPS.",0,3,3,0,0,155,
16/08/2022,SIN.,"SIN., SIN.",2,0,2,0,0,87,
16/08/2022,DGO.,"DGO., DGO.",1,0,1,0,0,13,
16/08/2022,DGO.,"GOMEZ PALACIO, DGO.",1,0,1,0,0,0,
16/08/2022,CD. MÉX.,"GUSTAVO A. MADERO, CD. MÉX.",1,0,1,0,0,0,
16/08/2022,COAH.,"MONCLOVA, COAH.",1,0,1,1,0,0,
16/08/2022,SIN.,"SIN., SIN.",1,0,1,0,0,0,
16/08/2022,TAMPS.,"VICTORIA, TAMPS.",1,0,1,0,0,0,
16/08/2022,TAMPS.,"ALTAMIRA, TAMPS.",1,0,1,0,0,0,
16/08/2022,CHIS.,"TONALÁ, CHIS.",0,0,0,0,0,15,
16/08/2022,CHIS.,"JIQUIPILAS, CHIS.",0,0,0,1,0,4,
16/08/2022,CD. MÉX.,"IZTACALCO, CD. MÉX.",0,0,0,0,0,68,
16/08/2022,COAH.,"RAMOS ARIZPE, COAH.",0,0,0,9,0,0,
16/08/2022,COAH.,"TORREÓN, COAH.",0,0,0,0,0,44,
16/08/2022,CHIS.,"JIQUIPILAS, CHIS.",0,0,0,1,0,4,
16/08/2022,COAH.,"RAMOS ARIZPE, COAH.",0,0,0,9,0,0,
17/08/2022,SIN.,"SIN., SIN.",3,1,4,0,0,50,
17/08/2022,TAMPS.,"REYNOSA, TAMPS.",3,1,4,8,0,164,
17/08/2022,SIN.,"SIN., SIN.",3,0,3,0,0,0,
17/08/2022,PUE.,"TEHUACAN, PUE.",2,0,2,0,0,41,
17/08/2022,COAH.,"MONCLOVA, COAH.",0,2,2,1,0,0,
17/08/2022,CD. MÉX.,"IZTACALCO, CD. MÉX.",1,0,1,0,0,9,
17/08/2022,CHIS.,"BERRIOZÁBAL, CHIS.",1,0,1,0,0,424,
17/08/2022,TAMPS.,"VICTORIA, TAMPS.",1,0,1,0,0,0,
17/08/2022,CD. MÉX.,"ALVARO OBREGON, CD. MÉX.",0,0,0,0,0,110,
17/08/2022,COAH.,"RAMOS ARIZPE, COAH.",0,0,0,0,0,39,
17/08/2022,COAH.,"TORREÓN, COAH.",0,0,0,0,0,19,
17/08/2022,CHIS.,"TONALÁ, CHIS.",0,0,0,1,0,3,
17/08/2022,CHIS.,"LAS MARGARITAS, CHIS.",0,0,0,0,4,126,
18/08/2022,COAH.,"TORREÓN, COAH.",2,5,7,0,0,249,
18/08/2022,CD. MÉX.,"CUAUHTEMOC, CD. MÉX.",2,1,3,0,0,0,
18/08/2022,CHIS.,"BERRIOZÁBAL, CHIS.",2,1,3,0,0,185,
18/08/2022,SIN.,"SIN., SIN.",1,1,2,0,0,0,
18/08/2022,DGO.,"DGO., DGO.",2,0,2,0,0,0,
18/08/2022,DGO.,"GOMEZ PALACIO, DGO.",2,0,2,0,0,0,
18/08/2022,QRO.,"PINAL DE AMOLES, QRO.",2,0,2,0,0,5,
18/08/2022,TAMPS.,"REYNOSA, TAMPS.",0,2,2,0,0,0,
18/08/2022,COAH.,"FRONTERA, COAH.",1,0,1,3,0,2,
18/08/2022,COAH.,"RAMOS ARIZPE, COAH.",1,0,1,3,0,19,
18/08/2022,CHIS.,"SAN FERNANDO, CHIS.",0,0,0,2,0,277,
18/08/2022,CD. MÉX.,"IZTACALCO, CD. MÉX.",0,0,0,0,6,12,
18/08/2022,CHIS.,"SAN FERNANDO, CHIS.",0,0,0,0,0,277,
18/08/2022,CHIS.,"TAPACHULA, CHIS.",0,0,0,0,0,168,
18/08/2022,CHIS.,"TONALÁ, CHIS.",0,0,0,0,0,13,
18/08/2022,CHIS.,"JIQUIPILAS, CHIS.",0,0,0,0,0,54,
18/08/2022,CHIS.,"LAS MARGARITAS, CHIS.",0,0,0,1,1,19,
19/08/2022,COAH.,"RAMOS ARIZPE, COAH.",2,0,2,23,0,488,
19/08/2022,DGO.,"GOMEZ PALACIO, DGO.",1,1,2,0,0,0,
19/08/2022,DGO.,"CUENCAME, DGO.",2,0,2,0,0,0,
19/08/2022,QRO.,"PEDRO ESCOBEDO, QRO.",1,1,2,0,0,0,
19/08/2022,PUE.,"TEHUACAN, PUE.",2,0,2,0,0,0,
19/08/2022,TAMPS.,"REYNOSA, TAMPS.",1,1,2,4,0,0,
19/08/2022,CD. MÉX.,"IZTACALCO, CD. MÉX.",1,0,1,0,0,144,
19/08/2022,CD. MÉX.,"GUSTAVO A. MADERO, CD. MÉX.",1,0,1,0,0,0,
19/08/2022,COAH.,"TORREÓN, COAH.",1,0,1,0,0,84,
19/08/2022,SIN.,"SIN., SIN.",0,1,1,0,1,0,
19/08/2022,DGO.,"DGO., DGO.",1,0,1,0,0,0,
19/08/2022,DGO.,"GOMEZ PALACIO, DGO.",1,0,1,0,0,0,
19/08/2022,CHIS.,"BERRIOZÁBAL, CHIS.",0,1,1,2,0,266,
19/08/2022,TAMPS.,"ALTAMIRA, TAMPS.",1,0,1,0,0,144,
19/08/2022,COAH.,"FRONTERA, COAH.",0,0,0,3,0,66,
19/08/2022,VER.,"TUXPAM, VER.",0,0,0,1,0,377,
19/08/2022,CHIS.,"SAN FERNANDO, CHIS.",0,0,0,0,1,508,
19/08/2022,TAB.,"TENOSIQUE, TAB.",0,0,0,0,0,137,
19/08/2022,CHIS.,"TONALÁ, CHIS.",0,0,0,0,0,10,
19/08/2022,CHIS.,"LAS MARGARITAS, CHIS.",0,0,0,0,0,29,
20/08/2022,SIN.,"ESCUINAPA, SIN.",1,1,2,0,0,0,
20/08/2022,SIN.,"SIN., SIN.",1,0,1,0,0,0,
20/08/2022,CHIS.,"TAPACHULA, CHIS.",1,0,1,0,0,100,
20/08/2022,CHIS.,"JIQUIPILAS, CHIS.",0,1,1,0,0,55,
20/08/2022,B.C.,"SAN FELIPE, B.C.",1,0,1,0,0,0,
20/08/2022,CHIS.,"SAN CRISTOBAL DE LAS CASAS, CHIS.",0,0,0,0,0,307,
20/08/2022,CHIS.,"TONALÁ, CHIS.",0,0,0,0,0,12,
21/08/2022,QRO.,"AMEALCO DE BONFIL, QRO.",1,3,4,0,0,0,
22/08/2022,COAH.,"SALTILLO, COAH.",6,1,7,2,0,214,
22/08/2022,COAH.,"PIEDRAS NEGRAS, COAH.",3,1,4,0,0,0,
22/08/2022,CD. MÉX.,"GUSTAVO A. MADERO, CD. MÉX.",2,1,3,0,0,2356,
22/08/2022,CD. MÉX.,"IZTACALCO, CD. MÉX.",0,2,2,0,0,0,
22/08/2022,CD. MÉX.,"CUAUHTEMOC, CD. MÉX.",2,0,2,0,0,6,
22/08/2022,SIN.,"ESCUINAPA, SIN.",1,1,2,0,0,0,
22/08/2022,SIN.,"SIN., SIN.",2,0,2,0,0,0,
22/08/2022,N.L.,"APODACA, N.L.",1,0,1,0,0,0,
22/08/2022,MÉX.,"AMECAMECA, MEX.",1,0,1,0,3,19,
22/08/2022,MÉX.,"CHIMALHUACAN, MEX.",1,0,1,0,0,0,
22/08/2022,COAH.,"ACUÑA, COAH.",0,1,1,0,0,0,
22/08/2022,COAH.,"MATAMOROS, COAH.",1,0,1,0,0,0,
22/08/2022,COAH.,"MONCLOVA, COAH.",0,0,0,1,0,16,
22/08/2022,CHIS.,"TONALÁ, CHIS.",0,0,0,0,0,13,
22/08/2022,CHIS.,"SUCHIATE, CHIS.",0,0,0,0,0,63,
22/08/2022,TAB.,"TENOSIQUE, TAB.",0,0,0,0,0,45,
22/08/2022,CHIS.,"FRONTERA COMALAPA, CHIS.",0,0,0,2,0,248,
23/08/2022,MÉX.,"CHIMALHUACAN, MEX.",9,0,9,0,0,26,
23/08/2022,N.L.,"APODACA, N.L.",3,1,4,1,0,68,
23/08/2022,COAH.,"SABINAS, COAH.",1,3,4,0,0,51,
23/08/2022,CD. MÉX.,"IZTACALCO, CD. MÉX.",3,0,3,0,0,392,
23/08/2022,COAH.,"FRONTERA, COAH.",3,0,3,0,0,0,
23/08/2022,COAH.,"SALTILLO, COAH.",2,1,3,1,0,51,
23/08/2022,MÉX.,"AMECAMECA, MEX.",2,1,3,0,0,184,
23/08/2022,COAH.,"PIEDRAS NEGRAS, COAH.",1,2,3,6,0,646,
23/08/2022,DGO.,"GOMEZ PALACIO, DGO.",0,2,2,0,0,0,
23/08/2022,SIN.,"ESCUINAPA, SIN.",1,0,1,0,0,0,
23/08/2022,SIN.,"ROSARIO, SIN.",1,0,1,0,0,0,
23/08/2022,TAMPS.,"VICTORIA, TAMPS.",1,0,1,0,0,0,
23/08/2022,COAH.,"ACUÑA, COAH.",1,0,1,2,0,0,
23/08/2022,COAH.,"TORREÓN, COAH.",0,0,0,0,0,175,
23/08/2022,DGO.,"DGO., DGO.",0,0,0,7,0,0,
23/08/2022,PUE.,"TEHUACAN, PUE.",0,0,0,0,3,0,
23/08/2022,CHIS.,"SUCHIATE, CHIS.",0,0,0,0,0,392,
23/08/2022,CHIS.,"TONALÁ, CHIS.",0,0,0,0,0,11,
23/08/2022,CHIS.,"LA TRINITARIA, CHIS.",0,0,0,0,0,30,
23/08/2022,TAMPS.,"REYNOSA, TAMPS.",0,0,0,2,0,0,
24/08/2022,MÉX.,"CHIMALHUACAN, MEX.",7,1,8,3,0,0,
24/08/2022,COAH.,"SALTILLO, COAH.",3,2,5,10,0,76,
24/08/2022,MÉX.,"NEZAHUALCOYOTL, MEX.",3,1,4,19,1,224,
24/08/2022,COAH.,"PIEDRAS NEGRAS, COAH.",1,2,3,4,0,646,
24/08/2022,N.L.,"APODACA, N.L.",1,1,2,1,0,354,
24/08/2022,MÉX.,"AMECAMECA, MEX.",2,0,2,0,0,185,
24/08/2022,SIN.,"ROSARIO, SIN.",0,1,1,0,0,0,
24/08/2022,CHIS.,"VILLAFLORES, CHIS.",0,1,1,3,0,589,
24/08/2022,DGO.,"GOMEZ PALACIO, DGO.",1,0,1,1,0,0,
24/08/2022,TAMPS.,"REYNOSA, TAMPS.",0,1,1,3,0,28,
24/08/2022,COAH.,"MONCLOVA, COAH.",0,0,0,0,0,14,
24/08/2022,CHIS.,"TONALÁ, CHIS.",0,0,0,1,0,22,
24/08/2022,CHIS.,"SUCHIATE, CHIS.",0,0,0,1,0,128,
24/08/2022,CHIS.,"LA TRINITARIA, CHIS.",0,0,0,0,0,23,
24/08/2022,CD. MÉX.,"IZTAPALAPA, CD. MÉX.",0,0,0,0,0,3,
24/08/2022,COAH.,"ACUÑA, COAH.",0,0,0,2,0,74,
25/08/2022,MÉX.,"ATIZAPAN, MEX.",5,3,8,2,1,3,
25/08/2022,DGO.,"GOMEZ PALACIO, DGO.",2,3,5,0,0,0,
25/08/2022,MÉX.,"NEZAHUALCOYOTL, MEX.",3,1,4,0,2,715,
25/08/2022,COAH.,"ACUÑA, COAH.",1,2,3,0,0,150,
25/08/2022,COAH.,"PIEDRAS NEGRAS, COAH.",2,0,2,1,0,125,
25/08/2022,COAH.,"NUEVA ROSITA, COAH.",2,0,2,0,0,24,
25/08/2022,CD. MÉX.,"IZTACALCO, CD. MÉX.",1,0,1,0,0,0,
25/08/2022,CD. MÉX.,"IZTAPALAPA, CD. MÉX.",0,1,1,0,0,0,
25/08/2022,CD. MÉX.,"GUSTAVO A. MADERO, CD. MÉX.",1,0,1,0,0,71,
25/08/2022,SIN.,"ESCUINAPA, SIN.",1,0,1,0,0,0,
25/08/2022,MÉX.,"AMECAMECA, MEX.",1,0,1,1,0,36,
25/08/2022,MÉX.,"CHIMALHUACAN, MEX.",1,0,1,0,0,7,
25/08/2022,MÉX.,"HUIXQUILUCAN, MEX.",1,0,1,0,0,18,
25/08/2022,CD. MÉX.,"CUAUHTEMOC, CD. MÉX.",0,0,0,0,0,349,
25/08/2022,DGO.,"DGO., DGO.",0,0,0,11,0,0,
25/08/2022,CHIS.,"VILLAFLORES, CHIS.",0,0,0,0,0,575,
25/08/2022,CHIS.,"BERRIOZÁBAL, CHIS.",0,0,0,0,0,29,
25/08/2022,CHIS.,"TONALÁ, CHIS.",0,0,0,0,0,24,
25/08/2022,N.L.,"APODACA, N.L.",0,0,0,0,0,51,
25/08/2022,TAMPS.,"REYNOSA, TAMPS.",0,0,0,2,0,0,
26/08/2022,MÉX.,"ATIZAPAN, MEX.",14,3,17,2,2,461,
26/08/2022,MÉX.,"CHIMALHUACAN, MEX.",8,2,10,5,0,0,
26/08/2022,MÉX.,"HUIXQUILUCAN, MEX.",2,4,6,0,0,0,
26/08/2022,MÉX.,"HUIXQUILUCAN, MEX.",3,1,4,1,0,108,
26/08/2022,COAH.,"SALTILLO, COAH.",1,3,4,8,0,249,
26/08/2022,MÉX.,"ATIZAPAN, MEX.",2,0,2,0,0,30,
26/08/2022,N.L.,"APODACA, N.L.",2,0,2,6,0,6,
26/08/2022,DGO.,"GOMEZ PALACIO, DGO.",1,1,2,1,0,0,
26/08/2022,CHIS.,"VILLAFLORES, CHIS.",2,0,2,0,0,804,
26/08/2022,COAH.,"PIEDRAS NEGRAS, COAH.",2,0,2,4,0,0,
26/08/2022,COAH.,"NUEVA ROSITA, COAH.",0,2,2,0,0,10,
26/08/2022,CD. MÉX.,"IZTACALCO, CD. MÉX.",1,0,1,0,0,0,
26/08/2022,CD. MÉX.,"IZTAPALAPA, CD. MÉX.",1,0,1,0,0,24,
26/08/2022,CD. MÉX.,"VENUSTIANO CARRANZA, CD. MÉX.",1,0,1,0,0,2,
26/08/2022,CD. MÉX.,"CUAUHTEMOC, CD. MÉX.",0,1,1,0,0,116,
26/08/2022,SIN.,"ESCUINAPA, SIN.",1,0,1,0,0,0,
26/08/2022,MÉX.,"AMECAMECA, MEX.",1,0,1,0,0,26,
26/08/2022,MÉX.,"NEZAHUALCOYOTL, MEX.",1,0,1,0,0,71,
26/08/2022,TAMPS.,"ALTAMIRA, TAMPS.",1,0,1,0,1,0,
26/08/2022,CHIS.,"ARRIAGA, CHIS.",1,0,1,0,0,0,
26/08/2022,TAMPS.,"REYNOSA, TAMPS.",1,0,1,7,0,115,
26/08/2022,PUE.,"TEHUACAN, PUE.",0,0,0,0,1,0,
26/08/2022,CHIS.,"CHICOASÉN, CHIS.",0,0,0,3,0,270,
26/08/2022,TAB.,"TENOSIQUE, TAB.",0,0,0,0,0,118,
26/08/2022,CHIS.,"SUCHIATE, CHIS.",0,0,0,0,0,286,
26/08/2022,CHIS.,"TONALÁ, CHIS.",0,0,0,0,0,4,
26/08/2022,B.C.,"SAN QUINTÍN, B.C.",0,0,0,2,0,70,
26/08/2022,COAH.,"FRANCISCO I. MADERO, COAH.",0,0,0,0,0,276,
26/08/2022,CHIS.,"FRONTERA COMALAPA, CHIS.",0,0,0,0,0,37,
27/08/2022,MÉX.,"CHIMALHUACAN, MEX.",12,2,14,2,0,22,
27/08/2022,MÉX.,"ATIZAPAN, MEX.",2,5,7,0,0,152,
27/08/2022,MÉX.,"HUIXQUILUCAN, MEX.",1,2,3,0,0,0,
27/08/2022,MÉX.,"AMECAMECA, MEX.",2,0,2,0,0,247,
27/08/2022,MÉX.,"NEZAHUALCOYOTL, MEX.",1,1,2,3,0,935,
27/08/2022,COAH.,"NUEVA ROSITA, COAH.",0,1,1,0,0,10,
27/08/2022,QRO.,"AMEALCO DE BONFIL, QRO.",0,0,0,0,2,0,
27/08/2022,PUE.,"TEHUACAN, PUE.",0,0,0,0,1,0,
27/08/2022,CHIS.,"SUCHIATE, CHIS.",0,0,0,0,0,357,
27/08/2022,CHIS.,"TONALÁ, CHIS.",0,0,0,0,0,5,
27/08/2022,CHIS.,"FRONTERA COMALAPA, CHIS.",0,0,0,2,0,73,
28/08/2022,SIN.,"ESCUINAPA, SIN.",1,0,1,0,0,0,
28/08/2022,QRO.,"QUERETARO, QRO.",0,0,0,0,1,0,
29/08/2022,MÉX.,"CHIMALHUACAN, MEX.",7,2,9,0,0,5,
29/08/2022,MOR.,"TEMIXCO, MOR.",2,3,5,1,1,485,
29/08/2022,TAMPS.,"REYNOSA, TAMPS.",3,2,5,3,0,63,
29/08/2022,MÉX.,"TEPETLAOXTOC, MEX.",2,2,4,0,0,2,
29/08/2022,COAH.,"TORREÓN, COAH.",3,0,3,0,0,0,
29/08/2022,COAH.,"PIEDRAS NEGRAS, COAH.",2,0,2,4,0,0,
29/08/2022,COAH.,"ACUÑA, COAH.",0,2,2,0,0,0,
29/08/2022,MÉX.,"NEZAHUALCOYOTL, MEX.",2,0,2,0,0,140,
29/08/2022,COAH.,"MATAMOROS, COAH.",2,0,2,20,0,0,
29/08/2022,CD. MÉX.,"IZTACALCO, CD. MÉX.",0,1,1,0,0,8,
29/08/2022,CD. MÉX.,"IZTAPALAPA, CD. MÉX.",1,0,1,0,0,0,
29/08/2022,CD. MÉX.,"VENUSTIANO CARRANZA, CD. MÉX.",1,0,1,0,0,0,
29/08/2022,COAH.,"NUEVA ROSITA, COAH.",1,0,1,2,0,10,
29/08/2022,N.L.,"APODACA, N.L.",0,1,1,0,0,53,
29/08/2022,COAH.,"NUEVA ROSITA, COAH.",0,1,1,1,0,0,
29/08/2022,CHIS.,"SUCHIATE, CHIS.",0,1,1,0,0,239,
29/08/2022,TAB.,"TENOSIQUE, TAB.",0,0,0,0,0,189,
29/08/2022,CHIS.,"TONALÁ, CHIS.",0,0,0,0,0,11,
29/08/2022,COAH.,"PIEDRAS NEGRAS, COAH.",0,0,0,4,0,280,
30/08/2022,MÉX.,"CHIMALHUACAN, MEX.",8,0,8,3,0,100,
30/08/2022,MÉX.,"ATIZAPAN, MEX.",4,1,5,5,0,357,
30/08/2022,MÉX.,"NEZAHUALCOYOTL, MEX.",4,0,4,29,0,977,
30/08/2022,COAH.,"TORREÓN, COAH.",2,0,2,0,0,0,
30/08/2022,MÉX.,"TEPETLAOXTOC, MEX.",1,1,2,1,0,0,
30/08/2022,TAMPS.,"REYNOSA, TAMPS.",2,0,2,1,1,32,
30/08/2022,CD. MÉX.,"IZTACALCO, CD. MÉX.",1,0,1,0,0,29,
30/08/2022,CHIS.,"ARRIAGA, CHIS.",1,0,1,0,0,489,
30/08/2022,TAMPS.,"ALTAMIRA, TAMPS.",1,0,1,1,0,6,
30/08/2022,CHIS.,"TONALÁ, CHIS.",0,0,0,1,0,15,
31/08/2022,N.L.,"APODACA, N.L.",4,5,9,0,0,40,
31/08/2022,MÉX.,"ATIZAPAN, MEX.",2,4,6,1,0,66,
31/08/2022,MÉX.,"CHIMALHUACAN, MEX.",2,2,4,3,0,100,
31/08/2022,MÉX.,"HUIXQUILUCAN, MEX.",0,3,3,0,0,0,
31/08/2022,MOR.,"TEMIXCO, MOR.",3,0,3,36,13,8,
31/08/2022,TAMPS.,"REYNOSA, TAMPS.",1,2,3,0,0,3,
31/08/2022,COAH.,"TORREÓN, COAH.",2,0,2,0,0,0,
31/08/2022,COAH.,"MATAMOROS, COAH.",2,0,2,0,0,0,
31/08/2022,MÉX.,"TEPETLAOXTOC, MEX.",2,0,2,0,50,0,
31/08/2022,CD. MÉX.,"IZTAPALAPA, CD. MÉX.",1,0,1,0,0,0,
31/08/2022,COAH.,"NUEVA ROSITA, COAH.",0,1,1,0,0,0,
31/08/2022,CHIS.,"ARRIAGA, CHIS.",0,1,1,1,0,511,
31/08/2022,B.C.,"TIJUANA, B.C.",0,1,1,0,0,0,
31/08/2022,COAH.,"ACUÑA, COAH.",1,0,1,0,0,299,
31/08/2022,COAH.,"PIEDRAS NEGRAS, COAH.",1,0,1,1,0,17,
31/08/2022,TAMPS.,"ALTAMIRA, TAMPS.",1,0,1,1,0,0,
31/08/2022,CD. MÉX.,"XOCHIMILCO, CD. MÉX.",0,0,0,0,0,35,
31/08/2022,COAH.,"MONCLOVA, COAH.",0,0,0,0,0,8,
31/08/2022,MÉX.,"NEZAHUALCOYOTL, MEX.",0,0,0,8,0,917,
31/08/2022,TAMPS.,"VICTORIA, TAMPS.",0,0,0,0,0,50,
31/08/2022,CHIS.,"TONALÁ, CHIS.",0,0,0,2,0,54,
01/09/2022,N.L.,"APODACA, N.L.",6,2,8,7,0,170,
01/09/2022,ZAC.,"ZAC., ZAC.",2,5,7,13,0,0,
01/09/2022,MÉX.,"ATIZAPAN, MEX.",3,4,7,1,0,0,
01/09/2022,MÉX.,"CHIMALHUACAN, MEX.",4,2,6,0,0,0,
01/09/2022,MÉX.,"HUIXQUILUCAN, MEX.",0,2,2,0,0,113,
01/09/2022,N.L.,"APODACA, N.L.",1,1,2,0,0,0,
01/09/2022,MOR.,"TEMIXCO, MOR.",2,0,2,0,0,55,
01/09/2022,CD. MÉX.,"XOCHIMILCO, CD. MÉX.",1,0,1,0,0,35,
01/09/2022,COAH.,"MONCLOVA, COAH.",1,0,1,0,0,0,
01/09/2022,ZAC.,"GUADALUPE, ZAC.",1,0,1,0,0,48,
01/09/2022,COAH.,"PIEDRAS NEGRAS, COAH.",0,0,0,10,0,327,
01/09/2022,COAH.,"ACUÑA, COAH.",0,0,0,2,0,0,
02/09/2022,ZAC.,"ZAC., ZAC.",5,4,9,29,0,207,
02/09/2022,CD. MÉX.,"COYOACAN, CD. MÉX.",8,1,9,0,0,336,
02/09/2022,MOR.,"CUERNAVACA, MOR.",8,0,8,13,0,386,
02/09/2022,MÉX.,"CHIMALHUACAN, MEX.",4,4,8,3,0,80,
02/09/2022,ZAC.,"GUADALUPE, ZAC.",3,1,4,1,1,286,
02/09/2022,MÉX.,"ATIZAPAN, MEX.",4,0,4,1,0,511,
02/09/2022,MÉX.,"TEPETLAOXTOC, MEX.",2,1,3,0,0,0,
02/09/2022,N.L.,"APODACA, N.L.",2,1,3,3,0,8,
02/09/2022,QRO.,"PEDRO ESCOBEDO, QRO.",1,1,2,0,0,0,
02/09/2022,CD. MÉX.,"XOCHIMILCO, CD. MÉX.",1,0,1,0,0,0,
02/09/2022,MÉX.,"HUIXQUILUCAN, MEX.",0,1,1,0,0,0,
02/09/2022,COAH.,"TORREÓN, COAH.",1,0,1,0,0,0,
02/09/2022,B.C.,"SAN QUINTÍN, B.C.",1,0,1,0,0,0,
02/09/2022,CD. MÉX.,"VENUSTIANO CARRANZA, CD. MÉX.",0,0,0,0,0,324,
02/09/2022,MOR.,"TEMIXCO, MOR.",0,0,0,1,3,0,
02/09/2022,COAH.,"MATAMOROS, COAH.",0,0,0,0,1,336,
02/09/2022,COAH.,"FRONTERA, COAH.",0,0,0,0,0,72,
03/09/2022,MÉX.,"TEPETLAOXTOC, MEX.",5,3,8,0,2,0,
03/09/2022,MÉX.,"CHIMALHUACAN, MEX.",6,2,8,0,0,36,
03/09/2022,MÉX.,"ATIZAPAN, MEX.",5,2,7,0,0,585,
03/09/2022,ZAC.,"ZAC., ZAC.",2,2,4,2,0,106,
03/09/2022,TAMPS.,"MATAMOROS, TAMPS.",4,0,4,3,0,49,
03/09/2022,ZAC.,"GUADALUPE, ZAC.",1,2,3,23,0,145,
03/09/2022,QRO.,"QUERETARO, QRO.",1,0,1,0,1,0,
03/09/2022,MÉX.,"HUIXQUILUCAN, MEX.",0,1,1,0,0,21,
04/09/2022,ZAC.,"ZAC., ZAC.",4,3,7,13,0,230,
04/09/2022,ZAC.,"GUADALUPE, ZAC.",4,2,6,5,0,225,
04/09/2022,QRO.,"QUERETARO, QRO.",0,0,0,0,1,0,
05/09/2022,MÉX.,"NAUCALPAN DE JUAREZ, MEX.",5,0,5,0,0,286,
05/09/2022,COAH.,"ACUÑA, COAH.",1,3,4,0,0,0,
05/09/2022,CD. MÉX.,"IZTAPALAPA, CD. MÉX.",2,0,2,0,0,19,
05/09/2022,CD. MÉX.,"VENUSTIANO CARRANZA, CD. MÉX.",1,1,2,0,0,1,
05/09/2022,CD. MÉX.,"XOCHIMILCO, CD. MÉX.",0,2,2,0,0,356,
05/09/2022,MÉX.,"TOLUCA, MEX.",0,2,2,0,0,0,
05/09/2022,TAMPS.,"MATAMOROS, TAMPS.",2,0,2,0,0,139,
05/09/2022,ZAC.,"FRESNILLO, ZAC.",1,0,1,0,0,50,
05/09/2022,COAH.,"PIEDRAS NEGRAS, COAH.",1,0,1,1,0,0,
05/09/2022,TAMPS.,"JAUMAVE, TAMPS.",0,1,1,0,0,0,
06/09/2022,MÉX.,"ECATEPEC DE MOR., MEX.",15,0,15,0,18,489,
06/09/2022,MÉX.,"CUAUTITLAN IZCALLI, MEX.",6,3,9,0,0,21,
06/09/2022,ZAC.,"FRESNILLO, ZAC.",7,2,9,17,0,363,
06/09/2022,CD. MÉX.,"TLAHUAC, CD. MÉX.",3,2,5,0,0,48,
06/09/2022,MÉX.,"NAUCALPAN DE JUAREZ, MEX.",4,0,4,0,0,0,
06/09/2022,CD. MÉX.,"COYOACAN, CD. MÉX.",2,0,2,0,0,267,
06/09/2022,CD. MÉX.,"XOCHIMILCO, CD. MÉX.",1,0,1,0,0,10,
06/09/2022,TAMPS.,"JAUMAVE, TAMPS.",1,0,1,0,0,0,
06/09/2022,MÉX.,"TOLUCA, MEX.",1,0,1,0,0,32,
06/09/2022,COAH.,"PIEDRAS NEGRAS, COAH.",0,0,0,0,0,247,
06/09/2022,COAH.,"ACUÑA, COAH.",0,0,0,3,0,5,
07/09/2022,ZAC.,"FRESNILLO, ZAC.",7,2,9,23,3,747,
07/09/2022,MÉX.,"ECATEPEC DE MOR., MEX.",8,1,9,1,18,281,
07/09/2022,CD. MÉX.,"VENUSTIANO CARRANZA, CD. MÉX.",5,0,5,0,0,32,
07/09/2022,PUE.,"TEHUACAN, PUE.",2,1,3,0,0,54,
07/09/2022,COAH.,"ACUÑA, COAH.",3,0,3,0,0,0,
07/09/2022,CD. MÉX.,"TLAHUAC, CD. MÉX.",2,1,3,0,0,86,
07/09/2022,MÉX.,"NAUCALPAN DE JUAREZ, MEX.",3,0,3,0,0,105,
07/09/2022,COAH.,"CUATROCIÉNEGAS, COAH.",0,2,2,0,0,0,
07/09/2022,S.L.P.,"SAN LUIS POTOSI, S.L.P.",2,0,2,0,4,0,
07/09/2022,MÉX.,"CUAUTITLAN IZCALLI, MEX.",1,1,2,1,0,36,
07/09/2022,TAMPS.,"JAUMAVE, TAMPS.",1,0,1,0,0,0,
07/09/2022,COAH.,"FRONTERA, COAH.",1,0,1,0,0,0,
07/09/2022,CD. MÉX.,"COYOACAN, CD. MÉX.",1,0,1,0,0,0,
07/09/2022,MÉX.,"TOLUCA, MEX.",1,0,1,0,0,267,
07/09/2022,TAMPS.,"MATAMOROS, TAMPS.",1,0,1,1,0,0,
07/09/2022,COAH.,"MONCLOVA, COAH.",0,0,0,0,0,29,
07/09/2022,COAH.,"PIEDRAS NEGRAS, COAH.",0,0,0,0,0,29,
07/09/2022,MOR.,"CUERNAVACA, MOR.",0,0,0,0,1,0,
08/09/2022,MÉX.,"ECATEPEC DE MOR., MEX.",5,4,9,0,0,371,
08/09/2022,ZAC.,"FRESNILLO, ZAC.",9,0,9,8,0,655,
08/09/2022,MÉX.,"TOLUCA, MEX.",4,0,4,0,0,3,
08/09/2022,MÉX.,"NAUCALPAN DE JUAREZ, MEX.",4,0,4,0,0,17,
08/09/2022,CD. MÉX.,"COYOACAN, CD. MÉX.",2,1,3,0,0,0,
08/09/2022,CD. MÉX.,"TLAHUAC, CD. MÉX.",2,1,3,0,0,5,
08/09/2022,MOR.,"CUERNAVACA, MOR.",2,1,3,0,1,0,
08/09/2022,CD. MÉX.,"AZCAPOTZALCO, CD. MÉX.",2,0,2,0,0,10,
08/09/2022,PUE.,"TEZIUTLAN, PUE.",1,1,2,0,0,160,
08/09/2022,TAMPS.,"MATAMOROS, TAMPS.",2,0,2,0,0,1,
08/09/2022,COAH.,"PIEDRAS NEGRAS, COAH.",0,0,0,0,0,100,
09/09/2022,ZAC.,"FRESNILLO, ZAC.",8,4,12,24,1,1027,
09/09/2022,MÉX.,"ECATEPEC DE MOR., MEX.",9,2,11,0,3,628,
09/09/2022,S.L.P.,"SAN LUIS POTOSI, S.L.P.",6,0,6,0,0,0,
09/09/2022,COAH.,"ACUÑA, COAH.",5,0,5,0,0,0,
09/09/2022,MOR.,"CUERNAVACA, MOR.",1,2,3,7,0,0,
09/09/2022,PUE.,"TEZIUTLAN, PUE.",2,0,2,2,0,119,
09/09/2022,MÉX.,"CUAUTITLAN IZCALLI, MEX.",2,0,2,1,0,108,
09/09/2022,MÉX.,"TOLUCA, MEX.",2,0,2,0,0,282,
09/09/2022,TAMPS.,"JAUMAVE, TAMPS.",1,1,2,0,0,40,
09/09/2022,CD. MÉX.,"TLAHUAC, CD. MÉX.",1,0,1,0,0,178,
09/09/2022,CD. MÉX.,"AZCAPOTZALCO, CD. MÉX.",0,1,1,0,0,20,
09/09/2022,CD. MÉX.,"XOCHIMILCO, CD. MÉX.",0,0,0,0,0,190,
09/09/2022,COAH.,"FRONTERA, COAH.",0,0,0,0,0,47,
09/09/2022,COAH.,"MONCLOVA, COAH.",0,0,0,2,0,0,
10/09/2022,ZAC.,"FRESNILLO, ZAC.",4,2,6,35,0,818,
10/09/2022,MÉX.,"NAUCALPAN DE JUAREZ, MEX.",4,2,6,0,0,1056,
10/09/2022,MÉX.,"ECATEPEC DE MOR., MEX.",5,1,6,0,0,81,
10/09/2022,MÉX.,"CUAUTITLAN IZCALLI, MEX.",2,2,4,0,1,262,
10/09/2022,MÉX.,"TOLUCA, MEX.",3,0,3,0,0,245,
11/09/2022,ZAC.,"JEREZ, ZAC.",1,2,3,0,0,0,
12/09/2022,MÉX.,"ECATEPEC DE MOR., MEX.",1,5,6,1,0,859,
12/09/2022,MÉX.,"TOLUCA, MEX.",3,0,3,0,0,6,
12/09/2022,MOR.,"CUERNAVACA, MOR.",2,1,3,0,1,0,
12/09/2022,MÉX.,"NAUCALPAN DE JUAREZ, MEX.",2,0,2,0,0,5,
12/09/2022,MÉX.,"CUAUTITLAN IZCALLI, MEX.",2,0,2,0,0,288,
12/09/2022,COAH.,"MÚZQUIZ, COAH.",0,1,1,0,0,0,
12/09/2022,COAH.,"PIEDRAS NEGRAS, COAH.",0,0,0,0,0,51,
12/09/2022,COAH.,"NUEVA ROSITA, COAH.",0,0,0,0,0,86,
12/09/2022,ZAC.,"JEREZ, ZAC.",0,0,0,8,0,19,
13/09/2022,MÉX.,"ECATEPEC DE MOR., MEX.",6,1,7,1,0,367,
13/09/2022,CD. MÉX.,"COYOACAN, CD. MÉX.",2,1,3,0,0,131,
13/09/2022,MÉX.,"NAUCALPAN DE JUAREZ, MEX.",2,0,2,0,0,245,
13/09/2022,CD. MÉX.,"TLAHUAC, CD. MÉX.",2,0,2,0,0,0,
13/09/2022,MOR.,"CUERNAVACA, MOR.",0,1,1,4,1,738,
13/09/2022,TAMPS.,"MATAMOROS, TAMPS.",0,1,1,0,0,5,
13/09/2022,MÉX.,"TOLUCA, MEX.",0,0,0,0,0,385,
13/09/2022,CD. MÉX.,"AZCAPOTZALCO, CD. MÉX.",0,0,0,0,0,161,
13/09/2022,MÉX.,"ECATEPEC DE MOR., MEX.",0,0,0,0,0,204,
13/09/2022,ZAC.,"JEREZ, ZAC.",0,0,0,0,0,562,
13/09/2022,COAH.,"CUATROCIÉNEGAS, COAH.",0,0,0,0,1,0,
14/09/2022,MÉX.,"CUAUTITLAN IZCALLI, MEX.",3,0,3,0,0,11,
14/09/2022,ZAC.,"JEREZ, ZAC.",2,1,3,21,0,32,
14/09/2022,CD. MÉX.,"AZCAPOTZALCO, CD. MÉX.",3,0,3,0,0,144,
14/09/2022,MÉX.,"ECATEPEC DE MOR., MEX.",2,0,2,0,0,72,
14/09/2022,CD. MÉX.,"COYOACAN, CD. MÉX.",1,1,2,0,0,124,
14/09/2022,CD. MÉX.,"TLAHUAC, CD. MÉX.",1,0,1,0,0,0,
14/09/2022,TAMPS.,"JAUMAVE, TAMPS.",1,0,1,0,0,0,
14/09/2022,S.L.P.,"SAN LUIS POTOSI, S.L.P.",0,0,0,0,3,0,
15/09/2022,MÉX.,"ECATEPEC DE MOR., MEX.",1,3,4,0,0,0,
15/09/2022,MÉX.,"CUAUTITLAN IZCALLI, MEX.",1,1,2,0,0,494,
15/09/2022,S.L.P.,"SAN LUIS POTOSI, S.L.P.",0,2,2,0,0,0,
15/09/2022,MÉX.,"NAUCALPAN DE JUAREZ, MEX.",1,1,2,0,0,798,
15/09/2022,COAH.,"SABINAS, COAH.",0,1,1,0,0,12,
16/09/2022,COAH.,"SABINAS, COAH.",0,1,1,0,0,0,
17/09/2022,MÉX.,"ECATEPEC DE MOR., MEX.",8,1,9,0,0,307,
17/09/2022,MÉX.,"CUAUTITLAN IZCALLI, MEX.",5,0,5,0,0,30,
17/09/2022,MÉX.,"TOLUCA, MEX.",1,1,2,0,0,3,
17/09/2022,MÉX.,"NAUCALPAN DE JUAREZ, MEX.",0,1,1,0,0,1228,
17/09/2022,COAH.,"PIEDRAS NEGRAS, COAH.",1,0,1,0,0,724,
17/09/2022,COAH.,"ACUÑA, COAH.",0,1,1,0,0,0,
19/09/2022,MÉX.,"TLALNEPANTLA DE BAZ, MEX.",6,1,7,0,1,93,
19/09/2022,MÉX.,"TECAMAC, MEX.",3,2,5,0,3,492,
19/09/2022,MÉX.,"NEZAHUALCOYOTL, MEX.",3,1,4,0,0,6,
19/09/2022,CD. MÉX.,"COYOACAN, CD. MÉX.",3,0,3,0,0,132,
19/09/2022,MOR.,"CUERNAVACA, MOR.",1,2,3,0,0,0,
19/09/2022,CD. MÉX.,"TLAHUAC, CD. MÉX.",1,1,2,0,0,0,
19/09/2022,MÉX.,"NICOLAS ROMERO, MEX.",0,2,2,0,0,0,
19/09/2022,CD. MÉX.,"CUAUHTEMOC, CD. MÉX.",1,0,1,0,3,55,
20/09/2022,MÉX.,"NEZAHUALCOYOTL, MEX.",5,1,6,0,0,234,
20/09/2022,MÉX.,"TECAMAC, MEX.",4,1,5,0,0,234,
20/09/2022,VER.,"POZA RICA DE HGO., VER.",2,1,3,0,0,122,
20/09/2022,S.L.P.,"SAN LUIS POTOSI, S.L.P.",1,2,3,0,0,0,
20/09/2022,CD. MÉX.,"AZCAPOTZALCO, CD. MÉX.",2,0,2,0,0,206,
20/09/2022,CD. MÉX.,"TLAHUAC, CD. MÉX.",1,0,1,0,0,0,
20/09/2022,CD. MÉX.,"CUAUHTEMOC, CD. MÉX.",1,0,1,0,0,68,
20/09/2022,MOR.,"CUERNAVACA, MOR.",0,1,1,1,0,0,
20/09/2022,COAH.,"ACUÑA, COAH.",0,1,1,0,0,0,
20/09/2022,COAH.,"PIEDRAS NEGRAS, COAH.",0,0,0,0,0,106,
21/09/2022,MÉX.,"TECAMAC, MEX.",4,3,7,0,0,122,
21/09/2022,CD. MÉX.,"TLAHUAC, CD. MÉX.",5,0,5,0,0,263,
21/09/2022,CD. MÉX.,"CUAUHTEMOC, CD. MÉX.",4,1,5,0,0,0,
21/09/2022,S.L.P.,"SAN LUIS POTOSI, S.L.P.",5,0,5,0,0,0,
21/09/2022,MÉX.,"NEZAHUALCOYOTL, MEX.",4,0,4,0,0,816,
21/09/2022,COAH.,"FRONTERA, COAH.",2,0,2,0,0,0,
21/09/2022,CD. MÉX.,"COYOACAN, CD. MÉX.",1,0,1,0,0,243,
21/09/2022,CD. MÉX.,"AZCAPOTZALCO, CD. MÉX.",1,0,1,0,0,0,
21/09/2022,VER.,"POZA RICA DE HGO., VER.",1,0,1,0,0,59,
22/09/2022,MÉX.,"TECAMAC, MEX.",3,1,4,0,0,129,
22/09/2022,MÉX.,"TLALNEPANTLA DE BAZ, MEX.",3,0,3,0,0,711,
22/09/2022,S.L.P.,"SAN LUIS POTOSI, S.L.P.",1,2,3,0,0,0,
22/09/2022,MÉX.,"NICOLAS ROMERO, MEX.",0,2,2,0,0,0,
22/09/2022,CD. MÉX.,"CUAUHTEMOC, CD. MÉX.",2,0,2,0,0,52,
22/09/2022,MÉX.,"NEZAHUALCOYOTL, MEX.",1,1,2,0,0,139,
22/09/2022,COAH.,"CASTAÑOS, COAH.",1,0,1,0,0,0,
22/09/2022,VER.,"POZA RICA DE HGO., VER.",1,0,1,1,0,90,
22/09/2022,CD. MÉX.,"COYOACAN, CD. MÉX.",1,0,1,0,0,0,
22/09/2022,CD. MÉX.,"TLAHUAC, CD. MÉX.",0,0,0,0,0,63,
22/09/2022,MOR.,"CUERNAVACA, MOR.",0,0,0,0,0,400,
23/09/2022,MÉX.,"TLALNEPANTLA DE BAZ, MEX.",6,0,6,0,0,24,
23/09/2022,CD. MÉX.,"GUSTAVO A. MADERO, CD. MÉX.",3,2,5,0,0,10,
23/09/2022,MÉX.,"NICOLAS ROMERO, MEX.",2,2,4,0,0,11,
23/09/2022,MÉX.,"NEZAHUALCOYOTL, MEX.",3,0,3,0,1,984,
23/09/2022,COAH.,"CASTAÑOS, COAH.",1,0,1,0,0,0,
23/09/2022,TAMPS.,"JAUMAVE, TAMPS.",1,0,1,0,0,0,
23/09/2022,MÉX.,"TECAMAC, MEX.",1,0,1,0,0,0,
23/09/2022,CHIH.,"JUÁREZ, CHIH.",0,0,0,0,0,31,
23/09/2022,VER.,"POZA RICA DE HGO., VER.",0,0,0,0,0,230,
23/09/2022,TAMPS.,"MATAMOROS, TAMPS.",0,0,0,2,0,21,
24/09/2022,MÉX.,"TLALNEPANTLA DE BAZ, MEX.",8,0,8,0,0,38,
24/09/2022,MÉX.,"TECAMAC, MEX.",1,1,2,0,0,0,
24/09/2022,MÉX.,"NEZAHUALCOYOTL, MEX.",1,0,1,0,0,357,
25/09/2022,S.L.P.,"SAN LUIS POTOSI, S.L.P.",1,3,4,0,0,0,
26/09/2022,MÉX.,"ALMOLOYA DE JUAREZ, MEX.",2,2,4,0,0,0,
26/09/2022,MÉX.,"TECAMAC, MEX.",2,1,3,0,10,664,
26/09/2022,COAH.,"SABINAS, COAH.",2,1,3,0,0,0,
26/09/2022,MOR.,"CUERNAVACA, MOR.",1,2,3,0,0,386,
26/09/2022,CD. MÉX.,"GUSTAVO A. MADERO, CD. MÉX.",1,0,1,0,0,164,
26/09/2022,CD. MÉX.,"VENUSTIANO CARRANZA, CD. MÉX.",0,1,1,0,0,0,
26/09/2022,COAH.,"FRONTERA, COAH.",0,1,1,1,0,70,
26/09/2022,COAH.,"CASTAÑOS, COAH.",1,0,1,0,0,5,
26/09/2022,MÉX.,"OCOYOACAC, MEX.",1,0,1,0,0,14,
26/09/2022,MÉX.,"NEZAHUALCOYOTL, MEX.",1,0,1,0,0,0,
26/09/2022,N.L.,"APODACA, N.L.",1,0,1,6,0,58,
27/09/2022,COAH.,"SABINAS, COAH.",0,5,5,0,0,0,
27/09/2022,MÉX.,"OCOYOACAC, MEX.",2,0,2,0,0,0,
27/09/2022,MÉX.,"TECAMAC, MEX.",2,0,2,0,3,400,
27/09/2022,N.L.,"APODACA, N.L.",1,1,2,0,0,43,
27/09/2022,MÉX.,"ALMOLOYA DE JUAREZ, MEX.",1,0,1,0,0,0,
27/09/2022,MÉX.,"NEZAHUALCOYOTL, MEX.",1,0,1,0,0,0,
27/09/2022,MOR.,"CUERNAVACA, MOR.",1,0,1,0,1,83,
27/09/2022,CHIH.,"JUÁREZ, CHIH.",0,0,0,0,0,7,
27/09/2022,COAH.,"MONCLOVA, COAH.",0,0,0,0,0,38,
27/09/2022,COAH.,"PIEDRAS NEGRAS, COAH.",0,0,0,0,0,325,
27/09/2022,CHIH.,"JUÁREZ, CHIH.",0,0,0,0,0,7,
28/09/2022,MÉX.,"NEZAHUALCOYOTL, MEX.",3,0,3,0,0,0,
28/09/2022,CD. MÉX.,"VENUSTIANO CARRANZA, CD. MÉX.",2,0,2,0,0,17,
28/09/2022,CD. MÉX.,"GUSTAVO A. MADERO, CD. MÉX.",2,0,2,0,0,43,
28/09/2022,COAH.,"FRONTERA, COAH.",0,1,1,0,0,0,
28/09/2022,COAH.,"MONCLOVA, COAH.",1,0,1,0,0,0,
28/09/2022,MOR.,"CUERNAVACA, MOR.",1,0,1,0,0,4,
28/09/2022,MÉX.,"TECAMAC, MEX.",0,1,1,0,0,0,
28/09/2022,CD. MÉX.,"CUAUHTEMOC, CD. MÉX.",0,0,0,0,0,263,
28/09/2022,N.L.,"APODACA, N.L.",0,0,0,1,0,32,
29/09/2022,MÉX.,"NEZAHUALCOYOTL, MEX.",9,0,9,0,0,0,
29/09/2022,MÉX.,"OCOYOACAC, MEX.",0,4,4,0,0,0,
29/09/2022,CD. MÉX.,"LA MAGDALENA CONTRERAS, CD. MÉX.",2,1,3,0,0,121,
29/09/2022,MÉX.,"TECAMAC, MEX.",2,0,2,0,0,0,
29/09/2022,S.L.P.,"SAN LUIS POTOSI, S.L.P.",1,0,1,0,0,0,
29/09/2022,QRO.,"CORREGIDORA, QRO.",1,0,1,1,0,12,
29/09/2022,MÉX.,"ALMOLOYA DE JUAREZ, MEX.",0,1,1,0,0,0,
29/09/2022,MOR.,"CUERNAVACA, MOR.",0,1,1,7,7,358,
29/09/2022,CD. MÉX.,"VENUSTIANO CARRANZA, CD. MÉX.",0,1,1,0,3,0,
29/09/2022,COAH.,"PIEDRAS NEGRAS, COAH.",0,0,0,0,0,184,
29/09/2022,CD. MÉX.,"CUAUHTEMOC, CD. MÉX.",0,0,0,0,0,58,
30/09/2022,CD. MÉX.,"TLALPAN, CD. MÉX.",4,1,5,0,0,162,
30/09/2022,MÉX.,"TECAMAC, MEX.",2,2,4,0,0,3,
30/09/2022,CD. MÉX.,"VENUSTIANO CARRANZA, CD. MÉX.",3,0,3,0,0,18,
30/09/2022,COAH.,"ACUÑA, COAH.",1,1,2,0,0,0,
30/09/2022,CD. MÉX.,"GUSTAVO A. MADERO, CD. MÉX.",0,1,1,0,0,0,
30/09/2022,TAMPS.,"MATAMOROS, TAMPS.",1,0,1,1,0,238,
30/09/2022,CHIH.,"JUÁREZ, CHIH.",0,1,1,0,0,129,
30/09/2022,MÉX.,"NEZAHUALCOYOTL, MEX.",0,0,0,0,0,6,
30/09/2022,COAH.,"PIEDRAS NEGRAS, COAH.",0,0,0,0,0,403,
01/10/2022,MÉX.,"ALMOLOYA DE JUAREZ, MEX.",2,2,4,0,0,0,
01/10/2022,MÉX.,"TECAMAC, MEX.",2,1,3,0,0,0,
01/10/2022,MÉX.,"OCOYOACAC, MEX.",0,2,2,2,0,8,
01/10/2022,MÉX.,"NEZAHUALCOYOTL, MEX.",1,0,1,0,0,0,
03/10/2022,CD. MÉX.,"TLALPAN, CD. MÉX.",2,1,3,0,0,58,
03/10/2022,VER.,"POZA RICA DE HGO., VER.",0,2,2,0,0,0,
03/10/2022,MÉX.,"TULTITLAN, MEX.",0,2,2,0,0,52,
03/10/2022,CHIH.,"JUÁREZ, CHIH.",1,1,2,0,0,0,
03/10/2022,CD. MÉX.,"VENUSTIANO CARRANZA, CD. MÉX.",1,0,1,0,0,0,
03/10/2022,CD. MÉX.,"GUSTAVO A. MADERO, CD. MÉX.",1,0,1,0,0,59,
03/10/2022,CD. MÉX.,"LA MAGDALENA CONTRERAS, CD. MÉX.",1,0,1,0,0,6,
03/10/2022,MÉX.,"CHALCO, MEX.",1,0,1,0,0,106,
03/10/2022,TLAX.,"TEPETITLA DE LARDIZABAL, TLAX.",1,0,1,1,0,0,
03/10/2022,COAH.,"FRONTERA, COAH.",1,0,1,0,0,0,
03/10/2022,MÉX.,"XALATLACO, MEX.",1,0,1,0,0,0,
03/10/2022,MÉX.,"ATLACOMULCO, MEX.",0,1,1,0,0,0,
03/10/2022,TLAX.,"HUAMANTLA, TLAX.",0,1,1,0,0,0,
03/10/2022,COAH.,"PIEDRAS NEGRAS, COAH.",0,0,0,0,0,92,
04/10/2022,MÉX.,"CHALCO, MEX.",14,0,14,0,0,71,
04/10/2022,CD. MÉX.,"TLALPAN, CD. MÉX.",3,3,6,0,0,41,
04/10/2022,TLAX.,"TLAX., TLAX.",2,1,3,0,0,0,
04/10/2022,TLAX.,"HUAMANTLA, TLAX.",3,0,3,0,0,0,
04/10/2022,MÉX.,"TULTEPEC, MEX.",3,0,3,0,0,71,
04/10/2022,VER.,"POZA RICA DE HGO., VER.",0,2,2,0,0,0,
04/10/2022,MÉX.,"TULTITLAN, MEX.",0,2,2,0,0,41,
04/10/2022,CD. MÉX.,"CUAUHTEMOC, CD. MÉX.",1,0,1,0,0,41,
04/10/2022,COAH.,"MONCLOVA, COAH.",1,0,1,0,0,0,
04/10/2022,MÉX.,"XALATLACO, MEX.",1,0,1,0,0,0,
05/10/2022,MÉX.,"CHALCO, MEX.",22,0,22,0,0,33,
05/10/2022,COAH.,"SAN JUAN DE SABINAS, COAH.",1,5,6,0,0,0,
05/10/2022,TLAX.,"TLAX., TLAX.",3,0,3,0,0,0,
05/10/2022,MÉX.,"TULTITLAN, MEX.",3,0,3,0,0,26,
05/10/2022,CD. MÉX.,"TLALPAN, CD. MÉX.",2,1,3,0,10,92,
05/10/2022,MÉX.,"XALATLACO, MEX.",2,0,2,0,0,0,
05/10/2022,MÉX.,"TULTEPEC, MEX.",2,0,2,0,0,0,
05/10/2022,VER.,"POZA RICA DE HGO., VER.",1,0,1,1,0,71,
05/10/2022,CHIH.,"JUÁREZ, CHIH.",0,0,0,1,0,123,
05/10/2022,COAH.,"PIEDRAS NEGRAS, COAH.",0,0,0,0,0,300,
05/10/2022,CD. MÉX.,"CUAUHTEMOC, CD. MÉX.",0,0,0,0,0,434,
06/10/2022,CD. MÉX.,"GUSTAVO A. MADERO, CD. MÉX.",5,1,6,0,0,220,
06/10/2022,CHIH.,"JUÁREZ, CHIH.",4,1,5,4,0,401,
06/10/2022,MÉX.,"CHALCO, MEX.",1,2,3,0,0,42,
06/10/2022,VER.,"POZA RICA DE HGO., VER.",2,0,2,0,0,1106,
06/10/2022,MÉX.,"TULTITLAN, MEX.",2,0,2,1,0,33,
06/10/2022,COAH.,"FRONTERA, COAH.",1,0,1,0,0,21,
06/10/2022,TLAX.,"TLAX., TLAX.",1,0,1,0,0,40,
06/10/2022,TLAX.,"HUAMANTLA, TLAX.",1,0,1,0,0,0,
06/10/2022,MÉX.,"TULTEPEC, MEX.",1,0,1,0,0,0,
06/10/2022,CD. MÉX.,"CUAUHTEMOC, CD. MÉX.",0,0,0,0,0,36,
06/10/2022,CD. MÉX.,"TLALPAN, CD. MÉX.",0,0,0,0,0,154,
06/10/2022,COAH.,"CASTAÑOS, COAH.",0,0,0,0,0,26,
06/10/2022,MÉX.,"XALATLACO, MEX.",0,0,0,0,0,218,
06/10/2022,MÉX.,"ATLACOMULCO, MEX.",0,0,0,0,0,11,
06/10/2022,COAH.,"PIEDRAS NEGRAS, COAH.",0,0,0,0,0,424,
06/10/2022,QRO.,"CORREGIDORA, QRO.",0,0,0,0,3,53,
07/10/2022,MÉX.,"TULTEPEC, MEX.",3,3,6,0,0,50,
07/10/2022,CD. MÉX.,"CUAUHTEMOC, CD. MÉX.",1,3,4,0,0,11,
07/10/2022,MÉX.,"XALATLACO, MEX.",3,0,3,0,0,0,
07/10/2022,TLAX.,"TLAX., TLAX.",1,2,3,0,0,0,
07/10/2022,MÉX.,"TULTITLAN, MEX.",2,1,3,1,0,28,
07/10/2022,MÉX.,"TULTITLAN, MEX.",3,0,3,0,0,25,
07/10/2022,CD. MÉX.,"ALVARO OBREGON, CD. MÉX.",2,0,2,0,0,200,
07/10/2022,CD. MÉX.,"TLALPAN, CD. MÉX.",1,1,2,0,0,128,
07/10/2022,VER.,"POZA RICA DE HGO., VER.",2,0,2,0,0,1106,
07/10/2022,CD. MÉX.,"GUSTAVO A. MADERO, CD. MÉX.",0,1,1,0,0,283,
07/10/2022,TLAX.,"HUAMANTLA, TLAX.",0,1,1,0,0,0,
07/10/2022,COAH.,"FRONTERA, COAH.",0,0,0,2,0,0,
07/10/2022,COAH.,"CASTAÑOS, COAH.",0,0,0,0,0,31,
07/10/2022,CHIH.,"JUÁREZ, CHIH.",0,0,0,0,0,31,
07/10/2022,QRO.,"CORREGIDORA, QRO.",0,0,0,0,1,0,
08/10/2022,MÉX.,"TULTEPEC, MEX.",1,3,4,0,0,0,
08/10/2022,MÉX.,"CHALCO, MEX.",4,0,4,0,0,245,
08/10/2022,TLAX.,"ESPAÑITA, TLAX.",0,2,2,0,0,0,
08/10/2022,TLAX.,"ALTZAYANCA, TLAX.",0,2,2,0,0,0,
08/10/2022,VER.,"POZA RICA DE HGO., VER.",2,0,2,0,0,1106,
08/10/2022,MÉX.,"TULTITLAN, MEX.",1,1,2,0,0,6,
08/10/2022,TLAX.,"TLAX., TLAX.",0,1,1,0,0,0,
10/10/2022,SIN.,"MAZATLAN, SIN.",14,0,14,0,0,404,
10/10/2022,MÉX.,"VALLE DE CHALCO SOLIDARIDAD, MEX.",7,2,9,2,0,417,
10/10/2022,CHIH.,"JUÁREZ, CHIH.",3,0,3,7,0,386,
10/10/2022,MÉX.,"TENANGO DEL VALLE, MEX.",2,1,3,0,0,0,
10/10/2022,MÉX.,"ATLACOMULCO, MEX.",1,1,2,0,0,0,
10/10/2022,MÉX.,"OTZOLOTEPEC, MEX.",1,1,2,0,0,14,
10/10/2022,TLAX.,"APIZACO, TLAX.",1,1,2,0,0,0,
10/10/2022,SIN.,"CONCORDIA, SIN.",1,0,1,0,0,0,
10/10/2022,SIN.,"SAN IGNACIO, SIN.",0,1,1,0,0,0,
10/10/2022,JAL.,"PUERTO VALLARTA, JAL.",1,0,1,0,0,0,
10/10/2022,COAH.,"FRONTERA, COAH.",0,0,0,0,0,50,
10/10/2022,COAH.,"ACUÑA, COAH.",0,0,0,0,0,16,
11/10/2022,SIN.,"MAZATLAN, SIN.",9,0,9,0,0,2977,
11/10/2022,JAL.,"PUERTO VALLARTA, JAL.",2,2,4,0,0,0,
11/10/2022,DGO.,"DGO., DGO.",1,2,3,2,0,595,
11/10/2022,MÉX.,"VALLE DE CHALCO SOLIDARIDAD, MEX.",3,0,3,0,98,26,
11/10/2022,SIN.,"CONCORDIA, SIN.",1,1,2,0,1,0,
11/10/2022,TLAX.,"TERRENATE, TLAX.",0,1,1,0,0,0,
11/10/2022,CHIH.,"JUÁREZ, CHIH.",1,0,1,2,0,200,
11/10/2022,CD. MÉX.,"ALVARO OBREGON, CD. MÉX.",1,0,1,0,0,85,
11/10/2022,CD. MÉX.,"TLALPAN, CD. MÉX.",1,0,1,0,0,2,
11/10/2022,SIN.,"SAN IGNACIO, SIN.",0,1,1,0,0,0,
11/10/2022,MÉX.,"OTZOLOTEPEC, MEX.",0,0,0,0,0,15,
11/10/2022,CD. MÉX.,"CUAUHTEMOC, CD. MÉX.",0,0,0,0,1,0,
12/10/2022,MÉX.,"VALLE DE CHALCO SOLIDARIDAD, MEX.",23,1,24,0,0,42,
12/10/2022,DGO.,"DGO., DGO.",3,1,4,1,0,281,
12/10/2022,TLAX.,"APIZACO, TLAX.",0,3,3,0,0,0,
12/10/2022,MÉX.,"TENANGO DEL VALLE, MEX.",1,2,3,0,0,0,
12/10/2022,MÉX.,"OTZOLOTEPEC, MEX.",2,0,2,0,0,0,
12/10/2022,CD. MÉX.,"TLALPAN, CD. MÉX.",0,1,1,0,0,0,
12/10/2022,COAH.,"PIEDRAS NEGRAS, COAH.",1,0,1,0,0,0,
12/10/2022,CD. MÉX.,"CUAUHTEMOC, CD. MÉX.",0,0,0,0,2,96,
12/10/2022,COAH.,"CASTAÑOS, COAH.",0,0,0,0,0,41,
13/10/2022,SIN.,"MAZATLAN, SIN.",7,4,11,0,0,307,
13/10/2022,MÉX.,"VALLE DE CHALCO SOLIDARIDAD, MEX.",3,3,6,0,0,21,
13/10/2022,JAL.,"PUERTO VALLARTA, JAL.",3,1,4,0,155,950,
13/10/2022,CD. MÉX.,"CUAUHTEMOC, CD. MÉX.",3,1,4,0,0,0,
13/10/2022,CHIH.,"JUÁREZ, CHIH.",3,0,3,6,0,0,
13/10/2022,DGO.,"DGO., DGO.",2,1,3,10,0,124,
13/10/2022,TLAX.,"APIZACO, TLAX.",3,0,3,0,0,0,
13/10/2022,COAH.,"PIEDRAS NEGRAS, COAH.",0,3,3,0,0,0,
13/10/2022,QRO.,"CORREGIDORA, QRO.",1,1,2,0,0,50,
13/10/2022,CD. MÉX.,"ALVARO OBREGON, CD. MÉX.",2,0,2,0,0,10,
13/10/2022,SIN.,"SAN IGNACIO, SIN.",0,1,1,0,0,505,
13/10/2022,SIN.,"CONCORDIA, SIN.",0,0,0,0,0,71,
13/10/2022,S.L.P.,"SAN LUIS POTOSI, S.L.P.",0,0,0,6,0,0,
13/10/2022,CD. MÉX.,"GUSTAVO A. MADERO, CD. MÉX.",0,0,0,0,0,36,
14/10/2022,MÉX.,"VALLE DE CHALCO SOLIDARIDAD, MEX.",31,0,31,0,4,140,
14/10/2022,CD. MÉX.,"VENUSTIANO CARRANZA, CD. MÉX.",10,0,10,0,0,726,
14/10/2022,CD. MÉX.,"ALVARO OBREGON, CD. MÉX.",5,4,9,0,0,384,
14/10/2022,SIN.,"MAZATLAN, SIN.",7,2,9,4,0,520,
14/10/2022,DGO.,"DGO., DGO.",6,1,7,9,0,39,
14/10/2022,CHIH.,"JUÁREZ, CHIH.",1,1,2,1,0,507,
14/10/2022,TLAX.,"SANCTORUM DE LAZARO CARDENAS, TLAX.",2,0,2,0,0,0,
14/10/2022,TLAX.,"TERRENATE, TLAX.",0,2,2,0,0,0,
14/10/2022,CD. MÉX.,"CUAUHTEMOC, CD. MÉX.",1,0,1,0,0,13,
14/10/2022,CD. MÉX.,"TLALPAN, CD. MÉX.",0,1,1,0,0,175,
14/10/2022,TLAX.,"APIZACO, TLAX.",0,1,1,0,0,0,
14/10/2022,TLAX.,"XALOZTOC, TLAX.",1,0,1,0,0,0,
14/10/2022,SIN.,"SAN IGNACIO, SIN.",1,0,1,0,0,1483,
14/10/2022,COAH.,"FRONTERA, COAH.",0,1,1,0,0,0,
14/10/2022,COAH.,"CUATROCIÉNEGAS, COAH.",1,0,1,0,0,10,
14/10/2022,MÉX.,"OTZOLOTEPEC, MEX.",1,0,1,0,0,80,
14/10/2022,SIN.,"CONCORDIA, SIN.",0,0,0,0,0,30,
15/10/2022,MÉX.,"VALLE DE CHALCO SOLIDARIDAD, MEX.",17,0,17,0,0,0,
15/10/2022,MÉX.,"OTZOLOTEPEC, MEX.",1,0,1,0,1,0,
15/10/2022,TLAX.,"SANCTORUM DE LAZARO CARDENAS, TLAX.",0,1,1,0,0,0,
15/10/2022,TLAX.,"APIZACO, TLAX.",1,0,1,0,0,0,
15/10/2022,TLAX.,"XALOZTOC, TLAX.",1,0,1,0,0,0,
17/10/2022,MÉX.,"LA PAZ, MEX.",7,0,7,0,1,15,
17/10/2022,CD. MÉX.,"ALVARO OBREGON, CD. MÉX.",2,2,4,0,0,0,
17/10/2022,SIN.,"MAZATLAN, SIN.",2,1,3,0,2,75,
17/10/2022,CHIH.,"JUÁREZ, CHIH.",3,0,3,3,0,0,
17/10/2022,MÉX.,"EL ORO, MEX.",1,1,2,0,0,0,
17/10/2022,CD. MÉX.,"CUAUHTEMOC, CD. MÉX.",2,0,2,0,0,0,
17/10/2022,MÉX.,"HUEHUETOCA, MEX.",1,1,2,0,0,28,
17/10/2022,TLAX.,"IXTACUIXTLA DE MARIANO MATAMOROS, TLAX.",1,0,1,0,0,0,
17/10/2022,TLAX.,"APETATITLAN DE ANTONIO CARVAJAL, TLAX.",1,0,1,0,0,0,
17/10/2022,MÉX.,"METEPEC, MEX.",1,0,1,0,0,0,
17/10/2022,CD. MÉX.,"TLALPAN, CD. MÉX.",0,1,1,0,0,225,
17/10/2022,TAMPS.,"NUEVO LAREDO, TAMPS.",1,0,1,0,0,298,
17/10/2022,MOR.,"PUENTE DE IXTLA, MOR.",1,0,1,0,0,26,
17/10/2022,SIN.,"CONCORDIA, SIN.",0,0,0,0,0,22,
17/10/2022,SIN.,"SAN IGNACIO, SIN.",0,0,0,0,0,175,
18/10/2022,MÉX.,"LA PAZ, MEX.",6,4,10,0,0,146,
18/10/2022,SIN.,"MAZATLAN, SIN.",3,5,8,0,2,63,
18/10/2022,MÉX.,"EL ORO, MEX.",4,0,4,0,0,0,
18/10/2022,CD. MÉX.,"CUAUHTEMOC, CD. MÉX.",2,1,3,0,0,94,
18/10/2022,CD. MÉX.,"TLALPAN, CD. MÉX.",1,1,2,0,2,113,
18/10/2022,TLAX.,"APETATITLAN DE ANTONIO CARVAJAL, TLAX.",1,1,2,0,0,0,
18/10/2022,MÉX.,"HUEHUETOCA, MEX.",2,0,2,0,18,0,
18/10/2022,MOR.,"YECAPIXTLA, MOR.",2,0,2,0,0,78,
18/10/2022,MOR.,"PUENTE DE IXTLA, MOR.",0,1,1,0,0,0,
18/10/2022,TAMPS.,"NUEVO LAREDO, TAMPS.",0,1,1,0,0,0,
18/10/2022,COAH.,"PIEDRAS NEGRAS, COAH.",0,0,0,0,0,119,
18/10/2022,SIN.,"SAN IGNACIO, SIN.",0,0,0,0,0,5145,
19/10/2022,MÉX.,"LA PAZ, MEX.",9,1,10,0,0,185,
19/10/2022,SIN.,"MAZATLAN, SIN.",7,2,9,3,0,1014,
19/10/2022,MÉX.,"HUEHUETOCA, MEX.",2,1,3,0,0,12,
19/10/2022,CHIH.,"JUÁREZ, CHIH.",0,2,2,0,0,249,
19/10/2022,TLAX.,"HUEYOTLIPAN, TLAX.",2,0,2,0,0,0,
19/10/2022,CD. MÉX.,"VENUSTIANO CARRANZA, CD. MÉX.",1,0,1,0,0,0,
19/10/2022,CD. MÉX.,"ALVARO OBREGON, CD. MÉX.",1,0,1,0,0,365,
19/10/2022,B.C.,"SAN FELIPE, B.C.",0,1,1,0,0,0,
19/10/2022,COAH.,"CASTAÑOS, COAH.",0,1,1,0,0,0,
19/10/2022,SIN.,"CONCORDIA, SIN.",1,0,1,0,0,1242,
19/10/2022,TLAX.,"IXTACUIXTLA DE MARIANO MATAMOROS, TLAX.",0,1,1,0,0,0,
19/10/2022,MOR.,"PUENTE DE IXTLA, MOR.",0,1,1,0,0,0,
19/10/2022,TAMPS.,"NUEVO LAREDO, TAMPS.",0,1,1,0,0,258,
19/10/2022,COAH.,"PIEDRAS NEGRAS, COAH.",0,0,0,0,0,119,
19/10/2022,SIN.,"SAN IGNACIO, SIN.",0,0,0,0,0,10650,
19/10/2022,TLAX.,"TLAX., TLAX.",0,0,0,0,0,108,
19/10/2022,MOR.,"YECAPIXTLA, MOR.",0,0,0,100,0,0,
20/10/2022,MOR.,"PUENTE DE IXTLA, MOR.",8,4,12,0,0,0,
20/10/2022,CD. MÉX.,"CUAUHTEMOC, CD. MÉX.",5,0,5,0,0,56,
20/10/2022,SIN.,"MAZATLAN, SIN.",4,1,5,2,2,639,
20/10/2022,COAH.,"PIEDRAS NEGRAS, COAH.",1,2,3,0,0,206,
20/10/2022,TLAX.,"IXTACUIXTLA DE MARIANO MATAMOROS, TLAX.",0,2,2,0,0,0,
20/10/2022,MOR.,"YECAPIXTLA, MOR.",2,0,2,7,1,38,
20/10/2022,OAX.,"SAN JUAN CACAHUATEPEC, OAX.",2,0,2,0,0,0,
20/10/2022,COAH.,"CASTAÑOS, COAH.",2,0,2,0,0,0,
20/10/2022,CHIH.,"JUÁREZ, CHIH.",0,1,1,0,0,0,
20/10/2022,SIN.,"SAN IGNACIO, SIN.",1,0,1,0,0,42,
20/10/2022,MÉX.,"METEPEC, MEX.",1,0,1,0,2,0,
20/10/2022,TLAX.,"TLAX., TLAX.",1,0,1,0,0,0,
20/10/2022,TAMPS.,"NUEVO LAREDO, TAMPS.",1,0,1,0,0,260,
20/10/2022,CD. MÉX.,"ALVARO OBREGON, CD. MÉX.",0,0,0,0,0,292,
21/10/2022,MÉX.,"LA PAZ, MEX.",24,0,24,0,81,233,
21/10/2022,MOR.,"PUENTE DE IXTLA, MOR.",4,3,7,0,0,0,
21/10/2022,MÉX.,"HUEHUETOCA, MEX.",4,1,5,0,0,303,
21/10/2022,SIN.,"MAZATLAN, SIN.",5,0,5,4,0,936,
21/10/2022,MÉX.,"EL ORO, MEX.",2,0,2,0,0,0,
21/10/2022,CD. MÉX.,"TLALPAN, CD. MÉX.",1,0,1,0,12,0,
21/10/2022,MÉX.,"METEPEC, MEX.",1,0,1,0,0,20,
21/10/2022,TLAX.,"TLAX., TLAX.",0,1,1,0,0,0,
21/10/2022,TLAX.,"PANOTLA, TLAX.",1,0,1,0,0,0,
21/10/2022,MOR.,"YECAPIXTLA, MOR.",1,0,1,31,0,1570,
21/10/2022,TAMPS.,"NUEVO LAREDO, TAMPS.",1,0,1,0,0,27,
21/10/2022,CD. MÉX.,"CUAUHTEMOC, CD. MÉX.",0,0,0,0,0,190,
21/10/2022,CD. MÉX.,"ALVARO OBREGON, CD. MÉX.",0,0,0,0,0,129,
22/10/2022,MÉX.,"LA PAZ, MEX.",11,0,11,0,0,415,
22/10/2022,MÉX.,"METEPEC, MEX.",1,1,2,0,0,13,
22/10/2022,MÉX.,"HUEHUETOCA, MEX.",1,0,1,0,0,0,
24/10/2022,MÉX.,"LERMA, MEX.",4,0,4,0,0,0,
24/10/2022,MÉX.,"COYOTEPEC, MEX.",4,0,4,0,0,0,
24/10/2022,TAMPS.,"NUEVO LAREDO, TAMPS.",3,1,4,0,0,186,
24/10/2022,N.L.,"APODACA, N.L.",3,0,3,1,0,328,
24/10/2022,N.L.,"GRAL. ESCOBEDO, N.L.",3,0,3,1,0,328,
24/10/2022,TLAX.,"TLAX., TLAX.",0,2,2,0,0,0,
24/10/2022,MOR.,"CUAUTLA, MOR.",0,2,2,3,0,0,
24/10/2022,CD. MÉX.,"ALVARO OBREGON, CD. MÉX.",1,0,1,0,0,92,
24/10/2022,SIN.,"MAZATLAN, SIN.",1,0,1,0,0,38,
24/10/2022,MÉX.,"NEXTLALPAN, MEX., MEX.",0,0,0,0,1,0,
24/10/2022,COAH.,"PIEDRAS NEGRAS, COAH.",0,0,0,1,0,175,
24/10/2022,N.L.,"MONTERREY, N.L.",0,0,0,0,0,10,
25/10/2022,MOR.,"CUAUTLA, MOR.",2,4,6,0,0,184,
25/10/2022,N.L.,"APODACA, N.L.",5,1,6,1,0,152,
25/10/2022,N.L.,"GRAL. ESCOBEDO, N.L.",5,1,6,1,0,152,
25/10/2022,TAMPS.,"NUEVO LAREDO, TAMPS.",3,1,4,0,0,1070,
25/10/2022,CD. MÉX.,"TLALPAN, CD. MÉX.",1,2,3,0,0,820,
25/10/2022,SIN.,"MAZATLAN, SIN.",1,1,2,0,0,106,
25/10/2022,MÉX.,"NEXTLALPAN, MEX., MEX.",1,1,2,0,0,4,
25/10/2022,N.L.,"MONTERREY, N.L.",0,2,2,0,0,11,
25/10/2022,MÉX.,"LERMA, MEX.",0,1,1,0,0,0,
25/10/2022,MÉX.,"COYOTEPEC, MEX.",0,1,1,0,0,0,
25/10/2022,COAH.,"PIEDRAS NEGRAS, COAH.",0,0,0,0,0,153,
26/10/2022,MÉX.,"NEXTLALPAN, MEX., MEX.",43,0,43,0,0,0,
26/10/2022,MÉX.,"COYOTEPEC, MEX.",8,1,9,0,0,62,
26/10/2022,MOR.,"CUAUTLA, MOR.",1,6,7,14,0,10,
26/10/2022,N.L.,"MONTERREY, N.L.",3,3,6,1,0,0,
26/10/2022,CHIH.,"JUÁREZ, CHIH.",3,2,5,3,0,0,
26/10/2022,SIN.,"MAZATLAN, SIN.",2,1,3,0,0,304,
26/10/2022,TLAX.,"TLAX., TLAX.",0,2,2,0,0,0,
26/10/2022,CD. MÉX.,"LA MAGDALENA CONTRERAS, CD. MÉX.",1,0,1,0,0,21,
26/10/2022,CD. MÉX.,"VENUSTIANO CARRANZA, CD. MÉX.",1,0,1,0,0,137,
26/10/2022,CD. MÉX.,"GUSTAVO A. MADERO, CD. MÉX.",1,0,1,0,0,0,
26/10/2022,CD. MÉX.,"TLALPAN, CD. MÉX.",0,1,1,0,0,0,
26/10/2022,TLAX.,"SANTA ANA NOPALUCAN, TLAX.",1,0,1,0,0,0,
26/10/2022,MÉX.,"LERMA, MEX.",1,0,1,0,0,0,
26/10/2022,N.L.,"GRAL. ESCOBEDO, N.L.",0,1,1,1,0,184,
26/10/2022,TAMPS.,"NUEVO LAREDO, TAMPS.",1,0,1,0,0,247,
26/10/2022,MÉX.,"MEXICALTZINGO, MEX.",0,0,0,0,0,11,
27/10/2022,N.L.,"MONTERREY, N.L.",6,2,8,0,0,65,
27/10/2022,MOR.,"CUAUTLA, MOR.",5,0,5,16,0,25,
27/10/2022,TLAX.,"CONTLA DE JUAN CUAMATZI, TLAX.",2,1,3,0,0,0,
27/10/2022,SIN.,"MAZATLAN, SIN.",1,1,2,0,0,391,
27/10/2022,MÉX.,"LERMA, MEX.",1,1,2,0,0,6,
27/10/2022,TLAX.,"TLAX., TLAX.",2,0,2,0,0,0,
27/10/2022,CD. MÉX.,"LA MAGDALENA CONTRERAS, CD. MÉX.",0,1,1,0,5,0,
27/10/2022,CD. MÉX.,"GUSTAVO A. MADERO, CD. MÉX.",1,0,1,0,0,46,
27/10/2022,CHIH.,"JUÁREZ, CHIH.",1,0,1,4,0,293,
27/10/2022,MÉX.,"MEXICALTZINGO, MEX.",1,0,1,0,0,0,
27/10/2022,MÉX.,"NEXTLALPAN, MEX., MEX.",1,0,1,0,0,0,
27/10/2022,MÉX.,"COYOTEPEC, MEX.",0,1,1,0,0,49,
27/10/2022,COAH.,"PIEDRAS NEGRAS, COAH.",1,0,1,0,0,154,
27/10/2022,N.L.,"GRAL. ESCOBEDO, N.L.",1,0,1,0,0,70,
27/10/2022,CD. MÉX.,"VENUSTIANO CARRANZA, CD. MÉX.",0,0,0,0,0,598,
27/10/2022,CD. MÉX.,"TLALPAN, CD. MÉX.",0,0,0,0,0,492,
27/10/2022,TAMPS.,"NUEVO LAREDO, TAMPS.",0,0,0,0,0,32,
28/10/2022,GRO.,"IGUALA DE LA INDEPENDENCIA, GRO.",4,4,8,9,0,490,
28/10/2022,N.L.,"MONTERREY, N.L.",5,0,5,0,0,139,
28/10/2022,TAMPS.,"NUEVO LAREDO, TAMPS.",3,1,4,0,0,16,
28/10/2022,MÉX.,"LERMA, MEX.",1,2,3,0,2,0,
28/10/2022,TLAX.,"CONTLA DE JUAN CUAMATZI, TLAX.",2,1,3,0,0,0,
28/10/2022,MOR.,"CUAUTLA, MOR.",3,0,3,1,0,162,
28/10/2022,CD. MÉX.,"GUSTAVO A. MADERO, CD. MÉX.",2,0,2,0,0,40,
28/10/2022,CD. MÉX.,"TLALPAN, CD. MÉX.",1,1,2,0,0,0,
28/10/2022,SIN.,"MAZATLAN, SIN.",1,1,2,0,0,55,
28/10/2022,CHIH.,"JUÁREZ, CHIH.",1,0,1,4,0,22,
28/10/2022,COAH.,"FRONTERA, COAH.",0,1,1,0,1,0,
28/10/2022,TLAX.,"TLAX., TLAX.",1,0,1,0,0,0,
28/10/2022,MÉX.,"NEXTLALPAN, MEX., MEX.",1,0,1,0,0,191,
28/10/2022,MÉX.,"COYOTEPEC, MEX.",0,1,1,0,0,0,
28/10/2022,N.L.,"GRAL. ESCOBEDO, N.L.",0,0,0,0,0,33,
29/10/2022,MÉX.,"NEXTLALPAN, MEX., MEX.",50,0,50,0,0,0,
29/10/2022,MÉX.,"COYOTEPEC, MEX.",22,0,22,0,37,0,
29/10/2022,GRO.,"IGUALA DE LA INDEPENDENCIA, GRO.",5,2,7,5,0,204,
29/10/2022,TLAX.,"CONTLA DE JUAN CUAMATZI, TLAX.",2,2,4,0,0,0,
29/10/2022,TLAX.,"SANTA ANA NOPALUCAN, TLAX.",3,0,3,0,0,0,
29/10/2022,TLAX.,"SAN DAMIAN TEXOLOC, TLAX.",1,1,2,0,0,0,
29/10/2022,MÉX.,"LERMA, MEX.",0,1,1,0,0,0,
29/10/2022,TLAX.,"TLAX., TLAX.",0,1,1,0,0,0,
31/10/2022,MÉX.,"CUAUTITLAN, MEX.",22,2,24,0,0,0,
31/10/2022,MÉX.,"SAN MATEO ATENCO, MEX.",4,1,5,0,0,0,
31/10/2022,MÉX.,"CHICOLOAPAN, MEX.",4,0,4,0,0,47,
31/10/2022,CD. MÉX.,"GUSTAVO A. MADERO, CD. MÉX.",3,0,3,0,0,130,
31/10/2022,MÉX.,"ZINACANTEPEC, MEX.",1,2,3,0,0,0,
31/10/2022,CHIH.,"JUÁREZ, CHIH.",2,0,2,8,0,0,
31/10/2022,SIN.,"COSALA, SIN.",1,1,2,0,0,0,
31/10/2022,CD. MÉX.,"TLALPAN, CD. MÉX.",1,0,1,0,0,0,
31/10/2022,SIN.,"ELOTA, SIN.",1,0,1,0,0,0,
31/10/2022,TLAX.,"TLAX., TLAX.",0,1,1,0,0,0,
31/10/2022,COAH.,"PIEDRAS NEGRAS, COAH.",0,0,0,0,0,650,
01/11/2022,MÉX.,"CHICOLOAPAN, MEX.",2,1,3,0,0,9,
01/11/2022,MÉX.,"CUAUTITLAN, MEX.",2,0,2,0,0,0,
01/11/2022,MÉX.,"SAN MATEO ATENCO, MEX.",2,0,2,0,0,49,
01/11/2022,TLAX.,"IXTACUIXTLA DE MARIANO MATAMOROS, TLAX.",1,0,1,0,0,0,
01/11/2022,TLAX.,"CONTLA DE JUAN CUAMATZI, TLAX.",1,0,1,0,0,0,
01/11/2022,SIN.,"ELOTA, SIN.",1,0,1,0,0,0,
01/11/2022,CD. MÉX.,"TLAHUAC, CD. MÉX.",0,1,1,0,0,0,
01/11/2022,SIN.,"COSALA, SIN.",0,0,0,0,0,670,
02/11/2022,SIN.,"ELOTA, SIN.",2,1,3,0,1,0,
02/11/2022,TLAX.,"CONTLA DE JUAN CUAMATZI, TLAX.",1,1,2,0,0,0,
02/11/2022,TLAX.,"IXTACUIXTLA DE MARIANO MATAMOROS, TLAX.",1,0,1,0,0,0,
02/11/2022,COAH.,"PIEDRAS NEGRAS, COAH.",0,1,1,0,0,250,
03/11/2022,MÉX.,"CUAUTITLAN, MEX.",67,1,68,0,0,30,
03/11/2022,MÉX.,"ZINACANTEPEC, MEX.",4,1,5,0,1,0,
03/11/2022,TLAX.,"TLAX., TLAX.",4,0,4,0,0,0,
03/11/2022,MÉX.,"CHICOLOAPAN, MEX.",3,1,4,0,0,201,
03/11/2022,CD. MÉX.,"TLALPAN, CD. MÉX.",2,0,2,0,0,0,
03/11/2022,MÉX.,"SAN MATEO ATENCO, MEX.",2,0,2,0,0,0,
03/11/2022,CD. MÉX.,"CUAUHTEMOC, CD. MÉX.",1,0,1,0,0,7,
03/11/2022,CHIS.,"JIQUIPILAS, CHIS.",1,0,1,0,0,0,
03/11/2022,TAMPS.,"NUEVO LAREDO, TAMPS.",1,0,1,0,0,130,
03/11/2022,SIN.,"ELOTA, SIN.",0,0,0,0,0,96,
04/11/2022,MÉX.,"CUAUTITLAN, MEX.",34,0,34,0,0,50,
04/11/2022,MÉX.,"CHICOLOAPAN, MEX.",10,0,10,0,0,0,
04/11/2022,CD. MÉX.,"GUSTAVO A. MADERO, CD. MÉX.",4,1,5,0,0,222,
04/11/2022,VER.,"POZA RICA DE HGO., VER.",5,0,5,20,0,214,
04/11/2022,SIN.,"ELOTA, SIN.",2,1,3,0,0,0,
04/11/2022,SIN.,"COSALA, SIN.",2,1,3,0,0,0,
04/11/2022,VER.,"ACAYUCAN, VER.",3,0,3,0,0,8,
04/11/2022,MÉX.,"SAN MATEO ATENCO, MEX.",2,0,2,0,0,107,
04/11/2022,MÉX.,"ZINACANTEPEC, MEX.",0,2,2,0,0,0,
04/11/2022,TLAX.,"CONTLA DE JUAN CUAMATZI, TLAX.",2,0,2,0,0,0,
04/11/2022,COAH.,"SAN JUAN DE SABINAS, COAH.",2,0,2,0,0,0,
04/11/2022,CD. MÉX.,"TLALPAN, CD. MÉX.",1,0,1,0,0,0,
04/11/2022,CHIS.,"JIQUIPILAS, CHIS.",0,0,0,3,0,0,
04/11/2022,TAMPS.,"NUEVO LAREDO, TAMPS.",0,0,0,0,0,932,
05/11/2022,MÉX.,"CUAUTITLAN, MEX.",30,4,34,1,0,30,
05/11/2022,VER.,"ACAYUCAN, VER.",4,0,4,0,0,83,
05/11/2022,MÉX.,"CHICOLOAPAN, MEX.",4,0,4,0,0,28,
05/11/2022,VER.,"POZA RICA DE HGO., VER.",3,0,3,1,0,238,
05/11/2022,CHIS.,"TAPACHULA, CHIS.",0,2,2,3,0,0,
05/11/2022,MÉX.,"SAN MATEO ATENCO, MEX.",1,0,1,0,0,51,
05/11/2022,MÉX.,"ZINACANTEPEC, MEX.",0,0,0,0,0,27,
05/11/2022,CHIS.,"TONALÁ, CHIS.",0,0,0,0,0,17,
05/11/2022,CHIS.,"JIQUIPILAS, CHIS.",0,0,0,3,0,0,
05/11/2022,COAH.,"SAN JUAN DE SABINAS, COAH.",0,0,0,1,0,50,
06/11/2022,VER.,"POZA RICA DE HGO., VER.",1,1,2,1,0,143,
06/11/2022,VER.,"ACAYUCAN, VER.",0,0,0,0,0,65,
07/11/2022,MOR.,"AYALA, MOR.",8,1,9,0,0,0,
07/11/2022,OAX.,"SANTIAGO PINOTEPA NACIONAL, OAX.",6,0,6,8,0,145,
07/11/2022,CD. MÉX.,"TLALPAN, CD. MÉX.",2,1,3,0,0,150,
07/11/2022,MÉX.,"ZUMPANGO, MEX.",3,0,3,0,0,46,
07/11/2022,SIN.,"ELOTA, SIN.",2,0,2,0,0,0,
07/11/2022,CHIS.,"SAN CRISTOBAL DE LAS CASAS, CHIS.",2,0,2,0,0,0,
07/11/2022,JAL.,"TOMATLAN, JAL.",1,1,2,0,0,0,
07/11/2022,MÉX.,"IXTAPALUCA, MEX.",2,0,2,0,0,16,
07/11/2022,MÉX.,"COACALCO DE BERRIOZABAL, MEX.",2,0,2,0,0,101,
07/11/2022,VER.,"ACAYUCAN, VER.",2,0,2,0,0,0,
07/11/2022,CD. MÉX.,"CUAUHTEMOC, CD. MÉX.",1,0,1,0,0,50,
07/11/2022,CD. MÉX.,"GUSTAVO A. MADERO, CD. MÉX.",1,0,1,0,0,330,
07/11/2022,CHIS.,"BERRIOZÁBAL, CHIS.",1,0,1,0,0,0,
07/11/2022,CHIS.,"TUXTLA GUTIÉRREZ, CHIS.",1,0,1,0,0,0,
07/11/2022,COAH.,"SAN JUAN DE SABINAS, COAH.",0,1,1,0,0,0,
07/11/2022,VER.,"PAPANTLA, VER.",0,0,0,0,0,191,
07/11/2022,TAMPS.,"NUEVO LAREDO, TAMPS.",0,0,0,0,0,29,
08/11/2022,MÉX.,"COACALCO DE BERRIOZABAL, MEX.",132,0,132,0,0,687,
08/11/2022,MÉX.,"ZUMPANGO, MEX.",48,1,49,0,1,29,
08/11/2022,MÉX.,"SAN MARTIN DE LAS PIRAMIDES, MEX.",6,0,6,0,0,13,
08/11/2022,VER.,"PAPANTLA, VER.",3,2,5,9,0,135,
08/11/2022,MOR.,"AYALA, MOR.",4,1,5,13,1,0,
08/11/2022,OAX.,"SANTIAGO PINOTEPA NACIONAL, OAX.",4,0,4,18,0,146,
08/11/2022,TAMPS.,"NUEVO LAREDO, TAMPS.",2,2,4,0,0,309,
08/11/2022,CHIS.,"BERRIOZÁBAL, CHIS.",2,1,3,0,0,420,
08/11/2022,CHIS.,"SAN CRISTOBAL DE LAS CASAS, CHIS.",2,1,3,0,0,0,
08/11/2022,GRO.,"ACAPULCO DE JUAREZ, GRO.",3,0,3,2,4,250,
08/11/2022,JAL.,"TOMATLAN, JAL.",2,0,2,0,0,0,
08/11/2022,CHIS.,"TUXTLA GUTIÉRREZ, CHIS.",1,1,2,3,0,1062,
08/11/2022,CHIS.,"BERRIOZÁBAL, CHIS.",2,0,2,0,0,900,
08/11/2022,CD. MÉX.,"CUAUHTEMOC, CD. MÉX.",0,1,1,0,0,0,
08/11/2022,SIN.,"ELOTA, SIN.",1,0,1,0,0,0,
08/11/2022,CHIS.,"TUXTLA GUTIÉRREZ, CHIS.",1,0,1,1,0,94,
08/11/2022,MÉX.,"IXTAPALUCA, MEX.",1,0,1,0,0,25,
08/11/2022,COAH.,"NUEVA ROSITA, COAH.",1,0,1,0,0,0,
08/11/2022,VER.,"ACAYUCAN, VER.",1,0,1,0,1,0,
08/11/2022,CD. MÉX.,"GUSTAVO A. MADERO, CD. MÉX.",0,0,0,0,3,180,
09/11/2022,MÉX.,"COACALCO DE BERRIOZABAL, MEX.",231,0,231,0,0,0,
09/11/2022,MÉX.,"ZUMPANGO, MEX.",56,2,58,0,0,194,
09/11/2022,MÉX.,"IXTAPALUCA, MEX.",15,0,15,0,0,20,
09/11/2022,GTO.,"LEON, GTO.",8,4,12,0,0,0,
09/11/2022,MOR.,"AYALA, MOR.",4,0,4,0,0,0,
09/11/2022,VER.,"PAPANTLA, VER.",2,1,3,3,0,127,
09/11/2022,OAX.,"SANTIAGO PINOTEPA NACIONAL, OAX.",1,2,3,5,0,41,
09/11/2022,COAH.,"ACUÑA, COAH.",0,2,2,0,0,0,
09/11/2022,VER.,"ACAYUCAN, VER.",1,1,2,0,0,300,
09/11/2022,MÉX.,"SAN MARTIN DE LAS PIRAMIDES, MEX.",1,0,1,0,1,0,
09/11/2022,SIN.,"COSALA, SIN.",0,1,1,0,0,400,
09/11/2022,JAL.,"TOMATLAN, JAL.",0,1,1,0,0,0,
09/11/2022,JAL.,"MELAQUE, JAL.",1,0,1,0,0,0,
09/11/2022,CD. MÉX.,"CUAUHTEMOC, CD. MÉX.",0,0,0,0,0,66,
09/11/2022,CD. MÉX.,"IZTAPALAPA, CD. MÉX.",0,0,0,0,0,38,
09/11/2022,CD. MÉX.,"LA MAGDALENA CONTRERAS, CD. MÉX.",0,0,0,0,0,32,
09/11/2022,GRO.,"ACAPULCO DE JUAREZ, GRO.",0,0,0,0,4,67,
10/11/2022,MÉX.,"COACALCO DE BERRIOZABAL, MEX.",205,1,206,1,0,16,
10/11/2022,MÉX.,"ZUMPANGO, MEX.",21,0,21,0,0,0,
10/11/2022,GTO.,"LEON, GTO.",17,3,20,0,1,0,
10/11/2022,MÉX.,"IXTAPALUCA, MEX.",6,0,6,0,0,79,
10/11/2022,CHIS.,"SAN CRISTOBAL DE LAS CASAS, CHIS.",2,3,5,6,0,1306,
10/11/2022,CD. MÉX.,"GUSTAVO A. MADERO, CD. MÉX.",2,0,2,0,0,0,
10/11/2022,CHIS.,"TUXTLA GUTIÉRREZ, CHIS.",1,1,2,8,4,692,
10/11/2022,MOR.,"AYALA, MOR.",1,0,1,0,0,400,
10/11/2022,SIN.,"COSALA, SIN.",0,0,0,0,0,88,
10/11/2022,CHIS.,"BERRIOZÁBAL, CHIS.",0,0,0,0,0,187,
11/11/2022,MÉX.,"COACALCO DE BERRIOZABAL, MEX.",208,2,210,0,0,72,
11/11/2022,MÉX.,"ZUMPANGO, MEX.",101,0,101,0,0,0,
11/11/2022,GTO.,"LEON, GTO.",14,1,15,0,0,514,
11/11/2022,MÉX.,"IXTAPALUCA, MEX.",6,0,6,0,0,7,
11/11/2022,CD. MÉX.,"COYOACAN, CD. MÉX.",6,0,6,0,0,629,
11/11/2022,VER.,"PAPANTLA, VER.",4,1,5,5,0,145,
11/11/2022,MÉX.,"SAN MARTIN DE LAS PIRAMIDES, MEX.",2,0,2,0,0,0,
11/11/2022,JAL.,"AUTLAN DE NAVARRO, JAL.",0,1,1,0,0,0,
11/11/2022,JAL.,"PUERTO VALLARTA, JAL.",1,0,1,0,0,0,
11/11/2022,JAL.,"MELAQUE, JAL.",1,0,1,0,0,0,
11/11/2022,SIN.,"COSALA, SIN.",0,1,1,0,0,200,
11/11/2022,VER.,"ACAYUCAN, VER.",0,0,0,0,0,140,
12/11/2022,MÉX.,"COACALCO DE BERRIOZABAL, MEX.",255,0,255,0,0,0,
12/11/2022,MÉX.,"ZUMPANGO, MEX.",54,0,54,0,0,0,
12/11/2022,MÉX.,"SAN MARTIN DE LAS PIRAMIDES, MEX.",22,0,22,0,0,0,
12/11/2022,CHIS.,"CHENALHÓ, CHIS.",4,15,19,3,0,132,
12/11/2022,GTO.,"LEON, GTO.",5,7,12,0,5,0,
12/11/2022,MÉX.,"IXTAPALUCA, MEX.",10,0,10,0,0,0,
12/11/2022,VER.,"PAPANTLA, VER.",2,0,2,0,0,82,
13/11/2022,CHIS.,"CHENALHÓ, CHIS.",2,19,21,0,0,0,
13/11/2022,GTO.,"LEON, GTO.",8,0,8,0,0,0,
13/11/2022,VER.,"ACAYUCAN, VER.",1,1,2,0,0,634,
13/11/2022,VER.,"PAPANTLA, VER.",0,1,1,0,0,19,
13/11/2022,JAL.,"TOMATLAN, JAL.",1,0,1,0,0,170,
14/11/2022,GTO.,"LEON, GTO.",14,9,23,0,1,0,
14/11/2022,CD. MÉX.,"LA MAGDALENA CONTRERAS, CD. MÉX.",2,0,2,0,0,328,
14/11/2022,CD. MÉX.,"IZTAPALAPA, CD. MÉX.",2,0,2,0,0,82,
14/11/2022,HGO.,"CUAUTEPEC DE HINOJOSA, HGO.",2,0,2,1,0,0,
14/11/2022,CD. MÉX.,"CUAUHTEMOC, CD. MÉX.",1,0,1,0,0,44,
14/11/2022,AGS.,"CALVILLO, AGS.",0,1,1,0,0,0,
14/11/2022,VER.,"PAPANTLA, VER.",0,1,1,0,0,30,
14/11/2022,CD. MÉX.,"COYOACAN, CD. MÉX.",0,0,0,0,0,82,
15/11/2022,GTO.,"LEON, GTO.",15,8,23,0,1,0,
15/11/2022,CHIS.,"CHENALHÓ, CHIS.",3,13,16,2,0,64,
15/11/2022,CD. MÉX.,"CUAUHTEMOC, CD. MÉX.",1,1,2,0,1,0,
15/11/2022,CD. MÉX.,"IZTAPALAPA, CD. MÉX.",1,0,1,0,0,0,
15/11/2022,VER.,"PAPANTLA, VER.",0,1,1,2,0,306,
15/11/2022,CHIS.,"BERRIOZÁBAL, CHIS.",0,0,0,0,0,793,
15/11/2022,CD. MÉX.,"COYOACAN, CD. MÉX.",0,0,0,0,0,150,
15/11/2022,VER.,"ACAYUCAN, VER.",0,0,0,5,0,314,
15/11/2022,JAL.,"AUTLAN DE NAVARRO, JAL.",0,0,0,0,20,0,
15/11/2022,CHIS.,"TUXTLA CHICO, CHIS.",0,0,0,0,0,95,
16/11/2022,CD. MÉX.,"MILPA ALTA, CD. MÉX.",2,1,3,0,0,32,
16/11/2022,VER.,"PAPANTLA, VER.",0,2,2,0,0,0,
16/11/2022,JAL.,"TOMATLAN, JAL.",1,1,2,0,0,0,
16/11/2022,VER.,"ACAYUCAN, VER.",1,0,1,1,0,0,
16/11/2022,JAL.,"PUERTO VALLARTA, JAL.",1,0,1,0,0,0,
16/11/2022,HGO.,"CUAUTEPEC DE HINOJOSA, HGO.",1,0,1,5,1,64,
16/11/2022,CD. MÉX.,"COYOACAN, CD. MÉX.",0,0,0,0,0,17,
16/11/2022,CD. MÉX.,"IZTAPALAPA, CD. MÉX.",0,0,0,0,0,5,
16/11/2022,CHIS.,"BERRIOZÁBAL, CHIS.",0,0,0,0,0,323,
17/11/2022,CD. MÉX.,"MILPA ALTA, CD. MÉX.",3,0,3,0,0,0,
17/11/2022,CD. MÉX.,"COYOACAN, CD. MÉX.",2,1,3,0,0,11,
17/11/2022,JAL.,"PUERTO VALLARTA, JAL.",2,0,2,0,0,0,
17/11/2022,CD. MÉX.,"CUAUHTEMOC, CD. MÉX.",2,0,2,0,0,0,
17/11/2022,VER.,"PAPANTLA, VER.",1,1,2,11,0,0,
17/11/2022,JAL.,"TOMATLAN, JAL.",0,1,1,0,0,0,
17/11/2022,HGO.,"ATOTONILCO DE TULA, HGO.",1,0,1,1,0,0,
17/11/2022,CHIS.,"OSUMACINTA, CHIS.",0,0,0,0,0,222,
17/11/2022,CHIS.,"BERRIOZÁBAL, CHIS.",0,0,0,0,0,223,
18/11/2022,CD. MÉX.,"MILPA ALTA, CD. MÉX.",2,0,2,0,0,0,
18/11/2022,VER.,"PAPANTLA, VER.",1,1,2,0,0,1220,
18/11/2022,CD. MÉX.,"CUAUHTEMOC, CD. MÉX.",1,0,1,0,0,0,
18/11/2022,HGO.,"ATOTONILCO DE TULA, HGO.",1,0,1,1,0,39,
18/11/2022,VER.,"ACAYUCAN, VER.",1,0,1,7,0,117,
18/11/2022,CHIS.,"OCOSINGO, CHIS.",0,1,1,7,0,322,
18/11/2022,JAL.,"PUERTO VALLARTA, JAL.",1,0,1,0,0,0,
18/11/2022,CHIS.,"OSUMACINTA, CHIS.",0,0,0,0,0,515,
18/11/2022,CHIS.,"JIQUIPILAS, CHIS.",0,0,0,0,0,58,
18/11/2022,CHIS.,"TUXTLA CHICO, CHIS.",0,0,0,0,0,15,
19/11/2022,HGO.,"ATOTONILCO DE TULA, HGO.",0,0,0,0,0,82,
19/11/2022,CHIS.,"OSUMACINTA, CHIS.",0,0,0,0,0,240,
20/11/2022,CHIS.,"ARRIAGA, CHIS.",0,0,0,0,0,20,
21/11/2022,CHIS.,"OCOSINGO, CHIS.",3,0,3,2,0,125,
21/11/2022,CHIS.,"COAPILLA, CHIS.",0,0,0,0,0,40,
21/11/2022,CHIS.,"COAPILLA, CHIS.",0,0,0,0,0,40,
21/11/2022,CHIS.,"ARRIAGA, CHIS.",0,0,0,0,0,34,
22/11/2022,CD. MÉX.,"COYOACAN, CD. MÉX.",2,3,5,0,0,0,
22/11/2022,CHIS.,"COAPILLA, CHIS.",3,0,3,0,0,8,
22/11/2022,JAL.,"PUERTO VALLARTA, JAL.",1,0,1,0,0,0,
22/11/2022,CHIS.,"TONALÁ, CHIS.",0,0,0,0,0,24,
22/11/2022,CD. MÉX.,"MILPA ALTA, CD. MÉX.",0,0,0,0,0,3,
23/11/2022,CD. MÉX.,"CUAUHTEMOC, CD. MÉX.",4,1,5,0,0,304,
23/11/2022,CD. MÉX.,"TLAHUAC, CD. MÉX.",1,2,3,0,2,7,
23/11/2022,CD. MÉX.,"COYOACAN, CD. MÉX.",1,0,1,0,0,0,
23/11/2022,CHIS.,"CHIAPA DE CORZO, CHIS.",1,0,1,0,0,300,
23/11/2022,CHIS.,"COAPILLA, CHIS.",1,0,1,0,0,0,
23/11/2022,Q. ROO.,"BENITO JUAREZ, Q. ROO",0,0,0,0,0,2,
24/11/2022,N.L.,"SANTA CATARINA, N.L.",15,6,21,11,0,564,
24/11/2022,TAB.,"CARDENAS, TAB.",2,2,4,9,0,0,
24/11/2022,Q. ROO.,"BENITO JUAREZ, Q. ROO",2,1,3,4,0,2236,
24/11/2022,CD. MÉX.,"AZCAPOTZALCO, CD. MÉX.",1,1,2,0,0,0,
24/11/2022,TAB.,"HUIMANGUILLO, TAB.",1,1,2,0,0,0,
24/11/2022,CHIS.,"CHIAPA DE CORZO, CHIS.",1,0,1,0,0,246,
24/11/2022,CHIS.,"TONALÁ, CHIS.",1,0,1,0,0,0,
24/11/2022,CD. MÉX.,"TLAHUAC, CD. MÉX.",0,0,0,0,0,10,
24/11/2022,CHIS.,"COAPILLA, CHIS.",0,0,0,0,0,130,
24/11/2022,CHIS.,"OCOSINGO, CHIS.",0,0,0,4,0,150,
25/11/2022,TAB.,"CENTRO, TAB.",2,1,3,0,0,0,
25/11/2022,N.L.,"MONTERREY, N.L.",0,3,3,1,0,10,
25/11/2022,CD. MÉX.,"AZCAPOTZALCO, CD. MÉX.",0,2,2,0,0,10,
25/11/2022,N.L.,"SANTA CATARINA, N.L.",2,0,2,1,0,105,
25/11/2022,CD. MÉX.,"TLAHUAC, CD. MÉX.",1,0,1,0,0,0,
25/11/2022,JAL.,"PUERTO VALLARTA, JAL.",0,1,1,0,0,0,
25/11/2022,CHIS.,"TAPACHULA, CHIS.",1,0,1,0,0,122,
25/11/2022,Q. ROO.,"BENITO JUAREZ, Q. ROO",0,1,1,2,0,1265,
25/11/2022,CD. MÉX.,"MILPA ALTA, CD. MÉX.",0,0,0,0,0,11,
25/11/2022,CD. MÉX.,"CUAUHTEMOC, CD. MÉX.",0,0,0,0,0,233,
25/11/2022,CHIS.,"COPAINALÁ, CHIS.",0,0,0,0,0,66,
26/11/2022,JAL.,"PUERTO VALLARTA, JAL.",2,1,3,0,0,0,
26/11/2022,CHIS.,"COPAINALÁ, CHIS.",0,0,0,0,0,86,
26/11/2022,Q. ROO.,"BENITO JUAREZ, Q. ROO",0,0,0,5,0,123,
27/11/2022,Q. ROO.,"BENITO JUAREZ, Q. ROO",0,1,1,2,0,104,
28/11/2022,N.L.,"LINARES, N.L.",6,3,9,1,0,1223,
28/11/2022,SIN.,"NAVOLATO, SIN.",3,0,3,0,1,50,
28/11/2022,SIN.,"CULIACAN, SIN.",1,1,2,0,0,42,
28/11/2022,CHIS.,"CHIAPA DE CORZO, CHIS.",1,0,1,0,0,210,
28/11/2022,CHIS.,"COMITAN DE DOMÍNGUEZ, CHIS.",0,1,1,1,0,124,
29/11/2022,CD. MÉX.,"AZCAPOTZALCO, CD. MÉX.",6,3,9,0,0,123,
29/11/2022,SIN.,"CULIACAN, SIN.",6,1,7,0,0,192,
29/11/2022,N.L.,"LINARES, N.L.",3,0,3,0,0,0,
29/11/2022,CHIS.,"CHIAPA DE CORZO, CHIS.",0,0,0,0,0,58,
30/11/2022,SIN.,"CULIACAN, SIN.",4,1,5,0,2,36,
30/11/2022,CD. MÉX.,"CUAUHTEMOC, CD. MÉX.",0,2,2,0,0,0,
30/11/2022,N.L.,"LINARES, N.L.",2,0,2,0,0,60,
30/11/2022,SIN.,"NAVOLATO, SIN.",2,0,2,0,0,0,
30/11/2022,CD. MÉX.,"AZCAPOTZALCO, CD. MÉX.",1,0,1,0,0,0,
30/11/2022,CD. MÉX.,"TLAHUAC, CD. MÉX.",0,1,1,0,0,41,
30/11/2022,JAL.,"PUERTO VALLARTA, JAL.",1,0,1,3,0,23,
30/11/2022,JAL.,"MELAQUE, JAL.",0,1,1,0,0,0,
30/11/2022,CD. MÉX.,"ALVARO OBREGON, CD. MÉX.",0,0,0,0,0,1,
30/11/2022,CHIS.,"OCOSINGO, CHIS.",0,0,0,0,0,130,
01/12/2022,SIN.,"CULIACAN, SIN.",3,0,3,0,0,0,
01/12/2022,CD. MÉX.,"TLAHUAC, CD. MÉX.",0,1,1,0,0,0,
01/12/2022,B.C.,"SAN FELIPE, B.C.",1,0,1,3,0,23,
02/12/2022,CHIS.,"CHENALHÓ, CHIS.",3,6,9,11,0,5,
02/12/2022,SIN.,"CULIACAN, SIN.",4,0,4,0,0,98,
02/12/2022,CHIH.,"JUÁREZ, CHIH.",3,0,3,12,0,24,
02/12/2022,SIN.,"NAVOLATO, SIN.",1,1,2,0,0,4,
02/12/2022,JAL.,"MELAQUE, JAL.",1,0,1,0,0,0,
03/12/2022,CHIS.,"CHENALHÓ, CHIS.",5,18,23,0,0,122,
03/12/2022,CD. MÉX.,"ALVARO OBREGON, CD. MÉX.",3,0,3,0,0,0,
03/12/2022,S.L.P.,"ZARAGOZA, S.L.P.",1,0,1,0,0,0,
05/12/2022,SIN.,"CULIACAN, SIN.",3,2,5,0,0,67,
05/12/2022,CD. MÉX.,"VENUSTIANO CARRANZA, CD. MÉX.",1,0,1,0,0,45,
05/12/2022,CD. MÉX.,"TLAHUAC, CD. MÉX.",1,0,1,0,0,0,
05/12/2022,SON.,"HERMOSILLO, SON.",1,0,1,0,0,0,
05/12/2022,CHIH.,"JUÁREZ, CHIH.",0,0,0,10,1,40,
06/12/2022,CHIH.,"JUÁREZ, CHIH.",2,3,5,0,1,0,
06/12/2022,SIN.,"CULIACAN, SIN.",2,3,5,0,1,0,
06/12/2022,SON.,"HERMOSILLO, SON.",2,0,2,0,0,0,
06/12/2022,JAL.,"TOMATLAN, JAL.",1,1,2,0,0,0,
07/12/2022,CHIH.,"CHIH., CHIH.",4,2,6,6,0,153,
07/12/2022,SIN.,"CULIACAN, SIN.",4,1,5,0,1,0,
07/12/2022,CD. MÉX.,"GUSTAVO A. MADERO, CD. MÉX.",3,0,3,0,0,1,
07/12/2022,SON.,"HERMOSILLO, SON.",2,1,3,0,0,0,
07/12/2022,JAL.,"TOMATLAN, JAL.",1,1,2,0,0,0,
07/12/2022,CHIH.,"JUÁREZ, CHIH.",1,0,1,3,0,65,
08/12/2022,CHIH.,"NUEVO CASAS GRANDES, CHIH.",7,4,11,18,0,0,
08/12/2022,CHIH.,"CHIH., CHIH.",8,1,9,28,0,1304,
08/12/2022,SON.,"HERMOSILLO, SON.",1,2,3,3,0,0,
08/12/2022,SIN.,"CULIACAN, SIN.",1,1,2,0,0,2,
08/12/2022,S.L.P.,"ZARAGOZA, S.L.P.",2,0,2,0,1,0,
08/12/2022,JAL.,"TOMATLAN, JAL.",1,1,2,0,0,0,
08/12/2022,CHIH.,"JUÁREZ, CHIH.",0,1,1,0,0,0,
08/12/2022,CD. MÉX.,"ALVARO OBREGON, CD. MÉX.",0,0,0,0,0,3,
09/12/2022,CHIH.,"CHIH., CHIH.",11,4,15,6,0,644,
09/12/2022,CHIH.,"NUEVO CASAS GRANDES, CHIH.",4,3,7,3,0,201,
09/12/2022,SIN.,"NAVOLATO, SIN.",1,3,4,0,0,9,
09/12/2022,SIN.,"CULIACAN, SIN.",1,1,2,0,1,721,
09/12/2022,SON.,"HERMOSILLO, SON.",1,1,2,0,1,400,
09/12/2022,CD. MÉX.,"VENUSTIANO CARRANZA, CD. MÉX.",1,0,1,0,0,79,
09/12/2022,CHIH.,"JUÁREZ, CHIH.",1,0,1,7,0,60,
09/12/2022,CHIH.,"OJINAGA, CHIH.",1,0,1,1,0,0,
09/12/2022,S.L.P.,"ZARAGOZA, S.L.P.",0,1,1,0,0,0,
09/12/2022,CHIS.,"JIQUIPILAS, CHIS.",0,0,0,0,0,14,
09/12/2022,JAL.,"TOMATLAN, JAL.",0,0,0,0,1,0,
10/12/2022,CHIH.,"CHIH., CHIH.",5,0,5,18,1,1013,
10/12/2022,CHIH.,"OJINAGA, CHIH.",0,5,5,0,0,0,
10/12/2022,CHIH.,"NUEVO CASAS GRANDES, CHIH.",3,0,3,4,1,11,
12/12/2022,SON.,"HERMOSILLO, SON.",0,1,1,0,1,0,
13/12/2022,SON.,"HERMOSILLO, SON.",4,2,6,1,0,400,
13/12/2022,SIN.,"CULIACAN, SIN.",4,0,4,0,0,177,
13/12/2022,CD. MÉX.,"VENUSTIANO CARRANZA, CD. MÉX.",2,0,2,0,0,10,
13/12/2022,CHIH.,"JUÁREZ, CHIH.",1,1,2,5,0,40,
13/12/2022,CD. MÉX.,"GUSTAVO A. MADERO, CD. MÉX.",1,0,1,0,0,0,
13/12/2022,TAMPS.,"MATAMOROS, TAMPS.",1,0,1,0,0,0,
13/12/2022,CHIS.,"CINTALAPA, CHIS.",0,0,0,1,0,46,
14/12/2022,CHIH.,"JUÁREZ, CHIH.",2,1,3,11,0,126,
14/12/2022,CD. MÉX.,"COYOACAN, CD. MÉX.",3,0,3,0,0,53,
14/12/2022,SON.,"HERMOSILLO, SON.",2,0,2,4,0,2000,
14/12/2022,N.L.,"ALLENDE, N.L.",2,0,2,0,0,84,
14/12/2022,SIN.,"CULIACAN, SIN.",1,0,1,0,0,971,
14/12/2022,CD. MÉX.,"VENUSTIANO CARRANZA, CD. MÉX.",0,0,0,0,0,143,
15/12/2022,SIN.,"CULIACAN, SIN.",4,1,5,0,0,250,
15/12/2022,SON.,"HERMOSILLO, SON.",3,1,4,4,0,0,
15/12/2022,MICH.,"ZAMORA, MICH.",1,2,3,0,0,17,
15/12/2022,CHIH.,"JUÁREZ, CHIH.",3,0,3,6,0,0,
15/12/2022,CD. MÉX.,"COYOACAN, CD. MÉX.",0,1,1,0,0,40,
15/12/2022,CD. MÉX.,"VENUSTIANO CARRANZA, CD. MÉX.",0,0,0,0,0,196,
16/12/2022,MICH.,"ZAMORA, MICH.",3,5,8,1,0,182,
16/12/2022,SON.,"HERMOSILLO, SON.",5,1,6,8,1,150,
16/12/2022,MICH.,"MORELIA, MICH.",2,0,2,0,2,0,
16/12/2022,CD. MÉX.,"COYOACAN, CD. MÉX.",0,2,2,0,0,302,
16/12/2022,SIN.,"CULIACAN, SIN.",2,0,2,0,2,1971,
16/12/2022,SIN.,"CULIACAN, SIN.",2,0,2,0,2,1971,
16/12/2022,CHIH.,"JUÁREZ, CHIH.",1,0,1,16,0,170,
16/12/2022,CHIS.,"CINTALAPA, CHIS.",0,0,0,0,3,0,
16/12/2022,CD. MÉX.,"GUSTAVO A. MADERO, CD. MÉX.",0,0,0,0,0,36,
16/12/2022,N.L.,"ALLENDE, N.L.",0,0,0,0,0,320,
17/12/2022,MICH.,"ZAMORA, MICH.",3,4,7,3,1,433,
17/12/2022,MICH.,"MORELIA, MICH.",3,2,5,0,2,122,
28/12/2022,CHIS.,"ARRIAGA, CHIS.",0,0,0,0,0,7,
30/12/2022,CHIS.,"ARRIAGA, CHIS.",0,0,0,0,0,46,
25/01/2023,Jalisco,"AUTLAN DE NAVARRO, JAL.",0,3,3,0,0,0,
27/01/2023,Jalisco,"AUTLAN DE NAVARRO, JAL.",1,0,1,0,0,0,
04/02/2023,Jalisco,"CUAUTITLAN DE GARCIA BARRAGAN, JAL.",1,0,1,0,0,0,
07/02/2023,Cd. de México,"TLAHUAC, CD. MÉX.",1,1,2,0,0,0,
08/02/2023,Cd. de México,"ALVARO OBREGON, CD. MÉX.",5,0,5,0,0,132,
09/02/2023,Cd. de México,"TLAHUAC, CD. MÉX.",3,0,3,0,11,114,
09/02/2023,Cd. de México,"ALVARO OBREGON, CD. MÉX.",2,1,3,0,0,206,
09/02/2023,Jalisco,"AUTLAN DE NAVARRO, JAL.",1,0,1,0,0,0,
10/02/2023,Cd. de México,"ALVARO OBREGON, CD. MÉX.",1,0,1,0,0,90,
10/02/2023,Cd. de México,"TLALPAN, CD. MÉX.",1,0,1,0,0,884,
13/02/2023,Cd. de México,"TLALPAN, CD. MÉX.",4,0,4,0,0,99,
13/02/2023,Cd. de México,"ALVARO OBREGON, CD. MÉX.",2,0,2,0,0,0,
13/02/2023,Tamaulipas,"NUEVO LAREDO, TAMPS.",0,0,0,2,0,96,
14/02/2023,Tamaulipas,"NUEVO LAREDO, TAMPS.",0,1,1,1,0,114,
14/02/2023,Cd. de México,"TLALPAN, CD. MÉX.",1,0,1,0,0,52,
15/02/2023,Cd. de México,"BENITO JUAREZ, CD. MÉX.",1,1,2,0,0,0,
15/02/2023,Cd. de México,"TLAHUAC, CD. MÉX.",1,0,1,0,0,223,
15/02/2023,Tamaulipas,"NUEVO LAREDO, TAMPS.",0,0,0,1,0,95,
16/02/2023,Cd. de México,"ALVARO OBREGON, CD. MÉX.",1,0,1,0,0,0,
16/02/2023,Cd. de México,"ALVARO OBREGON, CD. MÉX.",1,0,1,0,0,0,
16/02/2023,Tamaulipas,"NUEVO LAREDO, TAMPS.",0,1,1,2,0,652,
16/02/2023,Cd. de México,"TLAHUAC, CD. MÉX.",0,0,0,0,0,22,
17/02/2023,Cd. de México,"COYOACAN, CD. MÉX.",3,0,3,0,0,9,
17/02/2023,Cd. de México,"ALVARO OBREGON, CD. MÉX.",2,0,2,0,0,0,
17/02/2023,Cd. de México,"BENITO JUAREZ, CD. MÉX.",2,0,2,0,0,38,
17/02/2023,Tamaulipas,"NUEVO LAREDO, TAMPS.",1,0,1,6,0,363,
20/02/2023,Cd. de México,"ALVARO OBREGON, CD. MÉX.",1,0,1,0,0,0,
20/02/2023,Cd. de México,"BENITO JUAREZ, CD. MÉX.",1,0,1,0,0,32,
20/02/2023,Tamaulipas,"NUEVO LAREDO, TAMPS.",0,0,0,2,0,123,
21/02/2023,Cd. de México,"BENITO JUAREZ, CD. MÉX.",1,2,3,0,0,73,
21/02/2023,Cd. de México,"TLALPAN, CD. MÉX.",1,1,2,0,0,102,
21/02/2023,Tamaulipas,"NUEVO LAREDO, TAMPS.",0,0,0,10,0,450,
22/02/2023,Cd. de México,"TLALPAN, CD. MÉX.",1,1,2,0,0,0,
22/02/2023,Cd. de México,"BENITO JUAREZ, CD. MÉX.",0,0,0,0,3,0,
22/02/2023,Cd. de México,"CUAUHTEMOC, CD. MÉX.",0,0,0,0,0,106,
23/02/2023,Cd. de México,"BENITO JUAREZ, CD. MÉX.",4,0,4,0,0,83,
23/02/2023,Cd. de México,"CUAUHTEMOC, CD. MÉX.",2,0,2,0,0,120,
23/02/2023,Tamaulipas,"NUEVO LAREDO, TAMPS.",0,0,0,11,0,564,
24/02/2023,Cd. de México,"BENITO JUAREZ, CD. MÉX.",3,0,3,0,3,305,
24/02/2023,Cd. de México,"CUAUHTEMOC, CD. MÉX.",0,0,0,0,0,77,
24/02/2023,Cd. de México,"AZCAPOTZALCO, CD. MÉX.",0,0,0,0,0,11,
27/02/2023,Tamaulipas,"NUEVO LAREDO, TAMPS.",1,0,1,0,0,0,
27/02/2023,Cd. de México,"CUAUHTEMOC, CD. MÉX.",1,0,1,0,0,55,
27/02/2023,Cd. de México,"AZCAPOTZALCO, CD. MÉX.",1,0,1,0,0,1,
28/02/2023,Morelos,"ZACATEPEC, MOR.",1,1,2,1,0,6,
28/02/2023,Cd. de México,"IZTAPALAPA, CD. MÉX.",0,0,0,0,0,612,
28/02/2023,Tamaulipas,"NUEVO LAREDO, TAMPS.",0,0,0,3,0,56,
01/03/2023,Cd. de México,"CUAUHTEMOC, CD. MÉX.",4,0,4,0,0,521,
01/03/2023,Morelos,"ZACATEPEC, MOR.",0,1,1,0,0,0,
02/03/2023,Cd. de México,"IZTAPALAPA, CD. MÉX.",3,1,4,0,0,40,
02/03/2023,Morelos,"ZACATEPEC, MOR.",2,0,2,0,0,0,
02/03/2023,Coahuila,"ACUÑA, COAH.",0,0,0,4,0,0,
03/03/2023,Cd. de México,"IZTAPALAPA, CD. MÉX.",1,0,1,0,0,0,
03/03/2023,Veracruz,"LA PERLA, VER.",1,0,1,0,0,0,
03/03/2023,Chiapas,"COMITAN DE DOMÍNGUEZ, CHIS.",1,0,1,0,0,165,
03/03/2023,Coahuila,"ACUÑA, COAH.",0,1,1,0,0,0,
03/03/2023,Cd. de México,"CUAUHTEMOC, CD. MÉX.",0,1,1,0,0,9,
04/03/2023,Veracruz,"JALTIPAN, VER.",1,0,1,0,0,"10,882",
05/03/2023,Veracruz,"JALTIPAN, VER.",2,2,4,0,0,"13,058",
05/03/2023,Veracruz,"LA PERLA, VER.",1,0,1,0,0,0,
06/03/2023,México,"ECATEPEC DE MORELOS, MEX.",68,0,68,0,0,4,
06/03/2023,Cd. de México,"IZTACALCO, CD. MÉX.",1,1,2,0,0,10,
06/03/2023,México,"COACALCO DE BERRIOZABAL, MEX.",2,0,2,1,0,12,
06/03/2023,México,"NEZAHUALCOYOTL, MEX.",1,1,2,0,11,0,
06/03/2023,Cd. de México,"CUAUHTEMOC, CD. MÉX.",0,1,1,0,0,0,
06/03/2023,Veracruz,"JALTIPAN, VER.",0,0,0,2,0,"8,900",
06/03/2023,Chiapas,"COMITAN DE DOMÍNGUEZ, CHIS.",0,0,0,0,0,78,
06/03/2023,Cd. de México,"IZTAPALAPA, CD. MÉX.",0,0,0,0,0,110,
06/03/2023,Coahuila,"ACUÑA, COAH.",0,0,0,1,0,12,
07/03/2023,México,"ECATEPEC DE MORELOS, MEX.",48,0,48,0,0,269,
07/03/2023,Veracruz,"JALTIPAN, VER.",3,1,4,0,0,"11,119",
07/03/2023,México,"ATIZAPAN, MEX.",3,0,3,0,0,51,
07/03/2023,México,"NEZAHUALCOYOTL, MEX.",2,1,3,0,0,82,
07/03/2023,México,"COACALCO DE BERRIOZABAL, MEX.",1,1,2,0,0,0,
07/03/2023,Cd. de México,"IZTAPALAPA, CD. MÉX.",1,0,1,0,0,0,
07/03/2023,Cd. de México,"CUAUHTEMOC, CD. MÉX.",1,0,1,0,0,66,
07/03/2023,Cd. de México,"IZTACALCO, CD. MÉX.",1,0,1,0,0,2,
07/03/2023,Coahuila,"ACUÑA, COAH.",0,0,0,1,0,12,
08/03/2023,México,"NEZAHUALCOYOTL, MEX.",8,1,9,0,0,273,
08/03/2023,Cd. de México,"CUAUHTEMOC, CD. MÉX.",3,0,3,0,0,18,
08/03/2023,México,"COACALCO DE BERRIOZABAL, MEX.",1,0,1,0,0,0,
08/03/2023,Cd. de México,"AZCAPOTZALCO, CD. MÉX.",1,0,1,0,0,46,
08/03/2023,México,"ATIZAPAN, MEX.",1,0,1,0,0,6,
08/03/2023,Chiapas,"COMITAN DE DOMÍNGUEZ, CHIS.",0,0,0,0,0,80,
08/03/2023,Veracruz,"JALTIPAN, VER.",0,0,0,10,0,"17,000",
09/03/2023,Cd. de México,"AZCAPOTZALCO, CD. MÉX.",0,4,4,0,0,168,
09/03/2023,México,"NEZAHUALCOYOTL, MEX.",3,1,4,0,1,255,
09/03/2023,Cd. de México,"CUAUHTEMOC, CD. MÉX.",2,0,2,0,0,41,
09/03/2023,Veracruz,"JALTIPAN, VER.",2,0,2,3,0,"11,333",
09/03/2023,México,"ECATEPEC DE MORELOS, MEX.",2,0,2,0,0,104,
09/03/2023,Coahuila,"ACUÑA, COAH.",0,1,1,0,0,0,
09/03/2023,México,"ATIZAPAN, MEX.",1,0,1,0,0,51,
09/03/2023,México,"COACALCO DE BERRIOZABAL, MEX.",1,0,1,1,0,52,
09/03/2023,Chiapas,"COMITAN DE DOMÍNGUEZ, CHIS.",0,0,0,5,0,344,
10/03/2023,México,"ATIZAPAN, MEX.",7,0,7,0,0,29,
10/03/2023,México,"NEZAHUALCOYOTL, MEX.",4,0,4,0,5,55,
10/03/2023,México,"ECATEPEC DE MORELOS, MEX.",3,0,3,0,2,5,
10/03/2023,Cd. de México,"CUAUHTEMOC, CD. MÉX.",2,0,2,0,0,46,
10/03/2023,Cd. de México,"IZTACALCO, CD. MÉX.",1,0,1,0,0,0,
10/03/2023,Veracruz,"JALTIPAN, VER.",1,0,1,1,0,"4,957",
10/03/2023,Cd. de México,"IZTAPALAPA, CD. MÉX.",0,1,1,0,0,0,
10/03/2023,Tamaulipas,"NUEVO LAREDO, TAMPS.",0,0,0,3,0,417,
10/03/2023,Veracruz,"LA PERLA, VER.",0,0,0,7,0,18,
10/03/2023,Cd. de México,"MIGUEL HIDALGO, CD. MÉX.",0,0,0,0,0,11,
11/03/2023,México,"COACALCO DE BERRIOZABAL, MEX.",65,0,65,0,0,0,
11/03/2023,México,"ATIZAPAN, MEX.",57,0,57,0,0,0,
11/03/2023,México,"ECATEPEC DE MORELOS, MEX.",51,0,51,0,0,0,
11/03/2023,México,"NEZAHUALCOYOTL, MEX.",7,2,9,0,0,164,
11/03/2023,Veracruz,"JALTIPAN, VER.",2,0,2,0,0,"2,107",
11/03/2023,Veracruz,"LA PERLA, VER.",0,0,0,0,0,56,
12/03/2023,Veracruz,"JALTIPAN, VER.",0,0,0,41,0,301,
13/03/2023,México,"COACALCO DE BERRIOZABAL, MEX.",59,0,59,0,0,0,
13/03/2023,México,"ECATEPEC DE MORELOS, MEX.",51,0,51,0,0,5,
13/03/2023,México,"ATIZAPAN, MEX.",50,0,50,1,0,48,
13/03/2023,Chihuahua,"CHIHUAHUA, CHIH.",3,0,3,11,0,0,
13/03/2023,Cd. de México,"CUAUHTEMOC, CD. MÉX.",1,1,2,0,0,50,
13/03/2023,Cd. de México,"IZTACALCO, CD. MÉX.",0,0,0,0,0,11,
13/03/2023,Veracruz,"JALTIPAN, VER.",0,0,0,30,0,"1,398",
13/03/2023,México,"IXTAPALUCA, MEX.",0,0,0,0,0,186,
14/03/2023,México,"ECATEPEC DE MORELOS, MEX.",74,0,74,0,0,0,
14/03/2023,México,"COACALCO DE BERRIOZABAL, MEX.",51,0,51,0,0,0,
14/03/2023,Chihuahua,"CHIHUAHUA, CHIH.",3,0,3,27,0,369,
14/03/2023,México,"IXTAPALUCA, MEX.",1,1,2,0,0,186,
14/03/2023,México,"IXTAPALUCA, MEX.",1,1,2,0,0,186,
14/03/2023,Cd. de México,"MIGUEL HIDALGO, CD. MÉX.",0,2,2,0,0,0,
14/03/2023,Cd. de México,"IZTACALCO, CD. MÉX.",1,1,2,0,0,156,
14/03/2023,Veracruz,"JALTIPAN, VER.",1,0,1,27,0,"4,287",
14/03/2023,Cd. de México,"IZTAPALAPA, CD. MÉX.",1,0,1,0,0,0,
14/03/2023,Chiapas,"COMITAN DE DOMÍNGUEZ, CHIS.",0,1,1,2,0,179,
14/03/2023,Tamaulipas,"NUEVO LAREDO, TAMPS.",0,0,0,2,0,300,
14/03/2023,México,"ATIZAPAN, MEX.",0,0,0,0,0,855,
15/03/2023,México,"ECATEPEC DE MORELOS, MEX.",19,0,19,0,0,0,
15/03/2023,México,"COACALCO DE BERRIOZABAL, MEX.",10,0,10,0,0,0,
15/03/2023,México,"ATIZAPAN, MEX.",10,0,10,0,0,0,
15/03/2023,México,"IXTAPALUCA, MEX.",4,1,5,0,0,45,
15/03/2023,Veracruz,"JALTIPAN, VER.",3,0,3,16,0,"17,047",
15/03/2023,Chihuahua,"CHIHUAHUA, CHIH.",3,0,3,12,0,492,
15/03/2023,Cd. de México,"GUSTAVO A. MADERO, CD. MÉX.",2,0,2,0,0,26,
15/03/2023,Cd. de México,"IZTAPALAPA, CD. MÉX.",1,0,1,0,0,0,
15/03/2023,Tamaulipas,"NUEVO LAREDO, TAMPS.",0,0,0,9,0,148,
15/03/2023,Tamaulipas,"NUEVO LAREDO, TAMPS.",0,0,0,7,0,300,
15/03/2023,Chiapas,"COMITAN DE DOMÍNGUEZ, CHIS.",0,0,0,0,1,188,
16/03/2023,México,"ECATEPEC DE MORELOS, MEX.",20,0,20,0,0,0,
16/03/2023,México,"COACALCO DE BERRIOZABAL, MEX.",10,0,10,0,0,0,
16/03/2023,Chihuahua,"CHIHUAHUA, CHIH.",5,0,5,31,0,198,
16/03/2023,México,"IXTAPALUCA, MEX.",3,1,4,0,1,23,
16/03/2023,Cd. de México,"IZTACALCO, CD. MÉX.",1,0,1,0,0,158,
16/03/2023,Veracruz,"JALTIPAN, VER.",0,1,1,68,0,"3,053",
16/03/2023,Cd. de México,"MIGUEL HIDALGO, CD. MÉX.",0,0,0,0,0,290,
17/03/2023,México,"ATIZAPAN, MEX.",14,0,14,0,0,0,
17/03/2023,Chihuahua,"CHIHUAHUA, CHIH.",5,1,6,25,0,442,
17/03/2023,Veracruz,"JALTIPAN, VER.",3,0,3,24,0,"6,358",
17/03/2023,Cd. de México,"CUAUHTEMOC, CD. MÉX.",2,1,3,0,0,105,
17/03/2023,Cd. de México,"IZTAPALAPA, CD. MÉX.",1,0,1,0,0,34,
17/03/2023,México,"ECATEPEC DE MORELOS, MEX.",1,0,1,0,0,0,
17/03/2023,México,"IXTAPALUCA, MEX.",0,0,0,0,0,"2,000",
17/03/2023,Coahuila,"ACUÑA, COAH.",0,0,0,0,3,90,
18/03/2023,México,"ECATEPEC DE MORELOS, MEX.",13,0,13,0,0,343,
18/03/2023,México,"ATIZAPAN, MEX.",10,0,10,0,0,100,
18/03/2023,Chihuahua,"CHIHUAHUA, CHIH.",5,4,9,9,0,9,
18/03/2023,México,"IXTAPALUCA, MEX.",3,1,4,0,2,155,
18/03/2023,México,"COACALCO DE BERRIOZABAL, MEX.",1,0,1,0,0,89,
21/03/2023,México,"TOLUCA, MEX.",13,1,14,0,0,"1,331",
21/03/2023,Chihuahua,"CHIHUAHUA, CHIH.",7,5,12,32,0,574,
21/03/2023,México,"SAN MATEO ATENCO, MEX.",8,1,9,0,0,0,
21/03/2023,México,"NAUCALPAN DE JUAREZ, MEX.",5,1,6,0,0,0,
21/03/2023,Cd. de México,"MIGUEL HIDALGO, CD. MÉX.",3,1,4,0,0,94,
21/03/2023,México,"CUAUTITLAN, MEX.",3,1,4,0,0,0,
21/03/2023,Coahuila,"ACUÑA, COAH.",0,3,3,2,0,57,
21/03/2023,Cd. de México,"LA MAGDALENA CONTRERAS, CD. MÉX.",2,0,2,0,0,0,
22/03/2023,México,"SAN MATEO ATENCO, MEX.",11,0,11,0,0,90,
22/03/2023,Chihuahua,"CHIHUAHUA, CHIH.",7,3,10,24,0,224,
22/03/2023,México,"CUAUTITLAN, MEX.",8,0,8,0,0,273,
22/03/2023,Cd. de México,"LA MAGDALENA CONTRERAS, CD. MÉX.",3,0,3,0,0,0,
22/03/2023,México,"TOLUCA, MEX.",2,0,2,0,0,68,
22/03/2023,Cd. de México,"GUSTAVO A. MADERO, CD. MÉX.",1,0,1,0,0,0,
23/03/2023,México,"SAN MATEO ATENCO, MEX.",15,1,16,0,0,0,
23/03/2023,México,"NAUCALPAN DE JUAREZ, MEX.",0,7,7,0,1,0,
23/03/2023,Cd. de México,"MIGUEL HIDALGO, CD. MÉX.",1,5,6,0,0,722,
23/03/2023,Cd. de México,"LA MAGDALENA CONTRERAS, CD. MÉX.",5,0,5,0,0,65,
23/03/2023,México,"CUAUTITLAN IZCALLI, MEX.",2,0,2,0,0,0,
23/03/2023,Cd. de México,"CUAUHTEMOC, CD. MÉX.",2,0,2,0,0,303,
23/03/2023,México,"TOLUCA, MEX.",0,2,2,0,0,15,
23/03/2023,Coahuila,"ACUÑA, COAH.",2,0,2,2,2,137,
23/03/2023,Chiapas,"LA TRINITARIA, CHIS.",1,1,2,4,0,102,
23/03/2023,Cd. de México,"GUSTAVO A. MADERO, CD. MÉX.",1,0,1,0,0,113,
23/03/2023,Guanajuato,"SAN DIEGO DE LA UNION, GTO.",1,0,1,0,0,0,
23/03/2023,Veracruz,"MARTINEZ DE LA TORRE, VER.",0,0,0,20,0,"1,989",
23/03/2023,Chihuahua,"CHIHUAHUA, CHIH.",0,0,0,18,0,50,
24/03/2023,México,"CUAUTITLAN IZCALLI, MEX.",16,0,16,0,0,567,
24/03/2023,México,"NAUCALPAN DE JUAREZ, MEX.",1,15,16,0,0,421,
24/03/2023,México,"TOLUCA, MEX.",4,5,9,0,0,"1,159",
24/03/2023,Cd. de México,"LA MAGDALENA CONTRERAS, CD. MÉX.",5,1,6,0,0,447,
24/03/2023,Cd. de México,"CUAUHTEMOC, CD. MÉX.",3,1,4,0,0,39,
24/03/2023,Coahuila,"ACUÑA, COAH.",0,2,2,1,0,0,
24/03/2023,Cd. de México,"TLAHUAC, CD. MÉX.",1,0,1,0,0,0,
24/03/2023,México,"SAN MATEO ATENCO, MEX.",0,0,0,0,0,8,
25/03/2023,México,"CUAUTITLAN IZCALLI, MEX.",2,0,2,0,0,0,
25/03/2023,México,"NAUCALPAN DE JUAREZ, MEX.",1,0,1,0,0,0,
25/03/2023,Guanajuato,"SAN LUIS DE LA PAZ, GTO.",0,0,0,0,2,0,
27/03/2023,México,"NAUCALPAN DE JUAREZ, MEX.",4,0,4,0,0,4,
27/03/2023,México,"CUAUTITLAN IZCALLI, MEX.",1,3,4,0,0,244,
27/03/2023,México,"TOLUCA, MEX.",2,1,3,2,0,107,
27/03/2023,Cd. de México,"CUAUHTEMOC, CD. MÉX.",1,1,2,0,0,168,
27/03/2023,Cd. de México,"LA MAGDALENA CONTRERAS, CD. MÉX.",1,0,1,0,0,0,
27/03/2023,Chiapas,"LA TRINITARIA, CHIS.",0,1,1,1,0,204,
27/03/2023,Guanajuato,"SAN DIEGO DE LA UNION, GTO.",1,0,1,0,0,0,
27/03/2023,Coahuila,"PIEDRAS NEGRAS, COAH.",0,1,1,0,0,0,
27/03/2023,Guanajuato,"SAN LUIS DE LA PAZ, GTO.",0,0,0,0,2,0,
28/03/2023,México,"TLALNEPANTLA DE BAZ, MEX.",1,7,8,0,0,14,
28/03/2023,Coahuila,"PIEDRAS NEGRAS, COAH.",3,4,7,0,0,550,
28/03/2023,Cd. de México,"TLAHUAC, CD. MÉX.",1,2,3,0,0,95,
28/03/2023,México,"CUAUTITLAN IZCALLI, MEX.",2,0,2,0,0,81,
28/03/2023,Coahuila,"PIEDRAS NEGRAS, COAH.",2,0,2,0,0,0,
28/03/2023,México,"TOLUCA, MEX.",2,0,2,0,0,9,
28/03/2023,México,"NAUCALPAN DE JUAREZ, MEX.",1,0,1,0,0,0,
28/03/2023,Cd. de México,"CUAUHTEMOC, CD. MÉX.",0,0,0,0,0,6,
29/03/2023,Cd. de México,"ALVARO OBREGON, CD. MÉX.",4,1,5,0,0,11,
29/03/2023,México,"TLALNEPANTLA DE BAZ, MEX.",1,3,4,0,1,0,
29/03/2023,México,"NAUCALPAN DE JUAREZ, MEX.",1,1,2,0,0,0,
29/03/2023,Cd. de México,"TLAHUAC, CD. MÉX.",1,0,1,0,1,3,
29/03/2023,México,"CUAUTITLAN IZCALLI, MEX.",1,0,1,0,4,0,
29/03/2023,México,"TOLUCA, MEX.",1,0,1,0,0,0,
29/03/2023,Cd. de México,"LA MAGDALENA CONTRERAS, CD. MÉX.",0,0,0,0,0,77,
30/03/2023,Cd. de México,"ALVARO OBREGON, CD. MÉX.",2,1,3,0,0,0,
30/03/2023,Coahuila,"PIEDRAS NEGRAS, COAH.",2,0,2,0,0,6,
30/03/2023,Cd. de México,"LA MAGDALENA CONTRERAS, CD. MÉX.",1,0,1,0,0,0,
30/03/2023,México,"NAUCALPAN DE JUAREZ, MEX.",1,0,1,0,0,0,
30/03/2023,México,"TLALNEPANTLA DE BAZ, MEX.",0,1,1,0,0,219,
30/03/2023,México,"CUAUTITLAN IZCALLI, MEX.",1,0,1,0,0,0,
31/03/2023,México,"CUAUTITLAN IZCALLI, MEX.",21,0,21,0,0,44,
31/03/2023,Cd. de México,"AZCAPOTZALCO, CD. MÉX.",2,1,3,0,0,247,
31/03/2023,México,"TLALNEPANTLA DE BAZ, MEX.",3,0,3,0,0,50,
31/03/2023,México,"NAUCALPAN DE JUAREZ, MEX.",2,0,2,0,0,137,
31/03/2023,Coahuila,"MONCLOVA, COAH.",0,1,1,0,0,1,
31/03/2023,Cd. de México,"LA MAGDALENA CONTRERAS, CD. MÉX.",1,0,1,0,0,0,
31/03/2023,Cd. de México,"ALVARO OBREGON, CD. MÉX.",1,0,1,0,0,28,
31/03/2023,México,"TOLUCA, MEX.",0,1,1,0,0,0,
31/03/2023,Cd. de México,"TLAHUAC, CD. MÉX.",0,0,0,0,0,179,
31/03/2023,Coahuila,"ACUÑA, COAH.",0,0,0,0,0,269,
31/03/2023,Coahuila,"PIEDRAS NEGRAS, COAH.",0,0,0,0,0,49,
01/04/2023,México,"CUAUTITLAN IZCALLI, MEX.",26,0,26,0,0,0,
01/04/2023,México,"NAUCALPAN DE JUAREZ, MEX.",18,0,18,0,0,0,
01/04/2023,México,"TLALNEPANTLA DE BAZ, MEX.",7,1,8,0,0,658,
01/04/2023,México,"TOLUCA, MEX.",0,0,0,0,0,2,
10/04/2023,Cd. de México,"ALVARO OBREGON, CD. MÉX.",7,1,8,0,0,"1,002",
10/04/2023,Cd. de México,"CUAUHTEMOC, CD. MÉX.",4,0,4,0,0,598,
10/04/2023,Coahuila,"PIEDRAS NEGRAS, COAH.",1,0,1,1,0,11,
11/04/2023,Cd. de México,"CUAUHTEMOC, CD. MÉX.",6,1,7,0,0,199,
11/04/2023,Cd. de México,"ALVARO OBREGON, CD. MÉX.",5,1,6,0,1,132,
11/04/2023,Cd. de México,"AZCAPOTZALCO, CD. MÉX.",1,1,2,0,0,0,
11/04/2023,Cd. de México,"TLAHUAC, CD. MÉX.",1,0,1,0,0,0,
11/04/2023,Guanajuato,"ACAMBARO, GTO.",1,0,1,0,0,0,
12/04/2023,Cd. de México,"CUAUHTEMOC, CD. MÉX.",3,1,4,0,0,201,
12/04/2023,Guanajuato,"DOLORES HIDALGO CUNA DE LA INDEPENDENCIA NACIONAL, GTO.",2,2,4,0,0,0,
12/04/2023,Cd. de México,"ALVARO OBREGON, CD. MÉX.",3,0,3,0,0,3,
12/04/2023,Cd. de México,"TLALPAN, CD. MÉX.",0,0,0,0,0,17,
13/04/2023,Cd. de México,"CUAUHTEMOC, CD. MÉX.",3,2,5,0,0,0,
13/04/2023,Cd. de México,"ALVARO OBREGON, CD. MÉX.",1,3,4,0,0,0,
13/04/2023,Guanajuato,"ACAMBARO, GTO.",2,0,2,0,0,0,
13/04/2023,Cd. de México,"TLALPAN, CD. MÉX.",1,1,2,0,0,77,
13/04/2023,Morelos,"TEMIXCO, MOR.",1,0,1,0,0,0,
13/04/2023,Cd. de México,"AZCAPOTZALCO, CD. MÉX.",1,0,1,0,0,0,
14/04/2023,Cd. de México,"BENITO JUAREZ, CD. MÉX.",6,2,8,0,0,"1,636",
14/04/2023,Cd. de México,"CUAUHTEMOC, CD. MÉX.",6,2,8,0,0,427,
14/04/2023,Cd. de México,"TLALPAN, CD. MÉX.",0,1,1,0,0,0,
17/04/2023,Cd. de México,"BENITO JUAREZ, CD. MÉX.",3,1,4,0,0,715,
17/04/2023,Cd. de México,"CUAUHTEMOC, CD. MÉX.",0,0,0,0,0,143,
18/04/2023,Cd. de México,"TLALPAN, CD. MÉX.",3,1,4,0,0,0,
18/04/2023,Cd. de México,"CUAUHTEMOC, CD. MÉX.",3,1,4,0,0,180,
18/04/2023,Cd. de México,"BENITO JUAREZ, CD. MÉX.",2,0,2,0,0,60,
19/04/2023,Cd. de México,"TLALPAN, CD. MÉX.",6,0,6,0,0,0,
19/04/2023,Cd. de México,"IZTAPALAPA, CD. MÉX.",2,3,5,0,1,0,
19/04/2023,Cd. de México,"BENITO JUAREZ, CD. MÉX.",1,0,1,0,0,150,
20/04/2023,Cd. de México,"BENITO JUAREZ, CD. MÉX.",3,0,3,0,0,48,
20/04/2023,Cd. de México,"IZTAPALAPA, CD. MÉX.",2,0,2,0,0,27,
20/04/2023,Cd. de México,"TLALPAN, CD. MÉX.",2,0,2,0,0,0,
20/04/2023,Cd. de México,"CUAUHTEMOC, CD. MÉX.",1,0,1,0,0,0,
20/04/2023,Querétaro,"CORREGIDORA, QRO.",0,1,1,0,0,0,
21/04/2023,Cd. de México,"BENITO JUAREZ, CD. MÉX.",7,3,10,0,0,574,
21/04/2023,Querétaro,"CORREGIDORA, QRO.",6,1,7,0,0,0,
21/04/2023,Cd. de México,"COYOACAN, CD. MÉX.",4,0,4,0,0,79,
21/04/2023,Cd. de México,"IZTAPALAPA, CD. MÉX.",1,0,1,0,0,0,
21/04/2023,Cd. de México,"CUAUHTEMOC, CD. MÉX.",1,0,1,0,1,158,
22/04/2023,Querétaro,"CORREGIDORA, QRO.",1,1,2,0,1,42,
24/04/2023,Cd. de México,"COYOACAN, CD. MÉX.",2,0,2,0,0,163,
24/04/2023,Cd. de México,"CUAUHTEMOC, CD. MÉX.",0,2,2,0,0,459,
24/04/2023,Querétaro,"CORREGIDORA, QRO.",2,0,2,0,2,2,
24/04/2023,Cd. de México,"BENITO JUAREZ, CD. MÉX.",1,0,1,0,0,21,
25/04/2023,Cd. de México,"COYOACAN, CD. MÉX.",2,0,2,0,0,0,
25/04/2023,Cd. de México,"IZTAPALAPA, CD. MÉX.",1,0,1,0,0,12,
25/04/2023,Cd. de México,"CUAUHTEMOC, CD. MÉX.",1,0,1,0,0,58,
25/04/2023,Cd. de México,"IZTACALCO, CD. MÉX.",0,1,1,0,0,0,
26/04/2023,Cd. de México,"CUAUHTEMOC, CD. MÉX.",2,2,4,0,0,423,
26/04/2023,Cd. de México,"COYOACAN, CD. MÉX.",2,2,4,0,0,307,
26/04/2023,Cd. de México,"IZTACALCO, CD. MÉX.",3,0,3,0,0,49,
27/04/2023,Cd. de México,"CUAUHTEMOC, CD. MÉX.",3,1,4,0,0,0,
27/04/2023,Cd. de México,"IZTACALCO, CD. MÉX.",0,3,3,0,0,13,
27/04/2023,Cd. de México,"COYOACAN, CD. MÉX.",1,0,1,0,0,0,
28/04/2023,Cd. de México,"IZTACALCO, CD. MÉX.",1,0,1,0,0,36,
28/04/2023,Michoacán,"MORELIA, MICH.",0,0,0,4,0,0,
28/04/2023,Cd. de México,"COYOACAN, CD. MÉX.",0,0,0,0,0,396,
29/04/2023,Querétaro,"CORREGIDORA, QRO.",4,1,5,0,16,50,
30/04/2023,Querétaro,"CORREGIDORA, QRO.",3,3,6,0,0,31,
02/05/2023,Cd. de México,"CUAUHTEMOC, CD. MÉX.",5,1,6,0,0,417,
02/05/2023,Cd. de México,"XOCHIMILCO, CD. MÉX.",2,0,2,0,0,0,
02/05/2023,Michoacán,"MORELIA, MICH.",0,1,1,2,0,0,
02/05/2023,Cd. de México,"IZTACALCO, CD. MÉX.",0,0,0,0,0,27,
03/05/2023,Sinaloa,"CULIACAN, SIN.",14,2,16,0,0,182,
03/05/2023,Cd. de México,"XOCHIMILCO, CD. MÉX.",4,1,5,0,0,164,
03/05/2023,Michoacán,"MORELIA, MICH.",2,1,3,61,0,53,
03/05/2023,Cd. de México,"IZTACALCO, CD. MÉX.",0,1,1,0,0,111,
03/05/2023,Querétaro,"CORREGIDORA, QRO.",1,0,1,0,0,0,
04/05/2023,Sinaloa,"CULIACAN, SIN.",14,3,17,0,0,17,
04/05/2023,Cd. de México,"CUAUHTEMOC, CD. MÉX.",2,2,4,0,0,72,
04/05/2023,Cd. de México,"IZTAPALAPA, CD. MÉX.",1,0,1,0,0,0,
04/05/2023,Michoacán,"MORELIA, MICH.",0,1,1,70,0,156,
04/05/2023,Cd. de México,"XOCHIMILCO, CD. MÉX.",0,0,0,0,0,888,
05/05/2023,Sinaloa,"CULIACAN, SIN.",9,3,12,0,0,140,
05/05/2023,Sinaloa,"NAVOLATO, SIN.",0,1,1,0,0,0,
06/05/2023,Cd. de México,"CUAUHTEMOC, CD. MÉX.",3,4,7,0,0,"1,643",
06/05/2023,Querétaro,"CORREGIDORA, QRO.",1,6,7,0,0,4,
06/05/2023,Cd. de México,"XOCHIMILCO, CD. MÉX.",1,0,1,0,0,0,
07/05/2023,Michoacán,"SAHUAYO, MICH.",1,17,18,0,0,24,
07/05/2023,Michoacán,"URUAPAN, MICH.",5,0,5,135,0,0,
08/05/2023,Sinaloa,"NAVOLATO, SIN.",10,4,14,0,5,277,
08/05/2023,Cd. de México,"CUAUHTEMOC, CD. MÉX.",4,4,8,0,0,79,
08/05/2023,Querétaro,"CORREGIDORA, QRO.",1,0,1,0,0,0,
09/05/2023,Sinaloa,"NAVOLATO, SIN.",9,2,11,0,1,62,
09/05/2023,Cd. de México,"MIGUEL HIDALGO, CD. MÉX.",2,0,2,0,0,0,
09/05/2023,Cd. de México,"CUAUHTEMOC, CD. MÉX.",2,0,2,0,0,56,
09/05/2023,Cd. de México,"VENUSTIANO CARRANZA, CD. MÉX.",2,0,2,0,0,218,
10/05/2023,Sinaloa,"NAVOLATO, SIN.",6,4,10,0,0,605,
10/05/2023,Cd. de México,"CUAUHTEMOC, CD. MÉX.",3,1,4,0,0,0,
10/05/2023,Cd. de México,"MIGUEL HIDALGO, CD. MÉX.",1,0,1,0,0,24,
10/05/2023,Querétaro,"CORREGIDORA, QRO.",1,0,1,0,1,0,
11/05/2023,Querétaro,"CORREGIDORA, QRO.",3,0,3,0,0,0,
11/05/2023,Colima,"MINATITLÁN, COL.",1,1,2,0,0,0,
11/05/2023,Cd. de México,"MIGUEL HIDALGO, CD. MÉX.",0,1,1,0,0,34,
11/05/2023,Cd. de México,"CUAUHTEMOC, CD. MÉX.",1,0,1,0,0,119,
11/05/2023,Sinaloa,"NAVOLATO, SIN.",1,0,1,0,0,681,
11/05/2023,Cd. de México,"VENUSTIANO CARRANZA, CD. MÉX.",0,0,0,0,0,39,
12/05/2023,Sinaloa,"NAVOLATO, SIN.",12,1,13,0,0,"2,156",
12/05/2023,Cd. de México,"MIGUEL HIDALGO, CD. MÉX.",0,1,1,0,0,55,
12/05/2023,Cd. de México,"CUAUHTEMOC, CD. MÉX.",1,0,1,0,0,169,
13/05/2023,Querétaro,"CORREGIDORA, QRO.",3,1,4,3,0,46,
13/05/2023,Michoacán,"TARIMBARO, MICH.",1,0,1,58,0,0,
14/05/2023,Querétaro,"SAN JUAN DEL RIO, QRO.",0,1,1,3,0,55,
14/05/2023,Michoacán,"TARIMBARO, MICH.",0,0,0,62,0,0,
15/05/2023,Sinaloa,"NAVOLATO, SIN.",5,2,7,0,0,223,
15/05/2023,Cd. de México,"CUAUHTEMOC, CD. MÉX.",5,0,5,0,0,140,
15/05/2023,Michoacán,"TARIMBARO, MICH.",4,0,4,5,0,0,
15/05/2023,Michoacán,"TARIMBARO, MICH.",1,2,3,18,0,0,
15/05/2023,Michoacán,"JACONA, MICH.",0,1,1,1,0,32,
16/05/2023,Sinaloa,"CULIACAN, SIN.",5,1,6,0,0,"2,334",
16/05/2023,Sinaloa,"NAVOLATO, SIN.",2,2,4,0,0,29,
16/05/2023,Cd. de México,"TLALPAN, CD. MÉX.",3,0,3,0,0,295,
16/05/2023,Cd. de México,"CUAUHTEMOC, CD. MÉX.",3,0,3,0,0,85,
16/05/2023,Querétaro,"QUERETARO, QRO.",0,0,0,0,0,314,
17/05/2023,Sinaloa,"CULIACAN, SIN.",14,0,14,0,0,72,
17/05/2023,Michoacán,"TARIMBARO, MICH.",2,5,7,7,0,12,
17/05/2023,Cd. de México,"TLALPAN, CD. MÉX.",4,1,5,0,0,46,
17/05/2023,Sinaloa,"NAVOLATO, SIN.",2,1,3,0,0,0,
17/05/2023,Cd. de México,"CUAUHTEMOC, CD. MÉX.",3,0,3,0,0,188,
17/05/2023,Querétaro,"SAN JUAN DEL RIO, QRO.",1,0,1,0,0,0,
17/05/2023,Michoacán,"JACONA, MICH.",0,1,1,10,0,221,
17/05/2023,Cd. de México,"GUSTAVO A. MADERO, CD. MÉX.",0,1,1,0,0,0,
17/05/2023,Cd. de México,"VENUSTIANO CARRANZA, CD. MÉX.",0,0,0,0,7,0,
18/05/2023,Michoacán,"TARIMBARO, MICH.",3,2,5,142,0,275,
18/05/2023,Sinaloa,"NAVOLATO, SIN.",3,1,4,0,1,"1,573",
18/05/2023,Cd. de México,"CUAUHTEMOC, CD. MÉX.",3,1,4,0,0,188,
18/05/2023,Cd. de México,"VENUSTIANO CARRANZA, CD. MÉX.",2,0,2,0,0,30,
18/05/2023,Michoacán,"JACONA, MICH.",2,0,2,5,0,364,
18/05/2023,Cd. de México,"TLALPAN, CD. MÉX.",1,1,2,0,0,202,
19/05/2023,Sinaloa,"CULIACAN, SIN.",11,6,17,0,1,213,
19/05/2023,Colima,"TECOMÁN, COL.",1,3,4,2,1,14,
19/05/2023,Cd. de México,"CUAUHTEMOC, CD. MÉX.",1,2,3,0,0,65,
19/05/2023,Cd. de México,"GUSTAVO A. MADERO, CD. MÉX.",1,0,1,0,0,142,
19/05/2023,Querétaro,"SAN JUAN DEL RIO, QRO.",0,0,0,0,0,8,
22/05/2023,Cd. de México,"CUAUHTEMOC, CD. MÉX.",1,0,1,0,0,217,
23/05/2023,Cd. de México,"CUAUHTEMOC, CD. MÉX.",4,1,5,0,0,156,
23/05/2023,Cd. de México,"TLALPAN, CD. MÉX.",1,1,2,0,0,20,
24/05/2023,Cd. de México,"AZCAPOTZALCO, CD. MÉX.",5,0,5,0,0,0,
24/05/2023,Cd. de México,"CUAUHTEMOC, CD. MÉX.",0,2,2,0,0,0,
25/05/2023,Cd. de México,"CUAUHTEMOC, CD. MÉX.",2,0,2,0,0,377,
25/05/2023,Cd. de México,"AZCAPOTZALCO, CD. MÉX.",1,0,1,0,0,10,
26/05/2023,Cd. de México,"CUAUHTEMOC, CD. MÉX.",3,2,5,0,0,11,
26/05/2023,Michoacán,"HIDALGO, MICH.",4,0,4,85,0,115,
26/05/2023,Querétaro,"SAN JUAN DEL RIO, QRO.",1,1,2,0,0,0,
27/05/2023,Michoacán,"HIDALGO, MICH.",5,0,5,55,0,15,
28/05/2023,Michoacán,"HIDALGO, MICH.",0,1,1,4,0,0,
29/05/2023,Querétaro,"QUERETARO, QRO.",0,1,1,0,0,15,
29/05/2023,Michoacán,"HIDALGO, MICH.",0,0,0,1,0,0,
30/05/2023,Sinaloa,"SINALOA, SIN.",3,4,7,0,0,0,
30/05/2023,Sinaloa,"EL FUERTE, SIN.",2,1,3,0,0,0,
30/05/2023,Sinaloa,"CHOIX, SIN.",1,0,1,0,0,0,
31/05/2023,Sinaloa,"EL FUERTE, SIN.",9,9,18,0,0,0,
31/05/2023,Sinaloa,"CHOIX, SIN.",16,1,17,0,0,0,
31/05/2023,Cd. de México,"CUAUHTEMOC, CD. MÉX.",5,1,6,0,0,137,
31/05/2023,Sinaloa,"SINALOA, SIN.",1,4,5,0,1,3,
31/05/2023,Cd. de México,"LA MAGDALENA CONTRERAS, CD. MÉX.",4,0,4,0,0,184,
31/05/2023,Michoacán,"HIDALGO, MICH.",1,0,1,2,0,0,
01/06/2023,Sinaloa,"EL FUERTE, SIN.",22,10,32,0,0,0,
01/06/2023,Sinaloa,"CHOIX, SIN.",20,1,21,0,0,0,
01/06/2023,Michoacán,"HIDALGO, MICH.",3,0,3,88,0,308,
01/06/2023,Querétaro,"QUERETARO, QRO.",1,1,2,0,0,0,
01/06/2023,Sinaloa,"SINALOA, SIN.",0,2,2,0,0,0,
02/06/2023,Cd. de México,"CUAUHTEMOC, CD. MÉX.",5,4,9,0,1,270,
04/06/2023,Aguascalientes,"RINCÓN DE ROMOS, AGS.",3,0,3,1,0,8,
04/06/2023,Aguascalientes,"SAN FRANCISCO DE LOS ROMO, AGS.",1,0,1,0,0,25,
04/06/2023,Aguascalientes,"PABELLÓN DE ARTEAGA, AGS.",1,0,1,0,0,48,
05/06/2023,Sinaloa,"CHOIX, SIN.",16,4,20,0,0,256,
05/06/2023,Sinaloa,"EL FUERTE, SIN.",5,5,10,0,0,0,
05/06/2023,Cd. de México,"CUAUHTEMOC, CD. MÉX.",1,3,4,0,1,519,
05/06/2023,Sinaloa,"SINALOA, SIN.",2,1,3,0,0,28,
06/06/2023,Sinaloa,"EL FUERTE, SIN.",4,1,5,0,0,0,
06/06/2023,Sinaloa,"SINALOA, SIN.",1,2,3,0,0,0,
06/06/2023,Cd. de México,"CUAUHTEMOC, CD. MÉX.",2,1,3,0,0,150,
06/06/2023,Cd. de México,"COYOACAN, CD. MÉX.",1,1,2,0,0,7,
06/06/2023,Sinaloa,"CHOIX, SIN.",2,0,2,0,0,120,
06/06/2023,Cd. de México,"VENUSTIANO CARRANZA, CD. MÉX.",1,1,2,0,0,651,
06/06/2023,Querétaro,"QUERETARO, QRO.",2,0,2,0,0,0,
07/06/2023,Sinaloa,"EL FUERTE, SIN.",7,4,11,0,0,36,
07/06/2023,Sinaloa,"SINALOA, SIN.",2,0,2,0,0,0,
07/06/2023,Cd. de México,"CUAUHTEMOC, CD. MÉX.",1,1,2,0,0,267,
07/06/2023,Cd. de México,"VENUSTIANO CARRANZA, CD. MÉX.",1,1,2,0,0,651,
07/06/2023,Sinaloa,"CHOIX, SIN.",0,1,1,0,0,0,
07/06/2023,Cd. de México,"COYOACAN, CD. MÉX.",1,0,1,0,0,150,
08/06/2023,Sinaloa,"EL FUERTE, SIN.",4,4,8,0,0,0,
08/06/2023,Sinaloa,"CHOIX, SIN.",1,4,5,0,0,0,
08/06/2023,Cd. de México,"CUAUHTEMOC, CD. MÉX.",1,1,2,0,0,0,
08/06/2023,Cd. de México,"COYOACAN, CD. MÉX.",2,0,2,0,0,36,
08/06/2023,Cd. de México,"VENUSTIANO CARRANZA, CD. MÉX.",2,0,2,0,1,0,
08/06/2023,Sinaloa,"SINALOA, SIN.",2,0,2,0,0,0,
08/06/2023,Querétaro,"QUERETARO, QRO.",0,1,1,0,0,100,
09/06/2023,Sinaloa,"CHOIX, SIN.",2,6,8,0,0,0,
09/06/2023,Sinaloa,"EL FUERTE, SIN.",3,2,5,0,0,0,
09/06/2023,Cd. de México,"CUAUHTEMOC, CD. MÉX.",2,0,2,0,0,179,
09/06/2023,Querétaro,"SAN JOAQUIN, QRO.",2,0,2,0,0,0,
09/06/2023,Querétaro,"QUERETARO, QRO.",2,0,2,0,0,0,
09/06/2023,Cd. de México,"ALVARO OBREGON, CD. MÉX.",1,0,1,0,0,0,
09/06/2023,Sinaloa,"SINALOA, SIN.",1,0,1,0,0,0,
09/06/2023,Cd. de México,"COYOACAN, CD. MÉX.",0,0,0,0,0,256,
11/06/2023,Aguascalientes,"CALVILLO, AGS.",1,0,1,1,0,70,
12/06/2023,México,"NEXTLALPAN, MEX., MEX.",48,0,48,0,0,0,
12/06/2023,Cd. de México,"CUAUHTEMOC, CD. MÉX.",1,1,2,0,0,494,
12/06/2023,México,"LA PAZ, MEX.",0,2,2,0,0,54,
12/06/2023,Morelos,"CUERNAVACA, MOR.",0,2,2,11,0,393,
12/06/2023,Cd. de México,"VENUSTIANO CARRANZA, CD. MÉX.",0,0,0,0,0,18,
13/06/2023,México,"LERMA, MEX.",102,0,102,0,0,0,
13/06/2023,México,"LA PAZ, MEX.",12,0,12,0,0,32,
13/06/2023,Cd. de México,"CUAUHTEMOC, CD. MÉX.",4,0,4,0,0,169,
13/06/2023,México,"NEXTLALPAN, MEX., MEX.",2,1,3,0,0,179,
13/06/2023,Cd. de México,"MIGUEL HIDALGO, CD. MÉX.",1,1,2,0,0,0,
13/06/2023,Querétaro,"SAN JOAQUIN, QRO.",1,1,2,0,0,100,
14/06/2023,México,"LA PAZ, MEX.",63,1,64,0,40,62,
14/06/2023,Guanajuato,"LEON, GTO.",7,2,9,0,0,261,
14/06/2023,Cd. de México,"CUAUHTEMOC, CD. MÉX.",3,0,3,0,0,97,
14/06/2023,Cd. de México,"VENUSTIANO CARRANZA, CD. MÉX.",3,0,3,0,0,447,
14/06/2023,México,"LERMA, MEX.",2,0,2,0,0,35,
14/06/2023,Querétaro,"QUERETARO, QRO.",0,1,1,0,0,0,
14/06/2023,México,"JILOTEPEC, MEX.",1,0,1,0,0,36,
14/06/2023,Cd. de México,"MIGUEL HIDALGO, CD. MÉX.",0,0,0,0,2,0,
14/06/2023,Morelos,"CUERNAVACA, MOR.",0,0,0,6,1,92,
14/06/2023,Chiapas,"LA TRINITARIA, CHIS.",0,0,0,0,0,389,
15/06/2023,México,"NEXTLALPAN, MEX., MEX.",31,0,31,0,0,0,
15/06/2023,Guanajuato,"LEON, GTO.",10,5,15,6,0,233,
15/06/2023,México,"LA PAZ, MEX.",10,0,10,0,0,32,
15/06/2023,Cd. de México,"CUAUHTEMOC, CD. MÉX.",1,1,2,0,0,244,
15/06/2023,Puebla,"ATLIXCO, PUE.",1,0,1,1,0,0,
15/06/2023,Chihuahua,"NUEVO CASAS GRANDES, CHIH.",1,0,1,1,0,272,
15/06/2023,Chiapas,"LA TRINITARIA, CHIS.",0,0,0,2,0,246,
16/06/2023,Guanajuato,"LEON, GTO.",17,8,25,7,0,351,
16/06/2023,México,"NEXTLALPAN, MEX., MEX.",20,0,20,0,0,0,
16/06/2023,México,"LA PAZ, MEX.",11,1,12,0,0,127,
16/06/2023,México,"LERMA, MEX.",3,2,5,0,0,554,
16/06/2023,Cd. de México,"CUAUHTEMOC, CD. MÉX.",2,0,2,0,0,53,
16/06/2023,Chihuahua,"NUEVO CASAS GRANDES, CHIH.",0,1,1,0,0,0,
16/06/2023,México,"JILOTEPEC, MEX.",1,0,1,1,0,0,
16/06/2023,Cd. de México,"VENUSTIANO CARRANZA, CD. MÉX.",0,1,1,0,0,0,
16/06/2023,Morelos,"CUERNAVACA, MOR.",0,0,0,2,3,0,
16/06/2023,Querétaro,"QUERETARO, QRO.",0,0,0,0,0,20,
17/06/2023,Guanajuato,"LEON, GTO.",10,5,15,5,0,144,
17/06/2023,México,"LA PAZ, MEX.",3,1,4,0,0,5,
17/06/2023,México,"NEXTLALPAN, MEX., MEX.",2,2,4,0,0,0,
17/06/2023,México,"JILOTEPEC, MEX.",2,1,3,0,0,0,
17/06/2023,Aguascalientes,"JESÚS MARÍA, AGS.",2,0,2,0,0,5,
17/06/2023,México,"LERMA, MEX.",1,0,1,0,0,43,
17/06/2023,Puebla,"ATLIXCO, PUE.",0,0,0,0,0,206,
17/06/2023,Aguascalientes,"SAN JOSÉ DE GRACIA, AGS.",0,0,0,1,0,130,
18/06/2023,Aguascalientes,"JESÚS MARÍA, AGS.",1,0,1,0,0,982,
19/06/2023,México,"ZUMPANGO, MEX.",63,0,63,1,0,23,
19/06/2023,México,"TECAMAC, MEX.",4,1,5,0,0,37,
19/06/2023,Cd. de México,"CUAUHTEMOC, CD. MÉX.",4,0,4,0,0,235,
19/06/2023,México,"NICOLAS ROMERO, MEX.",2,1,3,1,0,6,
19/06/2023,Tlaxcala,"CONTLA DE JUAN CUAMATZI, TLAX.",2,0,2,0,0,0,
19/06/2023,Cd. de México,"VENUSTIANO CARRANZA, CD. MÉX.",2,0,2,0,0,0,
19/06/2023,Tlaxcala,"TLAXCALA, TLAX.",1,0,1,0,0,0,
19/06/2023,México,"ZINACANTEPEC, MEX.",1,0,1,0,0,0,
20/06/2023,México,"ZUMPANGO, MEX.",80,0,80,0,0,0,
20/06/2023,México,"TECAMAC, MEX.",13,1,14,0,0,127,
20/06/2023,Tlaxcala,"CONTLA DE JUAN CUAMATZI, TLAX.",2,1,3,0,0,0,
20/06/2023,Cd. de México,"VENUSTIANO CARRANZA, CD. MÉX.",3,0,3,0,0,0,
20/06/2023,Tlaxcala,"APIZACO, TLAX.",2,0,2,0,0,0,
20/06/2023,Querétaro,"QUERETARO, QRO.",1,1,2,0,0,65,
20/06/2023,Tlaxcala,"TLAXCALA, TLAX.",1,0,1,0,0,0,
20/06/2023,Tlaxcala,"HUAMANTLA, TLAX.",1,0,1,0,0,0,
20/06/2023,Puebla,"ATLIXCO, PUE.",1,0,1,0,0,50,
20/06/2023,Cd. de México,"CUAUHTEMOC, CD. MÉX.",1,0,1,0,0,7,
20/06/2023,México,"ZINACANTEPEC, MEX.",0,0,0,0,0,79,
20/06/2023,Chiapas,"COMITAN DE DOMÍNGUEZ, CHIS.",0,0,0,0,0,237,
20/06/2023,Veracruz,"MARTINEZ DE LA TORRE, VER.",0,0,0,5,0,400,
20/06/2023,México,"NICOLAS ROMERO, MEX.",0,0,0,0,0,16,
21/06/2023,Cd. de México,"CUAUHTEMOC, CD. MÉX.",3,2,5,0,0,19,
21/06/2023,Tlaxcala,"TLAXCALA, TLAX.",1,1,2,0,1,0,
21/06/2023,México,"NICOLAS ROMERO, MEX.",2,0,2,1,0,68,
21/06/2023,Querétaro,"QUERETARO, QRO.",1,0,1,2,0,75,
21/06/2023,Tlaxcala,"HUAMANTLA, TLAX.",0,1,1,0,0,0,
21/06/2023,Tlaxcala,"APIZACO, TLAX.",1,0,1,0,0,0,
21/06/2023,Cd. de México,"VENUSTIANO CARRANZA, CD. MÉX.",1,0,1,0,0,0,
21/06/2023,México,"ZINACANTEPEC, MEX.",1,0,1,0,0,7,
21/06/2023,Puebla,"ATLIXCO, PUE.",0,0,0,0,0,418,
22/06/2023,México,"ZUMPANGO, MEX.",60,0,60,13,0,0,
22/06/2023,México,"TECAMAC, MEX.",20,0,20,13,0,0,
22/06/2023,Guanajuato,"IRAPUATO, GTO.",14,3,17,28,0,846,
22/06/2023,Guanajuato,"SALAMANCA, GTO.",7,1,8,1,0,833,
22/06/2023,Tlaxcala,"HUAMANTLA, TLAX.",1,3,4,0,0,0,
22/06/2023,Tlaxcala,"APIZACO, TLAX.",3,0,3,0,0,0,
22/06/2023,Tlaxcala,"TLAXCALA, TLAX.",1,1,2,0,0,0,
22/06/2023,Guanajuato,"VALLE DE SANTIAGO, GTO.",0,2,2,1,17,228,
22/06/2023,México,"NICOLAS ROMERO, MEX.",1,0,1,0,0,197,
22/06/2023,Puebla,"ATLIXCO, PUE.",0,0,0,0,2,2,
22/06/2023,México,"ZINACANTEPEC, MEX.",0,0,0,0,0,15,
22/06/2023,Veracruz,"MARTINEZ DE LA TORRE, VER.",0,0,0,0,0,180,
22/06/2023,Chiapas,"COMITAN DE DOMÍNGUEZ, CHIS.",0,0,0,0,0,381,
23/06/2023,México,"NICOLAS ROMERO, MEX.",30,0,30,0,0,0,
23/06/2023,México,"TECAMAC, MEX.",27,0,27,0,0,233,
23/06/2023,Guanajuato,"IRAPUATO, GTO.",16,5,21,142,0,430,
23/06/2023,Michoacán,"ZAMORA, MICH.",5,5,10,3,0,182,
23/06/2023,México,"ZUMPANGO, MEX.",4,1,5,1,0,0,
23/06/2023,Cd. de México,"CUAUHTEMOC, CD. MÉX.",5,0,5,0,0,69,
23/06/2023,Tlaxcala,"APIZACO, TLAX.",4,1,5,0,0,0,
23/06/2023,Guanajuato,"VALLE DE SANTIAGO, GTO.",2,1,3,0,0,103,
23/06/2023,Guanajuato,"SALAMANCA, GTO.",0,2,2,0,0,354,
23/06/2023,México,"ZINACANTEPEC, MEX.",2,0,2,0,0,0,
23/06/2023,Tlaxcala,"HUAMANTLA, TLAX.",0,2,2,0,0,0,
23/06/2023,Chihuahua,"NUEVO CASAS GRANDES, CHIH.",1,1,2,0,0,0,
23/06/2023,Cd. de México,"MIGUEL HIDALGO, CD. MÉX.",2,0,2,0,0,7,
23/06/2023,Querétaro,"QUERETARO, QRO.",1,0,1,4,0,0,
23/06/2023,Puebla,"ATLIXCO, PUE.",0,1,1,0,0,295,
23/06/2023,Cd. de México,"VENUSTIANO CARRANZA, CD. MÉX.",0,1,1,0,0,0,
23/06/2023,Morelos,"CUERNAVACA, MOR.",1,0,1,0,0,0,
23/06/2023,Tlaxcala,"TLAXCALA, TLAX.",1,0,1,0,0,0,
23/06/2023,Veracruz,"MARTINEZ DE LA TORRE, VER.",0,0,0,20,0,"1,989",
23/06/2023,Chiapas,"COMITAN DE DOMÍNGUEZ, CHIS.",0,0,0,0,0,331,
24/06/2023,México,"ZUMPANGO, MEX.",48,0,48,0,0,172,
24/06/2023,Guanajuato,"IRAPUATO, GTO.",10,6,16,29,4,"1,024",
24/06/2023,México,"TECAMAC, MEX.",14,0,14,0,0,106,
24/06/2023,Michoacán,"ZAMORA, MICH.",8,3,11,11,0,214,
24/06/2023,Guanajuato,"SALAMANCA, GTO.",4,0,4,6,0,183,
24/06/2023,México,"ZINACANTEPEC, MEX.",4,0,4,0,0,0,
24/06/2023,Tlaxcala,"HUAMANTLA, TLAX.",1,1,2,0,0,0,
24/06/2023,Tlaxcala,"APIZACO, TLAX.",2,0,2,0,0,0,
24/06/2023,Guanajuato,"VALLE DE SANTIAGO, GTO.",1,0,1,0,0,99,
24/06/2023,Veracruz,"MARTINEZ DE LA TORRE, VER.",1,0,1,1,0,78,
24/06/2023,México,"NICOLAS ROMERO, MEX.",1,0,1,0,0,20,
24/06/2023,Tlaxcala,"CONTLA DE JUAN CUAMATZI, TLAX.",0,1,1,0,0,0,
24/06/2023,Puebla,"ATLIXCO, PUE.",0,0,0,4,0,67,
24/06/2023,Tlaxcala,"TLAXCALA, TLAX.",0,0,0,0,0,18,
26/06/2023,México,"HUEHUETOCA, MEX.",10,0,10,0,15,0,
26/06/2023,México,"VALLE DE CHALCO SOLIDARIDAD, MEX.",6,1,7,0,0,18,
26/06/2023,Sinaloa,"GUASAVE, SIN.",3,2,5,0,0,40,
26/06/2023,Michoacán,"ZAMORA, MICH.",2,1,3,43,0,256,
26/06/2023,Sinaloa,"AHOME, SIN.",3,0,3,0,0,0,
26/06/2023,México,"METEPEC, MEX.",3,0,3,0,0,0,
26/06/2023,Tlaxcala,"CALPULALPAN, TLAX.",2,0,2,0,0,0,
26/06/2023,Cd. de México,"CUAUHTEMOC, CD. MÉX.",2,0,2,0,0,415,
26/06/2023,Sinaloa,"ANGOSTURA, SIN.",2,0,2,0,0,0,
26/06/2023,Querétaro,"QUERETARO, QRO.",2,0,2,0,0,0,
26/06/2023,Tlaxcala,"PANOTLA, TLAX.",1,0,1,0,0,0,
26/06/2023,Veracruz,"MISANTLA, VER.",1,0,1,0,0,0,
26/06/2023,México,"VILLA VICTORIA, MEX.",1,0,1,0,0,0,
26/06/2023,Tlaxcala,"TLAXCALA, TLAX.",0,1,1,0,0,0,
26/06/2023,Puebla,"ATLIXCO, PUE.",0,0,0,0,0,464,
27/06/2023,México,"METEPEC, MEX.",22,0,22,0,0,5,
27/06/2023,México,"VALLE DE CHALCO SOLIDARIDAD, MEX.",7,1,8,0,2,183,
27/06/2023,Sinaloa,"AHOME, SIN.",3,3,6,0,0,5,
27/06/2023,Guanajuato,"APASEO EL GRANDE, GTO.",1,2,3,0,0,19,
27/06/2023,Querétaro,"QUERETARO, QRO.",3,0,3,0,0,0,
27/06/2023,Sinaloa,"GUASAVE, SIN.",3,0,3,0,0,50,
27/06/2023,Michoacán,"ZAMORA, MICH.",2,0,2,39,0,451,
27/06/2023,México,"VILLA VICTORIA, MEX.",2,0,2,0,0,0,
27/06/2023,Sinaloa,"ANGOSTURA, SIN.",1,1,2,0,0,65,
27/06/2023,Puebla,"ATLIXCO, PUE.",0,1,1,0,0,156,
27/06/2023,Tlaxcala,"IXTACUIXTLA DE MARIANO MATAMOROS, TLAX.",0,1,1,0,0,0,
27/06/2023,Cd. de México,"VENUSTIANO CARRANZA, CD. MÉX.",1,0,1,0,0,53,
27/06/2023,Cd. de México,"CUAUHTEMOC, CD. MÉX.",1,0,1,0,0,358,
27/06/2023,México,"HUEHUETOCA, MEX.",0,0,0,0,0,68,
27/06/2023,Veracruz,"MISANTLA, VER.",0,0,0,2,1,891,
28/06/2023,México,"HUEHUETOCA, MEX.",55,0,55,0,0,0,
28/06/2023,Guanajuato,"CELAYA, GTO.",7,1,8,4,0,202,
28/06/2023,México,"VALLE DE CHALCO SOLIDARIDAD, MEX.",7,0,7,0,0,40,
28/06/2023,Guanajuato,"SALVATIERRA, GTO.",3,3,6,17,0,230,
28/06/2023,Sinaloa,"AHOME, SIN.",5,0,5,0,0,64,
28/06/2023,Querétaro,"QUERETARO, QRO.",5,0,5,0,0,0,
28/06/2023,Sinaloa,"GUASAVE, SIN.",2,2,4,0,0,0,
28/06/2023,Tlaxcala,"PANOTLA, TLAX.",3,0,3,0,0,0,
28/06/2023,Cd. de México,"ALVARO OBREGON, CD. MÉX.",1,1,2,0,0,92,
28/06/2023,Tlaxcala,"TLAXCALA, TLAX.",1,1,2,0,0,86,
28/06/2023,Tlaxcala,"IXTACUIXTLA DE MARIANO MATAMOROS, TLAX.",1,1,2,0,0,0,
28/06/2023,Veracruz,"MISANTLA, VER.",2,0,2,0,0,0,
28/06/2023,México,"METEPEC, MEX.",1,0,1,0,0,30,
28/06/2023,Guanajuato,"APASEO EL GRANDE, GTO.",1,0,1,0,0,"7,708",
29/06/2023,Guanajuato,"SALVATIERRA, GTO.",5,7,12,6,2,18,
29/06/2023,México,"VALLE DE CHALCO SOLIDARIDAD, MEX.",6,1,7,0,7,0,
29/06/2023,Sinaloa,"AHOME, SIN.",5,1,6,0,1,31,
29/06/2023,Michoacán,"ZAMORA, MICH.",1,4,5,16,0,"1,540",
29/06/2023,Guanajuato,"CELAYA, GTO.",4,1,5,1,6,392,
29/06/2023,Guanajuato,"APASEO EL GRANDE, GTO.",2,2,4,2,0,109,
29/06/2023,Cd. de México,"BENITO JUAREZ, CD. MÉX.",3,0,3,0,0,0,
29/06/2023,México,"METEPEC, MEX.",2,1,3,0,0,6,
29/06/2023,Veracruz,"TIHUATLAN, VER.",2,1,3,0,0,92,
29/06/2023,Querétaro,"QUERETARO, QRO.",3,0,3,0,0,0,
29/06/2023,Sinaloa,"GUASAVE, SIN.",2,1,3,0,0,0,
29/06/2023,Cd. de México,"CUAUHTEMOC, CD. MÉX.",3,0,3,0,0,71,
29/06/2023,Sinaloa,"ANGOSTURA, SIN.",1,0,1,0,0,0,
29/06/2023,Tlaxcala,"TLAXCALA, TLAX.",1,0,1,0,0,0,
29/06/2023,Veracruz,"MISANTLA, VER.",0,0,0,35,0,453,
30/06/2023,Guanajuato,"SALVATIERRA, GTO.",5,4,9,9,0,876,
30/06/2023,Guanajuato,"CELAYA, GTO.",5,3,8,1,2,"1,160",
30/06/2023,Querétaro,"QUERETARO, QRO.",4,4,8,0,1,83,
30/06/2023,Sinaloa,"AHOME, SIN.",4,1,5,0,0,185,
30/06/2023,Sinaloa,"GUASAVE, SIN.",0,5,5,0,0,0,
30/06/2023,Tlaxcala,"IXTACUIXTLA DE MARIANO MATAMOROS, TLAX.",1,2,3,0,0,0,
30/06/2023,Veracruz,"MISANTLA, VER.",3,0,3,17,0,291,
30/06/2023,Veracruz,"TIHUATLAN, VER.",2,1,3,0,0,137,
30/06/2023,Tlaxcala,"TLAXCALA, TLAX.",1,0,1,0,0,0,
30/06/2023,Tlaxcala,"CALPULALPAN, TLAX.",1,0,1,0,0,0,
30/06/2023,Tlaxcala,"PANOTLA, TLAX.",1,0,1,0,0,0,
30/06/2023,Sinaloa,"ANGOSTURA, SIN.",1,0,1,0,0,0,
30/06/2023,Cd. de México,"CUAUHTEMOC, CD. MÉX.",1,0,1,0,0,62,
30/06/2023,Cd. de México,"ALVARO OBREGON, CD. MÉX.",0,1,1,0,0,0,
30/06/2023,Puebla,"ATLIXCO, PUE.",0,0,0,0,1,0,
30/06/2023,Guanajuato,"APASEO EL GRANDE, GTO.",0,0,0,7,0,8,
01/07/2023,México,"VALLE DE CHALCO SOLIDARIDAD, MEX.",3,0,3,0,1,856,
01/07/2023,México,"HUEHUETOCA, MEX.",2,1,3,0,0,4,
01/07/2023,México,"VILLA VICTORIA, MEX.",1,2,3,0,0,0,
01/07/2023,Veracruz,"MISANTLA, VER.",1,1,2,0,0,230,
01/07/2023,Tlaxcala,"IXTACUIXTLA DE MARIANO MATAMOROS, TLAX.",1,1,2,0,0,0,
01/07/2023,México,"METEPEC, MEX.",0,2,2,0,1,0,
01/07/2023,Tlaxcala,"TLAXCALA, TLAX.",1,0,1,0,0,0,
02/07/2023,Veracruz,"MISANTLA, VER.",1,2,3,0,0,"3,523",
03/07/2023,México,"VALLE DE CHALCO SOLIDARIDAD, MEX.",10,2,12,0,0,0,
03/07/2023,Sinaloa,"AHOME, SIN.",5,3,8,0,0,10,
03/07/2023,México,"CHIMALHUACAN, MEX.",7,1,8,0,0,5,
03/07/2023,Sinaloa,"GUASAVE, SIN.",2,4,6,0,0,0,
03/07/2023,México,"OTZOLOTEPEC, MEX.",2,1,3,0,0,211,
03/07/2023,Cd. de México,"CUAUHTEMOC, CD. MÉX.",2,0,2,0,0,497,
03/07/2023,Sinaloa,"ANGOSTURA, SIN.",1,0,1,0,0,0,
04/07/2023,Michoacán,"ZAMORA, MICH.",3,6,9,43,0,62,
04/07/2023,Sinaloa,"AHOME, SIN.",6,2,8,0,0,66,
04/07/2023,México,"XALATLACO, MEX.",4,0,4,0,2,0,
04/07/2023,Tlaxcala,"SANTA CRUZ TLAXCALA, TLAX.",1,1,2,0,0,0,
04/07/2023,México,"CHIMALHUACAN, MEX.",2,0,2,0,0,19,
04/07/2023,México,"OTZOLOTEPEC, MEX.",2,0,2,1,0,107,
04/07/2023,Sinaloa,"GUASAVE, SIN.",1,1,2,0,0,0,
04/07/2023,Cd. de México,"CUAUHTEMOC, CD. MÉX.",1,1,2,0,0,148,
04/07/2023,Cd. de México,"IZTAPALAPA, CD. MÉX.",1,1,2,0,0,100,
04/07/2023,México,"VALLE DE CHALCO SOLIDARIDAD, MEX.",2,0,2,0,0,18,
04/07/2023,Chiapas,"SAN CRISTOBAL DE LAS CASAS, CHIS.",0,1,1,0,0,64,
04/07/2023,Tlaxcala,"SAN PABLO DEL MONTE, TLAX.",1,0,1,0,0,0,
04/07/2023,Cd. de México,"MIGUEL HIDALGO, CD. MÉX.",0,1,1,0,0,0,
04/07/2023,Tamaulipas,"VICTORIA, TAMPS.",0,1,1,0,0,0,
04/07/2023,Veracruz,"VEGA DE ALATORRE, VER.",0,0,0,1,0,47,
05/07/2023,Michoacán,"ZAMORA, MICH.",1,13,14,47,0,302,
05/07/2023,Sinaloa,"AHOME, SIN.",7,2,9,0,0,86,
05/07/2023,México,"XALATLACO, MEX.",1,8,9,0,0,0,
05/07/2023,Sinaloa,"GUASAVE, SIN.",3,2,5,0,0,0,
05/07/2023,Tlaxcala,"TLAXCALA, TLAX.",2,1,3,0,0,0,
05/07/2023,Querétaro,"CORREGIDORA, QRO.",0,3,3,0,0,0,
05/07/2023,Chiapas,"CHIAPA DE CORZO, CHIS.",0,1,1,0,0,0,
05/07/2023,Chiapas,"SAN CRISTOBAL DE LAS CASAS, CHIS.",0,1,1,0,0,0,
05/07/2023,Tlaxcala,"SAN PABLO DEL MONTE, TLAX.",1,0,1,0,0,0,
05/07/2023,Tlaxcala,"SANTA CRUZ TLAXCALA, TLAX.",1,0,1,0,0,0,
05/07/2023,Sinaloa,"ANGOSTURA, SIN.",0,1,1,0,0,0,
05/07/2023,Tamaulipas,"VICTORIA, TAMPS.",0,1,1,0,0,0,
05/07/2023,Cd. de México,"CUAUHTEMOC, CD. MÉX.",1,0,1,0,0,146,
05/07/2023,México,"OTZOLOTEPEC, MEX.",0,0,0,0,0,11,
06/07/2023,Sinaloa,"GUASAVE, SIN.",4,10,14,0,0,0,
06/07/2023,Sinaloa,"AHOME, SIN.",4,3,7,0,0,204,
06/07/2023,Guerrero,"TECPAN DE GALEANA, GRO.",3,4,7,0,0,0,
06/07/2023,Cd. de México,"CUAUHTEMOC, CD. MÉX.",4,2,6,0,0,9,
06/07/2023,México,"CHIMALHUACAN, MEX.",4,1,5,0,0,0,
06/07/2023,México,"VALLE DE CHALCO SOLIDARIDAD, MEX.",4,0,4,0,0,0,
06/07/2023,Chiapas,"CHIAPA DE CORZO, CHIS.",1,0,1,0,0,0,
06/07/2023,Cd. de México,"BENITO JUAREZ, CD. MÉX.",1,0,1,0,0,19,
06/07/2023,Sinaloa,"ANGOSTURA, SIN.",1,0,1,0,0,0,
06/07/2023,Tlaxcala,"SANTA CRUZ TLAXCALA, TLAX.",0,1,1,0,0,0,
06/07/2023,Veracruz,"VEGA DE ALATORRE, VER.",1,0,1,0,0,0,
06/07/2023,México,"OTZOLOTEPEC, MEX.",0,0,0,0,0,98,
06/07/2023,Tlaxcala,"TLAXCALA, TLAX.",0,0,0,0,0,40,
06/07/2023,Chiapas,"SAN CRISTOBAL DE LAS CASAS, CHIS.",0,0,0,0,0,83,
07/07/2023,Sinaloa,"AHOME, SIN.",17,3,20,0,0,59,
07/07/2023,Sinaloa,"GUASAVE, SIN.",5,12,17,0,0,49,
07/07/2023,Querétaro,"CORREGIDORA, QRO.",7,3,10,0,5,0,
07/07/2023,México,"CHIMALHUACAN, MEX.",2,0,2,0,0,0,
07/07/2023,Chiapas,"SAN CRISTOBAL DE LAS CASAS, CHIS.",1,1,2,0,0,742,
07/07/2023,México,"XALATLACO, MEX.",2,0,2,1,0,10,
07/07/2023,Cd. de México,"CUAUHTEMOC, CD. MÉX.",1,0,1,0,0,13,
07/07/2023,México,"VALLE DE CHALCO SOLIDARIDAD, MEX.",0,1,1,0,0,0,
07/07/2023,Tlaxcala,"SAN PABLO DEL MONTE, TLAX.",0,1,1,0,0,0,
07/07/2023,México,"OTZOLOTEPEC, MEX.",1,0,1,0,0,138,
07/07/2023,Tlaxcala,"TLAXCALA, TLAX.",1,0,1,0,0,0,
07/07/2023,Tlaxcala,"SANTA CRUZ TLAXCALA, TLAX.",0,1,1,0,0,0,
07/07/2023,Chiapas,"CHIAPA DE CORZO, CHIS.",1,0,1,0,0,0,
08/07/2023,México,"XALATLACO, MEX.",0,3,3,0,0,0,
08/07/2023,México,"CHIMALHUACAN, MEX.",1,1,2,0,0,42,
08/07/2023,México,"OTZOLOTEPEC, MEX.",2,0,2,0,0,134,
08/07/2023,Chiapas,"TUXTLA GUTIÉRREZ, CHIS.",2,0,2,0,0,0,
08/07/2023,México,"CHALCO, MEX.",0,1,1,0,2,14,
08/07/2023,Veracruz,"VEGA DE ALATORRE, VER.",0,1,1,28,0,"2,420",
08/07/2023,Chiapas,"CHIAPA DE CORZO, CHIS.",0,0,0,0,0,199,
09/07/2023,Tlaxcala,"SANTA CRUZ TLAXCALA, TLAX.",2,2,4,0,0,0,
09/07/2023,Tlaxcala,"SAN PABLO DEL MONTE, TLAX.",1,1,2,0,0,0,
09/07/2023,Tlaxcala,"TLAXCALA, TLAX.",0,1,1,0,0,0,
09/07/2023,Tlaxcala,"TEOLOCHOLCO, TLAX.",1,0,1,0,0,0,
09/07/2023,Veracruz,"VEGA DE ALATORRE, VER.",0,0,0,1,0,0,
10/07/2023,Michoacán,"ZAMORA, MICH.",8,14,22,35,0,104,
10/07/2023,Michoacán,"URUAPAN, MICH.",6,4,10,38,0,296,
10/07/2023,Chihuahua,"NUEVO CASAS GRANDES, CHIH.",1,1,2,11,0,402,
10/07/2023,Cd. de México,"CUAUHTEMOC, CD. MÉX.",1,0,1,0,0,0,
10/07/2023,Tlaxcala,"TERRENATE, TLAX.",1,0,1,0,0,0,
10/07/2023,México,"VALLE DE BRAVO, MEX.",1,0,1,0,0,0,
10/07/2023,Chiapas,"TUXTLA GUTIÉRREZ, CHIS.",0,0,0,0,1,231,
10/07/2023,Chiapas,"SAN CRISTOBAL DE LAS CASAS, CHIS.",0,0,0,0,0,53,
11/07/2023,Cd. de México,"IZTAPALAPA, CD. MÉX.",4,1,5,0,0,104,
11/07/2023,México,"COYOTEPEC, MEX.",2,3,5,0,0,0,
11/07/2023,Chihuahua,"NUEVO CASAS GRANDES, CHIH.",1,2,3,18,0,0,
11/07/2023,México,"IXTAPAN DE LA SAL, MEX.",2,1,3,0,0,0,
11/07/2023,Cd. de México,"CUAUHTEMOC, CD. MÉX.",3,0,3,0,1,262,
11/07/2023,Querétaro,"CORREGIDORA, QRO.",1,1,2,0,2,120,
11/07/2023,Tamaulipas,"VICTORIA, TAMPS.",0,2,2,0,0,0,
11/07/2023,Tlaxcala,"APIZACO, TLAX.",0,1,1,0,0,0,
11/07/2023,Tlaxcala,"TERRENATE, TLAX.",1,0,1,0,0,0,
11/07/2023,México,"CHIMALHUACAN, MEX.",1,0,1,0,0,0,
12/07/2023,México,"CHIMALHUACAN, MEX.",3,0,3,0,0,0,
12/07/2023,México,"VALLE DE BRAVO, MEX.",3,0,3,0,0,0,
12/07/2023,Chiapas,"TUXTLA GUTIÉRREZ, CHIS.",1,1,2,0,0,209,
12/07/2023,Cd. de México,"CUAUHTEMOC, CD. MÉX.",2,0,2,0,0,0,
12/07/2023,Cd. de México,"IZTAPALAPA, CD. MÉX.",1,0,1,0,0,49,
12/07/2023,México,"COYOTEPEC, MEX.",1,0,1,0,0,15,
12/07/2023,Tamaulipas,"VICTORIA, TAMPS.",1,0,1,0,0,0,
12/07/2023,Chiapas,"SAN CRISTOBAL DE LAS CASAS, CHIS.",0,0,0,0,0,203,
13/07/2023,Tlaxcala,"APIZACO, TLAX.",3,1,4,0,0,0,
13/07/2023,México,"VALLE DE BRAVO, MEX.",2,2,4,0,0,0,
13/07/2023,México,"CHIMALHUACAN, MEX.",4,0,4,0,0,84,
13/07/2023,Chiapas,"TAPACHULA, CHIS.",3,0,3,0,0,0,
13/07/2023,Cd. de México,"CUAUHTEMOC, CD. MÉX.",2,1,3,0,0,0,
13/07/2023,México,"COYOTEPEC, MEX.",2,1,3,0,0,0,
13/07/2023,Tlaxcala,"TERRENATE, TLAX.",1,1,2,0,0,0,
13/07/2023,Cd. de México,"BENITO JUAREZ, CD. MÉX.",2,0,2,0,0,32,
13/07/2023,México,"IXTAPAN DE LA SAL, MEX.",0,1,1,0,0,0,
13/07/2023,Chiapas,"CHIAPA DE CORZO, CHIS.",1,0,1,0,0,212,
13/07/2023,Chiapas,"OCOSINGO, CHIS.",0,0,0,0,0,25,
13/07/2023,Cd. de México,"IZTAPALAPA, CD. MÉX.",0,0,0,0,0,523,
14/07/2023,México,"CHIMALHUACAN, MEX.",6,0,6,0,0,29,
14/07/2023,Cd. de México,"CUAUHTEMOC, CD. MÉX.",4,0,4,0,0,13,
14/07/2023,Cd. de México,"MIGUEL HIDALGO, CD. MÉX.",2,1,3,0,0,27,
14/07/2023,México,"VALLE DE BRAVO, MEX.",3,0,3,0,0,0,
14/07/2023,Tlaxcala,"TETLA DE LA SOLIDARIDAD, TLAX.",0,2,2,0,0,0,
14/07/2023,Querétaro,"CORREGIDORA, QRO.",2,0,2,5,0,90,
14/07/2023,Chiapas,"TUXTLA GUTIÉRREZ, CHIS.",1,0,1,0,0,677,
14/07/2023,México,"IXTAPAN DE LA SAL, MEX.",0,1,1,0,0,0,
14/07/2023,Tlaxcala,"TERRENATE, TLAX.",0,1,1,0,0,0,
14/07/2023,Chiapas,"OCOZOCOAUTLA DE ESPINOSA, CHIS.",0,0,0,4,0,911,
14/07/2023,México,"COYOTEPEC, MEX.",0,0,0,0,64,0,
14/07/2023,Chiapas,"TAPACHULA, CHIS.",0,0,0,0,0,156,
14/07/2023,Chiapas,"SAN CRISTOBAL DE LAS CASAS, CHIS.",0,0,0,0,0,150,
14/07/2023,Chiapas,"OCOSINGO, CHIS.",0,0,0,0,0,149,
15/07/2023,México,"CHIMALHUACAN, MEX.",7,0,7,0,0,5,
15/07/2023,Puebla,"ATLIXCO, PUE.",2,2,4,5,3,"1,658",
15/07/2023,México,"COYOTEPEC, MEX.",1,1,2,0,2,0,
15/07/2023,Chiapas,"TAPACHULA, CHIS.",1,0,1,0,2,72,
15/07/2023,Chiapas,"OCOZOCOAUTLA DE ESPINOSA, CHIS.",0,1,1,0,0,362,
15/07/2023,Tlaxcala,"APIZACO, TLAX.",1,0,1,0,0,0,
15/07/2023,Tlaxcala,"TETLA DE LA SOLIDARIDAD, TLAX.",0,1,1,0,0,0,
15/07/2023,Tlaxcala,"TLAXCALA, TLAX.",1,0,1,0,0,0,
15/07/2023,México,"IXTAPAN DE LA SAL, MEX.",0,1,1,0,0,0,
15/07/2023,México,"VALLE DE BRAVO, MEX.",1,0,1,0,0,0,
17/07/2023,México,"JOCOTITLAN, MEX.",1,4,5,0,0,0,
17/07/2023,Tlaxcala,"EMILIANO ZAPATA, TLAX.",1,0,1,0,0,0,
17/07/2023,Tlaxcala,"ZACATELCO, TLAX.",1,0,1,0,0,0,
17/07/2023,Cd. de México,"CUAUHTEMOC, CD. MÉX.",1,0,1,0,0,41,
17/07/2023,Chiapas,"MAZAPA DE MADERO, CHIS.",1,0,1,1,0,0,
17/07/2023,Chiapas,"TAPACHULA, CHIS.",0,0,0,4,0,159,
18/07/2023,México,"JOCOTITLAN, MEX.",0,7,7,0,0,26,
18/07/2023,México,"TULTITLAN, MEX.",3,1,4,0,0,31,
18/07/2023,Cd. de México,"CUAUHTEMOC, CD. MÉX.",2,2,4,0,0,0,
18/07/2023,Durango,"GOMEZ PALACIO, DGO.",1,3,4,1,0,17,
18/07/2023,Tlaxcala,"TLAXCALA, TLAX.",2,0,2,0,0,0,
18/07/2023,Chiapas,"TAPACHULA, CHIS.",1,0,1,810,0,0,
18/07/2023,Tlaxcala,"EMILIANO ZAPATA, TLAX.",0,1,1,0,0,0,
18/07/2023,Querétaro,"CORREGIDORA, QRO.",1,0,1,3,0,20,
18/07/2023,Durango,"SANTIAGO PAPASQUIARO, DGO.",0,0,0,14,1,0,
18/07/2023,Chiapas,"OCOZOCOAUTLA DE ESPINOSA, CHIS.",0,0,0,810,0,0,
19/07/2023,México,"CAPULHUAC, MEX.",2,2,4,0,0,0,
19/07/2023,Durango,"GOMEZ PALACIO, DGO.",2,0,2,3,0,21,
19/07/2023,México,"JOCOTITLAN, MEX.",1,1,2,0,2,0,
19/07/2023,Cd. de México,"CUAUHTEMOC, CD. MÉX.",1,0,1,0,0,348,
19/07/2023,Tlaxcala,"EMILIANO ZAPATA, TLAX.",1,0,1,0,0,0,
19/07/2023,Chiapas,"BERRIOZÁBAL, CHIS.",1,0,1,0,0,913,
19/07/2023,Chiapas,"OCOSINGO, CHIS.",1,0,1,1,0,87,
19/07/2023,México,"TULTITLAN, MEX.",0,0,0,0,2,0,
19/07/2023,Durango,"SANTIAGO PAPASQUIARO, DGO.",0,0,0,10,3,160,
20/07/2023,México,"TULTITLAN, MEX.",3,0,3,0,0,0,
20/07/2023,Tlaxcala,"YAUHQUEMECAN, TLAX.",0,2,2,0,0,0,
20/07/2023,Cd. de México,"CUAUHTEMOC, CD. MÉX.",0,1,1,0,0,0,
20/07/2023,Tlaxcala,"ZACATELCO, TLAX.",1,0,1,0,0,0,
22/07/2023,México,"JOCOTITLAN, MEX.",3,0,3,0,0,0,
22/07/2023,México,"CAPULHUAC, MEX.",1,1,2,0,0,0,
22/07/2023,Durango,"GOMEZ PALACIO, DGO.",1,0,1,1,0,22,
22/07/2023,Querétaro,"CORREGIDORA, QRO.",1,0,1,8,0,500,
22/07/2023,Durango,"DURANGO, DGO.",1,0,1,1,0,0,
22/07/2023,Durango,"SANTIAGO PAPASQUIARO, DGO.",0,0,0,0,0,60,
24/07/2023,Cd. de México,"CUAUHTEMOC, CD. MÉX.",2,1,3,0,0,385,
24/07/2023,Chiapas,"BERRIOZÁBAL, CHIS.",1,0,1,0,0,600,
24/07/2023,Chiapas,"OCOSINGO, CHIS.",0,0,0,0,0,250,
25/07/2023,Chiapas,"BERRIOZÁBAL, CHIS.",0,0,0,0,0,"1,509",
25/07/2023,Chiapas,"OCOSINGO, CHIS.",0,0,0,0,0,289,
26/07/2023,Cd. de México,"CUAUHTEMOC, CD. MÉX.",1,0,1,0,0,0,
26/07/2023,Chiapas,"TAPACHULA, CHIS.",0,0,0,1,0,292,
26/07/2023,Chiapas,"OCOSINGO, CHIS.",0,0,0,0,0,375,
27/07/2023,Chiapas,"HUIXTÁN, CHIS.",0,4,4,0,0,0,
27/07/2023,Chiapas,"VILLAFLORES, CHIS.",0,1,1,0,0,618,
27/07/2023,Chiapas,"OCOSINGO, CHIS.",0,0,0,3,0,931,
27/07/2023,Cd. de México,"CUAUHTEMOC, CD. MÉX.",0,0,0,0,1,49,
28/07/2023,Cd. de México,"VENUSTIANO CARRANZA, CD. MÉX.",3,0,3,0,0,413,
28/07/2023,Chiapas,"VILLAFLORES, CHIS.",2,0,2,2,0,"1,888",
28/07/2023,Cd. de México,"MIGUEL HIDALGO, CD. MÉX.",1,0,1,0,0,23,
28/07/2023,Chiapas,"HUIXTÁN, CHIS.",0,1,1,0,0,250,
28/07/2023,Chiapas,"LA INDEPENDENCIA, CHIS.",1,0,1,0,0,55,
28/07/2023,Chiapas,"OCOSINGO, CHIS.",0,0,0,2,0,668,
29/07/2023,Chiapas,"VILLAFLORES, CHIS.",0,0,0,0,0,"1,727",
30/07/2023,Chiapas,"VILLAFLORES, CHIS.",1,1,2,0,0,"3,667",
30/07/2023,Chiapas,"LA INDEPENDENCIA, CHIS.",1,0,1,0,0,90,
31/07/2023,Cd. de México,"CUAUHTEMOC, CD. MÉX.",3,0,3,0,0,63,
31/07/2023,México,"XONACATLAN, MEX.",3,0,3,0,0,531,
31/07/2023,Baja California Sur,"LA PAZ, B.C.S.",1,0,1,0,0,0,
31/07/2023,Chiapas,"SUCHIATE, CHIS.",0,0,0,0,0,167,
01/08/2023,Cd. de México,"CUAUHTEMOC, CD. MÉX.",3,5,8,5,1,25,
01/08/2023,Cd. de México,"IZTAPALAPA, CD. MÉX.",6,0,6,0,0,"1,667",
01/08/2023,México,"CUAUTITLAN, MEX.",1,3,4,0,0,168,
01/08/2023,Cd. de México,"CUAUHTEMOC, CD. MÉX.",3,0,3,0,0,150,
01/08/2023,México,"HUIXQUILUCAN, MEX.",2,0,2,0,0,0,
01/08/2023,México,"XONACATLAN, MEX.",1,0,1,0,0,64,
01/08/2023,México,"CHICOLOAPAN, MEX.",1,0,1,0,0,2,
02/08/2023,México,"CHICOLOAPAN, MEX.",51,0,51,0,0,0,
02/08/2023,Chihuahua,"JUÁREZ, CHIH.",5,3,8,2,0,815,
02/08/2023,Cd. de México,"MIGUEL HIDALGO, CD. MÉX.",3,2,5,0,2,310,
02/08/2023,México,"XONACATLAN, MEX.",2,0,2,0,7,0,
02/08/2023,México,"CUAUTITLAN, MEX.",2,0,2,0,80,0,
02/08/2023,México,"HUIXQUILUCAN, MEX.",1,0,1,0,0,108,
03/08/2023,México,"CUAUTITLAN, MEX.",7,0,7,2,34,0,
03/08/2023,México,"HUIXQUILUCAN, MEX.",4,2,6,0,0,764,
03/08/2023,Cd. de México,"CUAUHTEMOC, CD. MÉX.",4,1,5,0,0,0,
03/08/2023,México,"CHICOLOAPAN, MEX.",2,0,2,0,0,0,
03/08/2023,Chiapas,"SUCHIATE, CHIS.",1,0,1,0,0,0,
03/08/2023,Tamaulipas,"VICTORIA, TAMPS.",1,0,1,0,0,0,
03/08/2023,Cd. de México,"IZTAPALAPA, CD. MÉX.",1,0,1,0,0,0,
03/08/2023,Cd. de México,"VENUSTIANO CARRANZA, CD. MÉX.",1,0,1,0,0,0,
04/08/2023,México,"HUIXQUILUCAN, MEX.",4,2,6,0,0,"1,188",
04/08/2023,México,"XONACATLAN, MEX.",4,0,4,0,4,"2,000",
04/08/2023,México,"CHICOLOAPAN, MEX.",1,1,2,0,0,33,
04/08/2023,México,"CUAUTITLAN, MEX.",1,0,1,0,18,0,
04/08/2023,Cd. de México,"IZTACALCO, CD. MÉX.",0,0,0,0,0,468,
05/08/2023,México,"CUAUTITLAN, MEX.",2,2,4,1,2,54,
05/08/2023,México,"CHICOLOAPAN, MEX.",2,0,2,0,3,50,
07/08/2023,México,"ATLACOMULCO, MEX.",1,3,4,0,0,72,
07/08/2023,Chiapas,"CHENALHÓ, CHIS.",0,2,2,0,0,0,
07/08/2023,Cd. de México,"CUAUHTEMOC, CD. MÉX.",2,0,2,0,0,13,
07/08/2023,Tamaulipas,"VICTORIA, TAMPS.",2,0,2,0,0,0,
07/08/2023,Cd. de México,"IZTAPALAPA, CD. MÉX.",1,0,1,0,0,44,
08/08/2023,Chiapas,"CHENALHÓ, CHIS.",1,8,9,0,0,0,
08/08/2023,Cd. de México,"CUAUHTEMOC, CD. MÉX.",3,0,3,0,0,214,
08/08/2023,México,"SAN MARTIN DE LAS PIRAMIDES, MEX.",1,0,1,0,0,6,
08/08/2023,Chiapas,"TAPACHULA, CHIS.",1,0,1,0,0,20,
08/08/2023,México,"MALINALCO, MEX.",1,0,1,0,0,0,
08/08/2023,Cd. de México,"IZTACALCO, CD. MÉX.",0,0,0,0,1,0,
09/08/2023,Tamaulipas,"VICTORIA, TAMPS.",5,3,8,0,0,0,
09/08/2023,Chiapas,"CHENALHÓ, CHIS.",2,5,7,0,0,0,
09/08/2023,Michoacán,"ALVARO OBREGON, MICH.",1,1,2,64,0,7,
09/08/2023,México,"ATLACOMULCO, MEX.",2,0,2,1,0,0,
09/08/2023,México,"MALINALCO, MEX.",1,0,1,0,0,0,
09/08/2023,Cd. de México,"CUAUHTEMOC, CD. MÉX.",1,0,1,0,0,6,
09/08/2023,Chiapas,"TUXTLA CHICO, CHIS.",0,0,0,0,0,32,
09/08/2023,Cd. de México,"TLAHUAC, CD. MÉX.",0,0,0,0,0,175,
10/08/2023,Cd. de México,"CUAUHTEMOC, CD. MÉX.",5,0,5,0,0,290,
10/08/2023,Cd. de México,"TLAHUAC, CD. MÉX.",2,1,3,0,0,129,
10/08/2023,México,"SAN MARTIN DE LAS PIRAMIDES, MEX.",0,3,3,0,0,0,
10/08/2023,Michoacán,"ALVARO OBREGON, MICH.",0,2,2,116,0,0,
10/08/2023,México,"ATLACOMULCO, MEX.",2,0,2,0,0,86,
10/08/2023,Chiapas,"CHENALHÓ, CHIS.",0,1,1,0,0,0,
10/08/2023,Cd. de México,"IZTACALCO, CD. MÉX.",0,1,1,0,0,0,
10/08/2023,Tamaulipas,"VICTORIA, TAMPS.",1,0,1,0,0,0,
10/08/2023,México,"TEPETLAOXTOC, MEX.",0,1,1,0,0,0,
10/08/2023,Chiapas,"LA INDEPENDENCIA, CHIS.",1,0,1,0,0,0,
11/08/2023,México,"ATLACOMULCO, MEX.",2,1,3,0,0,161,
11/08/2023,México,"MALINALCO, MEX.",1,0,1,0,0,0,
11/08/2023,Michoacán,"ALVARO OBREGON, MICH.",0,0,0,5,0,0,
11/08/2023,México,"SAN MARTIN DE LAS PIRAMIDES, MEX.",0,0,0,0,0,"1,750",
12/08/2023,Michoacán,"ALVARO OBREGON, MICH.",2,1,3,5,4,0,
12/08/2023,México,"ATLACOMULCO, MEX.",1,1,2,0,0,0,
12/08/2023,México,"MALINALCO, MEX.",0,1,1,0,0,0,
12/08/2023,México,"SAN MARTIN DE LAS PIRAMIDES, MEX.",0,1,1,0,0,0,
12/08/2023,México,"TEPETLAOXTOC, MEX.",1,0,1,0,0,39,
13/08/2023,Michoacán,"ALVARO OBREGON, MICH.",0,1,1,0,0,42,
14/08/2023,Sinaloa,"SALVADOR ALVARADO, SIN.",11,2,13,0,1,174,
14/08/2023,Sinaloa,"MOCORITO, SIN.",2,1,3,0,0,0,
14/08/2023,Cd. de México,"GUSTAVO A. MADERO, CD. MÉX.",0,2,2,0,0,49,
14/08/2023,Puebla,"PALMAR DE BRAVO, PUE.",1,0,1,0,0,91,
14/08/2023,Sinaloa,"BADIRAGUATO, SIN.",0,1,1,0,0,0,
14/08/2023,Cd. de México,"TLAHUAC, CD. MÉX.",1,0,1,0,0,0,
14/08/2023,Cd. de México,"CUAUHTEMOC, CD. MÉX.",1,0,1,0,0,7,
14/08/2023,Tamaulipas,"VICTORIA, TAMPS.",1,0,1,0,0,0,
15/08/2023,Tamaulipas,"VICTORIA, TAMPS.",7,3,10,0,0,0,
15/08/2023,Sinaloa,"SALVADOR ALVARADO, SIN.",5,2,7,0,0,16,
15/08/2023,Sinaloa,"MOCORITO, SIN.",4,1,5,0,1,0,
15/08/2023,Sinaloa,"BADIRAGUATO, SIN.",3,1,4,0,0,142,
15/08/2023,Cd. de México,"CUAUHTEMOC, CD. MÉX.",2,2,4,0,0,5,
15/08/2023,Cd. de México,"GUSTAVO A. MADERO, CD. MÉX.",1,0,1,0,0,0,
15/08/2023,Cd. de México,"TLAHUAC, CD. MÉX.",0,1,1,0,0,0,
15/08/2023,Puebla,"PALMAR DE BRAVO, PUE.",1,0,1,0,0,91,
15/08/2023,Guerrero,"EDUARDO NERI, GRO.",1,0,1,0,0,0,
15/08/2023,Cd. de México,"IZTACALCO, CD. MÉX.",0,0,0,0,0,767,
16/08/2023,Cd. de México,"CUAUHTEMOC, CD. MÉX.",3,0,3,0,0,0,
16/08/2023,Sinaloa,"SALVADOR ALVARADO, SIN.",2,1,3,0,0,87,
16/08/2023,Sinaloa,"MOCORITO, SIN.",2,1,3,0,0,0,
16/08/2023,Chihuahua,"JUÁREZ, CHIH.",1,1,2,1,0,15,
16/08/2023,Chihuahua,"JUÁREZ, CHIH.",1,1,2,1,0,15,
16/08/2023,Michoacán,"ALVARO OBREGON, MICH.",1,0,1,0,0,0,
16/08/2023,Tamaulipas,"VICTORIA, TAMPS.",1,0,1,0,0,0,
16/08/2023,Querétaro,"PEDRO ESCOBEDO, QRO.",1,0,1,0,0,0,
16/08/2023,Sinaloa,"BADIRAGUATO, SIN.",1,0,1,0,0,0,
16/08/2023,Cd. de México,"GUSTAVO A. MADERO, CD. MÉX.",0,0,0,0,0,50,
17/08/2023,Chihuahua,"JUÁREZ, CHIH.",8,0,8,4,0,206,
17/08/2023,Sinaloa,"SALVADOR ALVARADO, SIN.",4,0,4,0,0,81,
17/08/2023,Sinaloa,"BADIRAGUATO, SIN.",2,1,3,0,1,0,
17/08/2023,Sinaloa,"MOCORITO, SIN.",1,1,2,0,0,0,
17/08/2023,Michoacán,"CUITZEO, MICH.",2,0,2,110,0,15,
17/08/2023,Querétaro,"CADEREYTA DE MONTES, QRO.",1,0,1,0,0,16,
17/08/2023,Cd. de México,"IZTACALCO, CD. MÉX.",0,1,1,0,0,0,
18/08/2023,Chihuahua,"JUÁREZ, CHIH.",6,2,8,16,0,393,
18/08/2023,Michoacán,"CUITZEO, MICH.",4,0,4,8,0,145,
18/08/2023,Cd. de México,"CUAUHTEMOC, CD. MÉX.",3,0,3,0,0,87,
18/08/2023,Cd. de México,"MIGUEL HIDALGO, CD. MÉX.",1,1,2,0,0,146,
18/08/2023,Sinaloa,"BADIRAGUATO, SIN.",1,1,2,0,0,0,
18/08/2023,Sinaloa,"SALVADOR ALVARADO, SIN.",1,0,1,0,0,93,
18/08/2023,Sinaloa,"MOCORITO, SIN.",0,1,1,0,0,0,
18/08/2023,Cd. de México,"TLAHUAC, CD. MÉX.",0,0,0,0,0,361,
19/08/2023,Querétaro,"PEDRO ESCOBEDO, QRO.",1,1,2,0,0,0,
19/08/2023,Michoacán,"CUITZEO, MICH.",0,1,1,0,0,0,
19/08/2023,Querétaro,"CADEREYTA DE MONTES, QRO.",0,1,1,0,0,0,
21/08/2023,Chihuahua,"JUÁREZ, CHIH.",6,0,6,6,0,120,
21/08/2023,Cd. de México,"CUAUHTEMOC, CD. MÉX.",3,0,3,0,0,0,
21/08/2023,Cd. de México,"MIGUEL HIDALGO, CD. MÉX.",0,2,2,0,0,7,
21/08/2023,Puebla,"PALMAR DE BRAVO, PUE.",1,0,1,0,0,0,
21/08/2023,Sinaloa,"SALVADOR ALVARADO, SIN.",1,0,1,0,0,176,
22/08/2023,Tabasco,"CARDENAS, TAB.",3,3,6,0,0,0,
22/08/2023,Sinaloa,"BADIRAGUATO, SIN.",2,1,3,0,0,0,
22/08/2023,Puebla,"CUETZALAN DEL PROGRESO, PUE.",2,0,2,0,0,0,
22/08/2023,Sinaloa,"MOCORITO, SIN.",1,1,2,0,0,0,
22/08/2023,Chiapas,"OSUMACINTA, CHIS.",0,0,0,0,0,101,
22/08/2023,Chiapas,"CACAHOATÁN, CHIS.",0,0,0,4,0,116,
22/08/2023,Sinaloa,"SALVADOR ALVARADO, SIN.",0,0,0,0,0,58,
23/08/2023,Tabasco,"CARDENAS, TAB.",4,1,5,2,0,264,
23/08/2023,Cd. de México,"GUSTAVO A. MADERO, CD. MÉX.",3,0,3,0,1,516,
23/08/2023,Sinaloa,"BADIRAGUATO, SIN.",3,0,3,0,0,0,
23/08/2023,Chihuahua,"JUÁREZ, CHIH.",2,1,3,22,2,116,
23/08/2023,Michoacán,"COPANDARO, MICH.",0,1,1,0,0,0,
23/08/2023,Cd. de México,"CUAUHTEMOC, CD. MÉX.",1,0,1,0,0,0,
23/08/2023,Sinaloa,"SALVADOR ALVARADO, SIN.",0,1,1,0,0,376,
23/08/2023,Chiapas,"TUXTLA GUTIÉRREZ, CHIS.",1,0,1,0,0,639,
23/08/2023,Chiapas,"OSUMACINTA, CHIS.",1,0,1,0,0,800,
23/08/2023,Sinaloa,"MOCORITO, SIN.",1,0,1,0,0,0,
23/08/2023,Chihuahua,"JUÁREZ, CHIH.",0,0,0,0,0,162,
23/08/2023,Guerrero,"TIXTLA DE GUERRERO, GRO.",0,0,0,1,0,58,
24/08/2023,Cd. de México,"MIGUEL HIDALGO, CD. MÉX.",2,0,2,0,0,54,
24/08/2023,Sinaloa,"BADIRAGUATO, SIN.",1,1,2,0,0,0,
24/08/2023,Sinaloa,"SALVADOR ALVARADO, SIN.",0,2,2,0,0,0,
24/08/2023,Michoacán,"COPANDARO, MICH.",0,1,1,1,0,0,
24/08/2023,Querétaro,"HUIMILPAN, QRO.",1,0,1,0,0,154,
24/08/2023,Guerrero,"TIXTLA DE GUERRERO, GRO.",0,1,1,0,0,0,
24/08/2023,Cd. de México,"CUAUHTEMOC, CD. MÉX.",1,0,1,0,1,61,
25/08/2023,Michoacán,"COPANDARO, MICH.",3,1,4,4,0,29,
25/08/2023,Sinaloa,"SALVADOR ALVARADO, SIN.",1,2,3,0,0,0,
25/08/2023,Tamaulipas,"VICTORIA, TAMPS.",3,0,3,0,0,0,
25/08/2023,Sinaloa,"BADIRAGUATO, SIN.",0,2,2,0,0,0,
25/08/2023,Cd. de México,"BENITO JUAREZ, CD. MÉX.",2,0,2,0,0,0,
25/08/2023,Guerrero,"TIXTLA DE GUERRERO, GRO.",0,1,1,0,0,19,
25/08/2023,Puebla,"LIBRES, PUE.",1,0,1,3,0,246,
25/08/2023,Sinaloa,"MOCORITO, SIN.",1,0,1,0,0,0,
25/08/2023,Cd. de México,"CUAUHTEMOC, CD. MÉX.",1,0,1,0,0,0,
25/08/2023,Tabasco,"CARDENAS, TAB.",0,0,0,0,0,135,
25/08/2023,Chiapas,"TUXTLA GUTIÉRREZ, CHIS.",0,0,0,0,0,203,
25/08/2023,Chihuahua,"JUÁREZ, CHIH.",0,0,0,35,0,207,
26/08/2023,Michoacán,"COPANDARO, MICH.",0,2,2,3,0,19,
27/08/2023,Michoacán,"COPANDARO, MICH.",1,0,1,0,0,0,
28/08/2023,Cd. de México,"BENITO JUAREZ, CD. MÉX.",5,1,6,0,0,"1,549",
28/08/2023,Morelos,"JIUTEPEC, MOR.",4,1,5,0,0,0,
28/08/2023,Cd. de México,"BENITO JUAREZ, CD. MÉX.",2,2,4,0,0,133,
28/08/2023,Tabasco,"CARDENAS, TAB.",3,1,4,0,0,566,
28/08/2023,Cd. de México,"CUAUHTEMOC, CD. MÉX.",1,2,3,0,0,228,
28/08/2023,Michoacán,"CUITZEO, MICH.",0,1,1,0,0,0,
28/08/2023,Chiapas,"CHANAL, CHIS.",0,1,1,0,0,0,
28/08/2023,Guerrero,"TIXTLA DE GUERRERO, GRO.",1,0,1,0,0,3,
28/08/2023,Cd. de México,"GUSTAVO A. MADERO, CD. MÉX.",1,0,1,0,0,163,
28/08/2023,Tamaulipas,"REYNOSA, TAMPS.",0,0,0,3,0,83,
29/08/2023,Tamaulipas,"REYNOSA, TAMPS.",1,2,3,14,1,162,
29/08/2023,Morelos,"JIUTEPEC, MOR.",1,0,1,3,2,"1,084",
29/08/2023,Tabasco,"HUIMANGUILLO, TAB.",1,0,1,0,0,0,
29/08/2023,Chiapas,"TUXTLA GUTIÉRREZ, CHIS.",1,0,1,0,0,0,
30/08/2023,Querétaro,"QUERETARO, QRO.",3,4,7,14,0,48,
30/08/2023,Tamaulipas,"REYNOSA, TAMPS.",4,2,6,14,0,784,
30/08/2023,Querétaro,"EL MARQUES, QRO.",2,0,2,0,0,129,
30/08/2023,Cd. de México,"GUSTAVO A. MADERO, CD. MÉX.",0,2,2,0,0,"2,170",
30/08/2023,Chiapas,"TUXTLA GUTIÉRREZ, CHIS.",0,2,2,0,0,"1,000",
30/08/2023,Michoacán,"CUITZEO, MICH.",1,1,2,1,0,22,
30/08/2023,Chihuahua,"OJINAGA, CHIH.",1,1,2,1,0,40,
30/08/2023,Morelos,"JIUTEPEC, MOR.",1,0,1,0,0,0,
30/08/2023,Tamaulipas,"MATAMOROS, TAMPS.",1,0,1,0,0,0,
31/08/2023,Querétaro,"QUERETARO, QRO.",6,8,14,11,17,647,
31/08/2023,Cd. de México,"CUAUHTEMOC, CD. MÉX.",1,3,4,0,1,10,
31/08/2023,Morelos,"JIUTEPEC, MOR.",3,0,3,0,1,0,
31/08/2023,Chiapas,"COPAINALÁ, CHIS.",0,2,2,0,0,550,
31/08/2023,Michoacán,"CUITZEO, MICH.",1,1,2,1,0,36,
31/08/2023,Tamaulipas,"REYNOSA, TAMPS.",2,0,2,60,0,693,
31/08/2023,Cd. de México,"GUSTAVO A. MADERO, CD. MÉX.",2,0,2,0,0,6,
31/08/2023,Chiapas,"TUXTLA GUTIÉRREZ, CHIS.",0,1,1,0,0,0,
31/08/2023,Tabasco,"CARDENAS, TAB.",1,0,1,1,0,702,
31/08/2023,Querétaro,"EL MARQUES, QRO.",0,0,0,0,0,7,
01/09/2023,Querétaro,"QUERETARO, QRO.",6,4,10,176,0,124,
01/09/2023,Tamaulipas,"REYNOSA, TAMPS.",2,2,4,8,0,191,
01/09/2023,Cd. de México,"BENITO JUAREZ, CD. MÉX.",3,0,3,0,0,110,
01/09/2023,Tabasco,"CARDENAS, TAB.",1,1,2,1,0,105,
01/09/2023,Cd. de México,"GUSTAVO A. MADERO, CD. MÉX.",2,0,2,0,0,0,
01/09/2023,Morelos,"JIUTEPEC, MOR.",2,0,2,7,0,407,
01/09/2023,Michoacán,"ZITACUARO, MICH.",1,0,1,4,1,168,
01/09/2023,Chiapas,"COPAINALÁ, CHIS.",0,0,0,0,1,350,
01/09/2023,Querétaro,"EL MARQUES, QRO.",0,0,0,0,0,60,
02/09/2023,Michoacán,"ZITACUARO, MICH.",4,7,11,9,0,100,
03/09/2023,Chiapas,"CACAHOATÁN, CHIS.",0,0,0,0,0,212,
04/09/2023,Puebla,"TEHUACAN, PUE.",2,1,3,0,1,78,
04/09/2023,Cd. de México,"BENITO JUAREZ, CD. MÉX.",1,0,1,0,0,0,
04/09/2023,Tabasco,"SUNUAPA, CHIS.",0,1,1,0,0,0,
04/09/2023,Cd. de México,"CUAUHTEMOC, CD. MÉX.",0,1,1,0,0,89,
04/09/2023,Tabasco,"JONUTA, TAB.",1,0,1,0,0,0,
04/09/2023,Tamaulipas,"NUEVO LAREDO, TAMPS.",0,0,0,5,0,198,
04/09/2023,Tamaulipas,"REYNOSA, TAMPS.",0,0,0,6,0,167,
05/09/2023,Tamaulipas,"REYNOSA, TAMPS.",1,0,1,6,0,222,
05/09/2023,Tamaulipas,"NUEVO LAREDO, TAMPS.",0,0,0,18,0,220,
06/09/2023,Michoacán,"MARAVATIO, MICH.",4,0,4,112,0,30,
06/09/2023,Tamaulipas,"NUEVO LAREDO, TAMPS.",2,0,2,0,0,0,
06/09/2023,Tabasco,"OSTUACÁN, CHIS.",0,1,1,0,0,0,
06/09/2023,Cd. de México,"BENITO JUAREZ, CD. MÉX.",0,1,1,0,0,0,
06/09/2023,Guerrero,"EDUARDO NERI, GRO.",0,0,0,4,0,120,
07/09/2023,Chihuahua,"JUÁREZ, CHIH.",4,0,4,23,0,548,
07/09/2023,Tabasco,"PICHUCALCO, CHIS.",3,1,4,0,0,0,
07/09/2023,Cd. de México,"VENUSTIANO CARRANZA, CD. MÉX.",3,0,3,0,0,354,
07/09/2023,Tamaulipas,"NUEVO LAREDO, TAMPS.",2,0,2,5,0,189,
07/09/2023,Puebla,"TEHUACAN, PUE.",1,0,1,0,2,64,
07/09/2023,Michoacán,"MARAVATIO, MICH.",1,0,1,45,0,281,
07/09/2023,Cd. de México,"BENITO JUAREZ, CD. MÉX.",1,0,1,0,0,111,
07/09/2023,Guerrero,"EDUARDO NERI, GRO.",0,0,0,7,0,162,
08/09/2023,Michoacán,"MARAVATIO, MICH.",2,1,3,77,0,113,
08/09/2023,Chihuahua,"JUÁREZ, CHIH.",2,0,2,1,0,32,
08/09/2023,Cd. de México,"BENITO JUAREZ, CD. MÉX.",1,0,1,0,0,0,
08/09/2023,Tamaulipas,"NUEVO LAREDO, TAMPS.",0,0,0,28,0,50,
08/09/2023,Cd. de México,"XOCHIMILCO, CD. MÉX.",0,0,0,0,1,32,
08/09/2023,Cd. de México,"CUAUHTEMOC, CD. MÉX.",0,0,0,0,2,0,
11/09/2023,Chihuahua,"JUÁREZ, CHIH.",0,1,1,15,0,113,
11/09/2023,Puebla,"TEHUACAN, PUE.",0,0,0,7,1,0,
12/09/2023,Cd. de México,"BENITO JUAREZ, CD. MÉX.",1,0,1,0,0,49,
12/09/2023,Chihuahua,"JUÁREZ, CHIH.",0,0,0,2,0,30,
12/09/2023,Cd. de México,"XOCHIMILCO, CD. MÉX.",0,0,0,0,0,210,
13/09/2023,Chihuahua,"JUÁREZ, CHIH.",3,0,3,0,0,129,
14/09/2023,Cd. de México,"VENUSTIANO CARRANZA, CD. MÉX.",2,0,2,0,0,0,
18/09/2023,Cd. de México,"CUAUHTEMOC, CD. MÉX.",3,0,3,0,0,470,
18/09/2023,Puebla,"TEHUACAN, PUE.",1,0,1,0,1,150,
18/09/2023,Chihuahua,"JUÁREZ, CHIH.",0,1,1,0,0,100,
19/09/2023,Puebla,"TEHUACAN, PUE.",5,1,6,0,6,315,
19/09/2023,Michoacán,"LA PIEDAD, MICH.",0,5,5,0,0,0,
19/09/2023,Cd. de México,"BENITO JUAREZ, CD. MÉX.",3,0,3,0,0,192,
19/09/2023,Chihuahua,"JUÁREZ, CHIH.",0,2,2,0,0,237,
19/09/2023,Cd. de México,"CUAUHTEMOC, CD. MÉX.",0,0,0,0,0,70,
20/09/2023,Chihuahua,"JUÁREZ, CHIH.",3,2,5,2,0,323,
20/09/2023,Cd. de México,"BENITO JUAREZ, CD. MÉX.",2,1,3,0,0,139,
20/09/2023,Cd. de México,"ALVARO OBREGON, CD. MÉX.",0,0,0,0,0,27,
21/09/2023,Michoacán,"LA PIEDAD, MICH.",2,39,41,10,0,38,
21/09/2023,Cd. de México,"CUAUHTEMOC, CD. MÉX.",2,0,2,0,0,27,
21/09/2023,Cd. de México,"BENITO JUAREZ, CD. MÉX.",0,1,1,0,0,0,
21/09/2023,Cd. de México,"XOCHIMILCO, CD. MÉX.",1,0,1,0,0,0,
21/09/2023,Chihuahua,"JUÁREZ, CHIH.",0,0,0,0,0,259,
22/09/2023,Michoacán,"LA PIEDAD, MICH.",4,50,54,17,0,52,
22/09/2023,Cd. de México,"CUAUHTEMOC, CD. MÉX.",4,0,4,0,0,136,
22/09/2023,Cd. de México,"ALVARO OBREGON, CD. MÉX.",0,3,3,0,0,186,
22/09/2023,Guerrero,"ZITLALA, GRO.",0,0,0,2,0,37,
25/09/2023,Cd. de México,"XOCHIMILCO, CD. MÉX.",2,0,2,0,0,670,
25/09/2023,Cd. de México,"CUAUHTEMOC, CD. MÉX.",1,0,1,0,0,0,
25/09/2023,Cd. de México,"ALVARO OBREGON, CD. MÉX.",0,0,0,0,0,22,
26/09/2023,Cd. de México,"ALVARO OBREGON, CD. MÉX.",3,0,3,0,0,34,
26/09/2023,Chihuahua,"JUÁREZ, CHIH.",1,0,1,0,0,0,
27/09/2023,Michoacán,"PENJAMILLO, MICH.",1,5,6,0,0,0,
27/09/2023,Veracruz,"POZA RICA DE HIDALGO, VER.",2,1,3,0,0,273,
27/09/2023,Chihuahua,"JUÁREZ, CHIH.",2,0,2,30,0,132,
28/09/2023,Cd. de México,"CUAUHTEMOC, CD. MÉX.",3,0,3,0,0,42,
28/09/2023,Chihuahua,"JUÁREZ, CHIH.",1,0,1,23,0,160,
28/09/2023,Veracruz,"TIHUATLAN, VER.",1,0,1,0,0,757,
29/09/2023,Cd. de México,"CUAUHTEMOC, CD. MÉX.",1,0,1,0,0,0,
29/09/2023,Chihuahua,"JUÁREZ, CHIH.",1,0,1,24,1,141,
01/10/2023,Sinaloa,"CONCORDIA, SIN.",0,1,1,0,0,0,
01/10/2023,Sinaloa,"COSALA, SIN.",0,0,0,0,0,200,
02/10/2023,Chihuahua,"JUÁREZ, CHIH.",2,3,5,0,0,0,
02/10/2023,Sinaloa,"MAZATLAN, SIN.",3,0,3,0,0,5,
02/10/2023,Sinaloa,"ROSARIO, SIN.",2,1,3,0,0,0,
02/10/2023,Sinaloa,"ESCUINAPA, SIN.",1,0,1,0,0,0,
02/10/2023,Cd. de México,"ALVARO OBREGON, CD. MÉX.",0,0,0,0,0,110,
03/10/2023,Tamaulipas,"VICTORIA, TAMPS.",9,3,12,0,0,0,
03/10/2023,Sinaloa,"ROSARIO, SIN.",3,2,5,0,0,0,
03/10/2023,Chihuahua,"CHIHUAHUA, CHIH.",2,2,4,0,0,196,
03/10/2023,Sinaloa,"MAZATLAN, SIN.",2,2,4,0,1,119,
03/10/2023,Cd. de México,"CUAUHTEMOC, CD. MÉX.",4,0,4,0,0,242,
03/10/2023,Sinaloa,"ESCUINAPA, SIN.",2,1,3,0,0,0,
03/10/2023,Chihuahua,"JUÁREZ, CHIH.",2,1,3,0,0,32,
04/10/2023,Chihuahua,"JUÁREZ, CHIH.",9,1,10,4,0,325,
04/10/2023,Sinaloa,"ROSARIO, SIN.",0,3,3,0,0,0,
04/10/2023,Sinaloa,"ESCUINAPA, SIN.",2,1,3,0,0,0,
04/10/2023,Sinaloa,"MAZATLAN, SIN.",2,0,2,0,0,147,
04/10/2023,Cd. de México,"VENUSTIANO CARRANZA, CD. MÉX.",1,0,1,0,0,0,
05/10/2023,Sinaloa,"ROSARIO, SIN.",4,2,6,0,0,0,
05/10/2023,Chihuahua,"CHIHUAHUA, CHIH.",6,0,6,0,0,409,
05/10/2023,Cd. de México,"CUAUHTEMOC, CD. MÉX.",2,3,5,0,0,0,
05/10/2023,Sinaloa,"MAZATLAN, SIN.",2,1,3,0,1,470,
05/10/2023,Chiapas,"SUCHIAPA, CHIS.",2,0,2,0,0,693,
05/10/2023,Cd. de México,"VENUSTIANO CARRANZA, CD. MÉX.",2,0,2,0,0,95,
05/10/2023,Cd. de México,"ALVARO OBREGON, CD. MÉX.",2,0,2,0,0,12,
05/10/2023,Chihuahua,"JUÁREZ, CHIH.",0,1,1,0,0,0,
05/10/2023,Sinaloa,"ESCUINAPA, SIN.",0,1,1,0,0,60,
06/10/2023,Chihuahua,"CHIHUAHUA, CHIH.",8,1,9,0,1,714,
06/10/2023,Sinaloa,"ROSARIO, SIN.",4,3,7,0,0,0,
06/10/2023,Sinaloa,"MAZATLAN, SIN.",2,2,4,0,0,0,
06/10/2023,Sinaloa,"ESCUINAPA, SIN.",1,0,1,0,0,0,
06/10/2023,Cd. de México,"CUAUHTEMOC, CD. MÉX.",0,0,0,0,0,49,
09/10/2023,Cd. de México,"VENUSTIANO CARRANZA, CD. MÉX.",4,1,5,0,1,701,
09/10/2023,Sinaloa,"ESCUINAPA, SIN.",3,2,5,0,0,47,
09/10/2023,Sinaloa,"ROSARIO, SIN.",2,2,4,0,1,0,
09/10/2023,Sinaloa,"MAZATLAN, SIN.",2,1,3,0,0,"1,242",
09/10/2023,Chihuahua,"CHIHUAHUA, CHIH.",2,0,2,0,0,467,
09/10/2023,Tamaulipas,"VICTORIA, TAMPS.",1,0,1,1,0,8,
09/10/2023,Cd. de México,"CUAUHTEMOC, CD. MÉX.",0,1,1,0,0,0,
10/10/2023,Sinaloa,"MAZATLAN, SIN.",1,3,4,0,0,26,
10/10/2023,Chihuahua,"CHIHUAHUA, CHIH.",3,0,3,2,0,511,
10/10/2023,Sinaloa,"ROSARIO, SIN.",2,1,3,0,0,0,
10/10/2023,Cd. de México,"ALVARO OBREGON, CD. MÉX.",2,0,2,0,0,153,
10/10/2023,Sinaloa,"ESCUINAPA, SIN.",2,0,2,0,0,0,
10/10/2023,Cd. de México,"CUAUHTEMOC, CD. MÉX.",1,0,1,0,0,0,
10/10/2023,Chiapas,"CHENALHÓ, CHIS.",0,1,1,0,0,0,
11/10/2023,Chihuahua,"CUAUHTÉMOC, CHIH.",7,0,7,0,0,0,
11/10/2023,Sinaloa,"ESCUINAPA, SIN.",1,3,4,0,0,0,
11/10/2023,Chihuahua,"CHIHUAHUA, CHIH.",1,0,1,0,0,241,
11/10/2023,Tamaulipas,"VICTORIA, TAMPS.",1,0,1,0,0,0,
11/10/2023,Sinaloa,"MAZATLAN, SIN.",1,0,1,0,0,205,
11/10/2023,Chiapas,"EL PORVENIR, CHIS.",1,0,1,0,0,0,
11/10/2023,Chiapas,"CHENALHÓ, CHIS.",0,0,0,0,0,12,
12/10/2023,Sinaloa,"MAZATLAN, SIN.",4,10,14,0,0,135,
12/10/2023,Chihuahua,"CUAUHTÉMOC, CHIH.",4,5,9,0,0,264,
12/10/2023,Sinaloa,"ROSARIO, SIN.",4,4,8,0,0,0,
12/10/2023,Sinaloa,"ESCUINAPA, SIN.",2,1,3,0,0,0,
12/10/2023,Chihuahua,"JUÁREZ, CHIH.",2,0,2,0,5,635,
13/10/2023,Sinaloa,"ROSARIO, SIN.",5,2,7,0,0,0,
13/10/2023,Chihuahua,"CUAUHTÉMOC, CHIH.",7,0,7,5,0,326,
13/10/2023,Sinaloa,"MAZATLAN, SIN.",6,1,7,0,1,0,
13/10/2023,Tamaulipas,"VICTORIA, TAMPS.",1,0,1,0,0,0,
13/10/2023,Sinaloa,"ESCUINAPA, SIN.",1,0,1,0,0,0,
13/10/2023,Cd. de México,"VENUSTIANO CARRANZA, CD. MÉX.",0,1,1,0,0,0,
13/10/2023,Chiapas,"CHENALHÓ, CHIS.",0,1,1,0,0,0,
13/10/2023,Chiapas,"EL PORVENIR, CHIS.",0,0,0,0,0,20,
14/10/2023,Chihuahua,"JUÁREZ, CHIH.",3,1,4,16,0,120,
14/10/2023,Chihuahua,"CHIHUAHUA, CHIH.",2,0,2,12,0,409,
14/10/2023,Chiapas,"EL PORVENIR, CHIS.",0,0,0,0,0,18,
15/10/2023,Tamaulipas,"VICTORIA, TAMPS.",1,0,1,0,0,0,
16/10/2023,Cd. de México,"CUAUHTEMOC, CD. MÉX.",1,4,5,0,0,387,
16/10/2023,Coahuila,"FRONTERA, COAH.",2,1,3,3,0,0,
17/10/2023,Cd. de México,"GUSTAVO A. MADERO, CD. MÉX.",1,1,2,0,0,0,
17/10/2023,Chiapas,"BELLA VISTA, CHIS.",0,0,0,2,0,56,
18/10/2023,Michoacán,"URUAPAN, MICH.",2,18,20,2,0,0,
18/10/2023,Cd. de México,"CUAUHTEMOC, CD. MÉX.",3,0,3,0,0,41,
19/10/2023,Michoacán,"URUAPAN, MICH.",6,30,36,30,0,0,
19/10/2023,Michoacán,"URUAPAN, MICH.",2,2,4,14,0,399,
19/10/2023,Coahuila,"FRONTERA, COAH.",1,2,3,1,0,0,
19/10/2023,Cd. de México,"GUSTAVO A. MADERO, CD. MÉX.",1,0,1,0,0,"1,152",
19/10/2023,Chiapas,"TONALÁ, CHIS.",1,0,1,0,0,0,
19/10/2023,Cd. de México,"CUAUHTEMOC, CD. MÉX.",0,0,0,0,0,37,
20/10/2023,Cd. de México,"VENUSTIANO CARRANZA, CD. MÉX.",1,0,1,0,0,4,
20/10/2023,Coahuila,"FRONTERA, COAH.",1,0,1,1,0,0,
20/10/2023,Cd. de México,"CUAUHTEMOC, CD. MÉX.",1,0,1,0,0,21,
20/10/2023,Cd. de México,"IZTAPALAPA, CD. MÉX.",0,0,0,0,0,157,
22/10/2023,Tamaulipas,"VICTORIA, TAMPS.",1,0,1,0,0,0,
24/10/2023,Coahuila,"FRONTERA, COAH.",3,4,7,3,0,245,
24/10/2023,Tlaxcala,"HUAMANTLA, TLAX.",2,1,3,0,0,0,
24/10/2023,Cd. de México,"CUAUHTEMOC, CD. MÉX.",2,0,2,0,0,0,
24/10/2023,Tlaxcala,"APETATITLAN DE ANTONIO CARVAJAL, TLAX.",0,1,1,0,0,0,
24/10/2023,Cd. de México,"VENUSTIANO CARRANZA, CD. MÉX.",1,0,1,0,0,50,
25/10/2023,Tlaxcala,"APIZACO, TLAX.",5,0,5,0,0,0,
25/10/2023,Coahuila,"FRONTERA, COAH.",3,0,3,3,0,300,
25/10/2023,Tlaxcala,"HUAMANTLA, TLAX.",3,0,3,0,0,0,
25/10/2023,Tlaxcala,"APETATITLAN DE ANTONIO CARVAJAL, TLAX.",0,2,2,0,0,0,
25/10/2023,Tlaxcala,"TOTOLAC, TLAX.",2,0,2,0,0,0,
26/10/2023,Tlaxcala,"APIZACO, TLAX.",1,1,2,0,0,0,
26/10/2023,Chiapas,"TONALÁ, CHIS.",1,0,1,0,0,0,
26/10/2023,Tlaxcala,"APETATITLAN DE ANTONIO CARVAJAL, TLAX.",1,0,1,0,0,0,
26/10/2023,Coahuila,"FRONTERA, COAH.",0,1,1,5,0,108,
26/10/2023,Cd. de México,"CUAUHTEMOC, CD. MÉX.",0,0,0,0,0,115,
26/10/2023,Tlaxcala,"TOTOLAC, TLAX.",0,0,0,0,0,30,
27/10/2023,Cd. de México,"GUSTAVO A. MADERO, CD. MÉX.",0,3,3,0,0,985,
27/10/2023,Tlaxcala,"APIZACO, TLAX.",2,0,2,0,0,0,
27/10/2023,Tamaulipas,"VICTORIA, TAMPS.",1,0,1,0,0,0,
27/10/2023,Coahuila,"MONCLOVA, COAH.",1,0,1,0,0,52,
27/10/2023,Cd. de México,"IZTAPALAPA, CD. MÉX.",1,0,1,0,0,24,
27/10/2023,Tlaxcala,"APETATITLAN DE ANTONIO CARVAJAL, TLAX.",0,1,1,0,0,0,
27/10/2023,Tlaxcala,"HUAMANTLA, TLAX.",0,1,1,1,0,14,
28/10/2023,Tlaxcala,"TOTOLAC, TLAX.",0,1,1,0,0,0,
28/10/2023,Tlaxcala,"HUAMANTLA, TLAX.",0,1,1,0,0,0,
29/10/2023,Chiapas,"TONALÁ, CHIS.",0,1,1,0,0,13,
30/10/2023,Sinaloa,"COSALA, SIN.",1,1,2,0,0,0,
30/10/2023,Coahuila,"MONCLOVA, COAH.",1,0,1,1,0,400,
30/10/2023,Sinaloa,"SAN IGNACIO, SIN.",0,1,1,0,0,5,
30/10/2023,Sinaloa,"CONCORDIA, SIN.",1,0,1,0,0,0,
30/10/2023,Cd. de México,"IZTAPALAPA, CD. MÉX.",1,0,1,0,0,0,
30/10/2023,Cd. de México,"CUAUHTEMOC, CD. MÉX.",1,0,1,0,0,109,
31/10/2023,Sinaloa,"SAN IGNACIO, SIN.",2,3,5,0,5,50,
31/10/2023,Coahuila,"MONCLOVA, COAH.",1,2,3,7,0,800,
31/10/2023,Tlaxcala,"APIZACO, TLAX.",2,0,2,0,0,0,
31/10/2023,Sinaloa,"CONCORDIA, SIN.",1,0,1,0,0,0,
31/10/2023,Tlaxcala,"SANTA CRUZ TLAXCALA, TLAX.",1,0,1,0,0,0,
31/10/2023,Tlaxcala,"HUAMANTLA, TLAX.",1,0,1,0,0,0,
31/10/2023,Cd. de México,"CUAUHTEMOC, CD. MÉX.",0,0,0,0,0,134,
01/11/2023,Coahuila,"MONCLOVA, COAH.",2,0,2,1,0,20,
01/11/2023,Tlaxcala,"SANTA CRUZ TLAXCALA, TLAX.",1,0,1,0,0,0,
01/11/2023,Cd. de México,"IZTAPALAPA, CD. MÉX.",0,1,1,0,0,4,
01/11/2023,Cd. de México,"CUAUHTEMOC, CD. MÉX.",1,0,1,0,0,0,
01/11/2023,Tlaxcala,"APIZACO, TLAX.",1,0,1,0,0,0,
02/11/2023,Tlaxcala,"TLAXCALA, TLAX.",2,1,3,0,0,0,
02/11/2023,Sinaloa,"SAN IGNACIO, SIN.",0,1,1,0,5,41,
03/11/2023,Tlaxcala,"TLAXCALA, TLAX.",1,2,3,0,0,0,
03/11/2023,Cd. de México,"GUSTAVO A. MADERO, CD. MÉX.",1,0,1,0,0,122,
03/11/2023,Sinaloa,"COSALA, SIN.",0,1,1,0,0,0,
03/11/2023,Sinaloa,"SAN IGNACIO, SIN.",0,1,1,0,4,149,
03/11/2023,Tlaxcala,"APIZACO, TLAX.",1,0,1,0,0,0,
03/11/2023,Coahuila,"MONCLOVA, COAH.",0,0,0,0,0,240,
03/11/2023,Cd. de México,"IZTAPALAPA, CD. MÉX.",0,0,0,0,0,2,
04/11/2023,Tlaxcala,"TLAXCALA, TLAX.",3,0,3,0,0,0,
04/11/2023,Tlaxcala,"HUAMANTLA, TLAX.",1,0,1,0,0,0,
06/11/2023,Cd. de México,"CUAUHTEMOC, CD. MÉX.",1,0,1,0,0,32,
06/11/2023,Tlaxcala,"CHIAUTEMPAN, TLAX.",1,0,1,0,0,0,
06/11/2023,Tlaxcala,"IXTACUIXTLA DE MARIANO MATAMOROS, TLAX.",1,0,1,1,0,0,
06/11/2023,Coahuila,"MONCLOVA, COAH.",0,0,0,3,0,816,
07/11/2023,Chiapas,"CHENALHÓ, CHIS.",0,2,2,0,0,0,
07/11/2023,Sinaloa,"SAN IGNACIO, SIN.",0,2,2,0,0,0,
07/11/2023,Cd. de México,"IZTAPALAPA, CD. MÉX.",0,1,1,0,0,0,
07/11/2023,Tlaxcala,"CHIAUTEMPAN, TLAX.",1,0,1,0,0,0,
07/11/2023,Sinaloa,"COSALA, SIN.",1,0,1,0,0,0,
07/11/2023,Cd. de México,"GUSTAVO A. MADERO, CD. MÉX.",1,0,1,0,0,0,
07/11/2023,Coahuila,"MONCLOVA, COAH.",0,0,0,0,1,984,
08/11/2023,Sinaloa,"SAN IGNACIO, SIN.",1,2,3,0,0,188,
08/11/2023,Cd. de México,"CUAJIMALPA DE MORELOS, CD. MÉX.",1,0,1,0,0,0,
08/11/2023,Sinaloa,"CONCORDIA, SIN.",1,0,1,0,0,0,
09/11/2023,Cd. de México,"BENITO JUAREZ, CD. MÉX.",3,0,3,0,0,40,
09/11/2023,Sinaloa,"SAN IGNACIO, SIN.",1,1,2,0,2,0,
09/11/2023,Sinaloa,"COSALA, SIN.",1,0,1,0,0,0,
09/11/2023,Sinaloa,"CONCORDIA, SIN.",0,1,1,0,0,0,
09/11/2023,Cd. de México,"CUAJIMALPA DE MORELOS, CD. MÉX.",0,0,0,0,0,74,
10/11/2023,Sinaloa,"COSALA, SIN.",3,1,4,0,0,0,
10/11/2023,Tlaxcala,"TLAXCALA, TLAX.",1,0,1,0,0,0,
10/11/2023,Tlaxcala,"CHIAUTEMPAN, TLAX.",1,0,1,0,0,0,
10/11/2023,Sinaloa,"CONCORDIA, SIN.",1,0,1,0,0,0,
10/11/2023,Cd. de México,"CUAJIMALPA DE MORELOS, CD. MÉX.",1,0,1,0,0,0,
10/11/2023,Tlaxcala,"IXTACUIXTLA DE MARIANO MATAMOROS, TLAX.",1,0,1,0,0,0,
10/11/2023,Sinaloa,"SAN IGNACIO, SIN.",0,0,0,0,1,193,
10/11/2023,Cd. de México,"CUAUHTEMOC, CD. MÉX.",0,0,0,0,0,21,
11/11/2023,Tlaxcala,"IXTACUIXTLA DE MARIANO MATAMOROS, TLAX.",2,0,2,0,0,0,
11/11/2023,Tlaxcala,"CHIAUTEMPAN, TLAX.",2,0,2,0,0,0,
11/11/2023,Guanajuato,"PENJAMO, GTO.",1,0,1,0,0,0,
11/11/2023,Tlaxcala,"TLAXCALA, TLAX.",1,0,1,0,0,0,
12/11/2023,Guanajuato,"PENJAMO, GTO.",3,0,3,0,0,0,
13/11/2023,Cd. de México,"CUAUHTEMOC, CD. MÉX.",2,0,2,0,0,22,
13/11/2023,Tlaxcala,"TLAXCALA, TLAX.",1,0,1,0,0,0,
13/11/2023,Guanajuato,"PENJAMO, GTO.",1,0,1,0,0,0,
13/11/2023,Cd. de México,"BENITO JUAREZ, CD. MÉX.",1,0,1,0,0,5,
14/11/2023,Cd. de México,"CUAJIMALPA DE MORELOS, CD. MÉX.",2,0,2,0,0,0,
14/11/2023,Cd. de México,"CUAUHTEMOC, CD. MÉX.",1,0,1,0,0,434,
14/11/2023,Tlaxcala,"TLAXCALA, TLAX.",0,1,1,0,0,0,
14/11/2023,Tlaxcala,"MAZATECOCHCO DE JOSE MARIA MORELOS, TLAX.",1,0,1,0,0,0,
15/11/2023,Cd. de México,"BENITO JUAREZ, CD. MÉX.",3,4,7,0,0,117,
16/11/2023,Cd. de México,"CUAUHTEMOC, CD. MÉX.",1,0,1,0,2,388,
16/11/2023,Cd. de México,"CUAJIMALPA DE MORELOS, CD. MÉX.",1,0,1,0,0,8,
16/11/2023,Tlaxcala,"TLAXCALA, TLAX.",0,1,1,0,0,0,
16/11/2023,Tamaulipas,"TAMPICO, TAMPS.",1,0,1,0,0,0,
17/11/2023,Tlaxcala,"TLAXCALA, TLAX.",1,1,2,0,0,0,
17/11/2023,Tlaxcala,"NATIVITAS, TLAX.",1,1,2,0,0,0,
17/11/2023,Tamaulipas,"TAMPICO, TAMPS.",1,0,1,0,0,187,
17/11/2023,Tlaxcala,"MAZATECOCHCO DE JOSE MARIA MORELOS, TLAX.",0,1,1,0,0,0,
17/11/2023,Cd. de México,"CUAUHTEMOC, CD. MÉX.",0,1,1,0,2,"3,443",
17/11/2023,San Luis Potosí,"SAN LUIS POTOSI, S.L.P.",0,0,0,18,0,0,
17/11/2023,Chiapas,"AMATENANGO DE LA FRONTERA, CHIS.",0,0,0,2,0,32,
18/11/2023,Nvo. León,"MONTERREY, N.L.",6,1,7,198,0,320,
18/11/2023,Tamaulipas,"TAMPICO, TAMPS.",2,0,2,0,0,51,
19/11/2023,Nvo. León,"MONTERREY, N.L.",4,0,4,47,1,637,
19/11/2023,San Luis Potosí,"SAN LUIS POTOSI, S.L.P.",1,1,2,23,0,22,
20/11/2023,Chiapas,"TONALÁ, CHIS.",0,0,0,2,0,12,
22/11/2023,Chiapas,"CHICOMUSELO, CHIS.",0,0,0,1,0,7,
23/11/2023,Cd. de México,"MILPA ALTA, CD. MÉX.",1,5,6,0,0,48,
23/11/2023,Chihuahua,"JUÁREZ, CHIH.",3,0,3,2,0,243,
23/11/2023,Cd. de México,"CUAUHTEMOC, CD. MÉX.",0,1,1,0,0,0,
23/11/2023,Cd. de México,"CUAJIMALPA DE MORELOS, CD. MÉX.",1,0,1,0,0,0,
24/11/2023,Morelos,"CUAUTLA, MOR.",2,1,3,2,1,172,
24/11/2023,Cd. de México,"BENITO JUAREZ, CD. MÉX.",1,1,2,0,0,136,
24/11/2023,Chihuahua,"JUÁREZ, CHIH.",2,0,2,2,1,689,
24/11/2023,Tamaulipas,"TAMPICO, TAMPS.",2,0,2,2,0,42,
25/11/2023,Guanajuato,"SAN MIGUEL DE ALLENDE, GTO.",3,1,4,0,0,0,
25/11/2023,Morelos,"CUAUTLA, MOR.",2,0,2,2,0,304,
25/11/2023,Tamaulipas,"TAMPICO, TAMPS.",1,0,1,0,0,49,
26/11/2023,Morelos,"CUAUTLA, MOR.",1,0,1,5,0,687,
26/11/2023,Chiapas,"CINTALAPA, CHIS.",0,0,0,3,0,41,
27/11/2023,Guanajuato,"LEON, GTO.",6,1,7,0,0,0,
27/11/2023,México,"NEZAHUALCOYOTL, MEX.",5,0,5,3,0,669,
27/11/2023,Sinaloa,"CULIACAN, SIN.",0,4,4,0,2,500,
27/11/2023,Cd. de México,"CUAUHTEMOC, CD. MÉX.",0,0,0,0,0,130,
28/11/2023,Guanajuato,"LEON, GTO.",16,4,20,4,1,63,
28/11/2023,Sinaloa,"CULIACAN, SIN.",4,3,7,0,0,216,
28/11/2023,México,"NEZAHUALCOYOTL, MEX.",3,1,4,4,20,298,
28/11/2023,Sinaloa,"ELOTA, SIN.",2,0,2,0,0,0,
28/11/2023,Cd. de México,"BENITO JUAREZ, CD. MÉX.",0,1,1,0,0,0,
28/11/2023,Cd. de México,"CUAJIMALPA DE MORELOS, CD. MÉX.",0,0,0,0,0,1,
28/11/2023,Puebla,"PUEBLA, PUE.",0,0,0,2,0,0,
28/11/2023,Chihuahua,"JUÁREZ, CHIH.",0,0,0,0,0,93,
29/11/2023,Guanajuato,"LEON, GTO.",16,4,20,39,6,515,
29/11/2023,México,"NEZAHUALCOYOTL, MEX.",3,1,4,28,2,718,
29/11/2023,Chiapas,"CHICOMUSELO, CHIS.",1,0,1,0,0,0,
29/11/2023,Puebla,"PUEBLA, PUE.",0,1,1,0,0,0,
29/11/2023,Sinaloa,"CULIACAN, SIN.",1,0,1,0,0,0,
29/11/2023,Chihuahua,"JUÁREZ, CHIH.",0,0,0,1,0,445,
30/11/2023,Guanajuato,"LEON, GTO.",17,12,29,39,0,9,
30/11/2023,Cd. de México,"COYOACAN, CD. MÉX.",5,0,5,0,0,175,
30/11/2023,Chihuahua,"JUÁREZ, CHIH.",1,3,4,0,0,16,
30/11/2023,Sinaloa,"CULIACAN, SIN.",2,2,4,0,4,588,
30/11/2023,México,"NEZAHUALCOYOTL, MEX.",3,0,3,3,0,336,
30/11/2023,Sinaloa,"ELOTA, SIN.",1,1,2,0,0,0,
30/11/2023,Chiapas,"CHICOMUSELO, CHIS.",0,0,0,0,0,65,
01/12/2023,Guanajuato,"LEON, GTO.",15,6,21,56,0,"2,376",
01/12/2023,Tamaulipas,"TAMPICO, TAMPS.",3,4,7,0,0,353,
01/12/2023,Sinaloa,"CULIACAN, SIN.",1,1,2,0,0,62,
01/12/2023,Chihuahua,"JUÁREZ, CHIH.",2,0,2,1,0,96,
01/12/2023,Hidalgo,"HUASCA DE OCAMPO, HGO.",1,0,1,0,0,0,
01/12/2023,Sinaloa,"ELOTA, SIN.",0,1,1,0,0,0,
01/12/2023,Puebla,"PUEBLA, PUE.",1,0,1,0,0,0,
01/12/2023,Chiapas,"PANTELHÓ, CHIS.",0,0,0,0,0,157,
02/12/2023,Chiapas,"CHICOMUSELO, CHIS.",0,0,0,0,0,324,
05/12/2023,Sinaloa,"CULIACAN, SIN.",4,0,4,0,0,251,
05/12/2023,Coahuila,"SACRAMENTO, COAH.",0,1,1,0,0,0,
05/12/2023,Hidalgo,"CUAUTEPEC DE HINOJOSA, HGO.",0,1,1,0,0,41,
05/12/2023,Sinaloa,"ELOTA, SIN.",1,0,1,0,0,0,
05/12/2023,Cd. de México,"CUAUHTEMOC, CD. MÉX.",1,0,1,0,0,0,
05/12/2023,Hidalgo,"ZACUALTIPAN DE ANGELES, HGO.",1,0,1,1,0,15,
05/12/2023,Hidalgo,"ATOTONILCO DE TULA, HGO.",0,0,0,0,0,52,
05/12/2023,Cd. de México,"MILPA ALTA, CD. MÉX.",0,0,0,0,0,49,
06/12/2023,Sinaloa,"CULIACAN, SIN.",3,2,5,0,0,44,
06/12/2023,Chihuahua,"JUÁREZ, CHIH.",3,0,3,1,0,286,
06/12/2023,Cd. de México,"CUAUHTEMOC, CD. MÉX.",2,0,2,0,0,0,
06/12/2023,Coahuila,"SACRAMENTO, COAH.",2,0,2,0,0,0,
06/12/2023,Hidalgo,"CUAUTEPEC DE HINOJOSA, HGO.",1,0,1,0,1,44,
06/12/2023,Hidalgo,"ZACUALTIPAN DE ANGELES, HGO.",1,0,1,0,0,13,
06/12/2023,Hidalgo,"ATOTONILCO DE TULA, HGO.",1,0,1,0,0,223,
06/12/2023,Cd. de México,"CUAJIMALPA DE MORELOS, CD. MÉX.",1,0,1,0,0,0,
06/12/2023,Cd. de México,"COYOACAN, CD. MÉX.",0,1,1,0,0,0,
06/12/2023,Chiapas,"LA GRANDEZA, CHIS.",0,0,0,0,0,25,
06/12/2023,Chiapas,"CHENALHÓ, CHIS.",0,0,0,0,0,63,
07/12/2023,Cd. de México,"MILPA ALTA, CD. MÉX.",1,1,2,0,0,0,
07/12/2023,Cd. de México,"CUAUHTEMOC, CD. MÉX.",0,1,1,0,0,0,
07/12/2023,Sinaloa,"CULIACAN, SIN.",1,0,1,0,0,"1,616",
07/12/2023,Coahuila,"SACRAMENTO, COAH.",1,0,1,0,0,0,
07/12/2023,Sinaloa,"ELOTA, SIN.",1,0,1,0,0,81,
07/12/2023,Chihuahua,"JUÁREZ, CHIH.",0,0,0,0,0,34,
08/12/2023,Sinaloa,"CULIACAN, SIN.",2,0,2,0,1,311,
08/12/2023,Sinaloa,"ELOTA, SIN.",0,1,1,0,0,6,
08/12/2023,Hidalgo,"ZACUALTIPAN DE ANGELES, HGO.",0,0,0,0,0,6,
08/12/2023,Cd. de México,"CUAUHTEMOC, CD. MÉX.",0,0,0,0,0,745,
08/12/2023,Chihuahua,"JUÁREZ, CHIH.",0,0,0,0,0,35,
09/12/2023,Chiapas,"LA GRANDEZA, CHIS.",0,0,0,0,0,25,
11/12/2023,Cd. de México,"COYOACAN, CD. MÉX.",2,0,2,0,0,32,
11/12/2023,Sinaloa,"CULIACAN, SIN.",2,0,2,0,4,0,
11/12/2023,Cd. de México,"CUAUHTEMOC, CD. MÉX.",1,0,1,0,0,344,
11/12/2023,Chihuahua,"JUÁREZ, CHIH.",0,0,0,10,2,98,
12/12/2023,Chihuahua,"JUÁREZ, CHIH.",1,1,2,7,0,185,
12/12/2023,Sinaloa,"CULIACAN, SIN.",2,0,2,0,0,71,
12/12/2023,Chiapas,"CHENALHÓ, CHIS.",0,1,1,1,0,225,
13/12/2023,Cd. de México,"COYOACAN, CD. MÉX.",2,1,3,0,0,51,
13/12/2023,Chiapas,"CHENALHÓ, CHIS.",0,2,2,0,0,0,
13/12/2023,Sinaloa,"CULIACAN, SIN.",1,1,2,0,1,742,
13/12/2023,Sinaloa,"ELOTA, SIN.",0,1,1,0,0,0,
13/12/2023,Cd. de México,"CUAUHTEMOC, CD. MÉX.",1,0,1,0,0,0,
13/12/2023,Hidalgo,"METZTITLAN, HGO.",0,0,0,0,0,25,
13/12/2023,Chihuahua,"JUÁREZ, CHIH.",0,0,0,2,0,0,
14/12/2023,Sinaloa,"CULIACAN, SIN.",4,0,4,0,0,348,
15/12/2023,Cd. de México,"COYOACAN, CD. MÉX.",0,5,5,0,0,24,
15/12/2023,Sinaloa,"CULIACAN, SIN.",3,0,3,0,0,50,
15/12/2023,Cd. de México,"CUAUHTEMOC, CD. MÉX.",3,0,3,0,0,0,
15/12/2023,Cd. de México,"IZTAPALAPA, CD. MÉX.",1,0,1,0,0,28,
15/12/2023,Chihuahua,"JUÁREZ, CHIH.",0,0,0,0,0,48,
16/12/2023,Chiapas,"CHENALHÓ, CHIS.",0,2,2,0,0,0,
18/12/2023,Chiapas,"TUXTLA GUTIÉRREZ, CHIS.",1,0,1,0,0,465,
18/12/2023,Chiapas,"CHENALHÓ, CHIS.",0,1,1,0,0,130,
20/12/2023,Chihuahua,"JUÁREZ, CHIH.",4,1,5,17,0,546,
20/12/2023,Chiapas,"TUXTLA GUTIÉRREZ, CHIS.",1,0,1,0,0,313,
20/12/2023,Chiapas,"CHENALHÓ, CHIS.",0,0,0,0,0,230,
21/12/2023,Zacatecas,"ZACATECAS, ZAC.",0,2,2,0,0,14,
21/12/2023,Chihuahua,"JUÁREZ, CHIH.",0,1,1,0,0,162,
22/12/2023,Zacatecas,"ZACATECAS, ZAC.",0,0,0,7,0,316,
26/12/2023,Zacatecas,"GUADALUPE, ZAC.",3,3,6,5,0,70,
27/12/2023,Zacatecas,"GUADALUPE, ZAC.",0,0,0,7,0,308,
28/12/2023,Zacatecas,"GUADALUPE, ZAC.",1,0,1,15,0,202,
29/12/2023,Zacatecas,"GUADALUPE, ZAC.",1,0,1,10,0,623,
09/01/2024,Zacatecas,"OJOCALIENTE, ZAC.",1,0,1,0,0,0,
11/01/2024,Zacatecas,"LUIS MOYA, ZAC.",0,0,0,1,0,10,
12/01/2024,Zacatecas,"PINOS, ZAC.",0,0,0,0,0,104,
15/01/2024,Zacatecas,"JEREZ, ZAC.",3,0,3,0,0,53,
16/01/2024,Zacatecas,"JEREZ, ZAC.",1,0,1,11,0,219,
17/01/2024,Zacatecas,"VILLANUEVA, ZAC.",1,0,1,0,0,0,
18/01/2024,Zacatecas,"VILLANUEVA, ZAC.",1,0,1,21,0,0,
19/01/2024,Zacatecas,"TLALTENANGO DE SANCHEZ ROMAN, ZAC.",2,0,2,0,0,0,
24/01/2024,Zacatecas,"ZACATECAS, ZAC.",0,0,0,1,0,0,
27/01/2024,Zacatecas,"ZACATECAS, ZAC.",1,0,1,0,0,0,
31/01/2024,Zacatecas,"GUADALUPE, ZAC.",0,0,0,0,0,50,
01/02/2024,Zacatecas,"ZACATECAS, ZAC.",1,0,1,0,0,0,
08/02/2024,Zacatecas,"JEREZ, ZAC.",2,0,2,15,0,123,
09/02/2024,Zacatecas,"TLALTENANGO DE SANCHEZ ROMAN, ZAC.",1,0,1,4,0,100,
10/02/2024,Zacatecas,"TLALTENANGO DE SANCHEZ ROMAN, ZAC.",0,0,0,3,1,171,
13/02/2024,Zacatecas,"FRESNILLO, ZAC.",1,0,1,11,0,190,
14/02/2024,Zacatecas,"FRESNILLO, ZAC.",0,0,0,10,0,626,
15/02/2024,Zacatecas,"FRESNILLO, ZAC.",0,0,0,17,0,503,
16/02/2024,Zacatecas,"FRESNILLO, ZAC.",1,0,1,8,0,148,
28/02/2024,Cd. de México,"GUSTAVO A. MADERO, CD. MÉX.",1,0,1,0,0,0,
01/03/2024,Cd. de México,"GUSTAVO A. MADERO, CD. MÉX.",0,0,0,0,0,16,
04/03/2024,Zacatecas,"FRESNILLO, ZAC.",3,0,3,27,0,217,
04/03/2024,Cd. de México,"CUAUHTEMOC, CD. MÉX.",2,0,2,0,0,0,
04/03/2024,Cd. de México,"GUSTAVO A. MADERO, CD. MÉX.",0,0,0,0,0,578,
05/03/2024,Cd. de México,"CUAUHTEMOC, CD. MÉX.",5,2,7,0,0,"1,789",
05/03/2024,Zacatecas,"FRESNILLO, ZAC.",1,1,2,7,0,317,
05/03/2024,Cd. de México,"GUSTAVO A. MADERO, CD. MÉX.",2,0,2,0,0,200,
06/03/2024,Cd. de México,"CUAUHTEMOC, CD. MÉX.",4,0,4,0,0,0,
06/03/2024,Zacatecas,"FRESNILLO, ZAC.",0,1,1,3,0,92,
07/03/2024,Zacatecas,"FRESNILLO, ZAC.",0,0,0,20,0,"1,242",
08/03/2024,Cd. de México,"GUSTAVO A. MADERO, CD. MÉX.",3,0,3,0,0,0,
08/03/2024,Cd. de México,"TLALPAN, CD. MÉX.",0,1,1,0,0,"1,111",
09/03/2024,Zacatecas,"FRESNILLO, ZAC.",0,0,0,212,0,374,
11/03/2024,Cd. de México,"IZTAPALAPA, CD. MÉX.",2,0,2,0,0,0,
11/03/2024,Cd. de México,"GUSTAVO A. MADERO, CD. MÉX.",1,0,1,0,0,0,
11/03/2024,Cd. de México,"CUAUHTEMOC, CD. MÉX.",1,0,1,0,0,365,
11/03/2024,Zacatecas,"FRESNILLO, ZAC.",0,0,0,6,0,160,
12/03/2024,Cd. de México,"IZTAPALAPA, CD. MÉX.",3,0,3,0,0,50,
12/03/2024,Cd. de México,"IZTAPALAPA, CD. MÉX.",2,0,2,0,0,8,
13/03/2024,Cd. de México,"GUSTAVO A. MADERO, CD. MÉX.",2,0,2,0,0,69,
13/03/2024,Cd. de México,"CUAUHTEMOC, CD. MÉX.",0,1,1,0,0,214,
14/03/2024,Cd. de México,"TLALPAN, CD. MÉX.",0,2,2,0,0,117,
14/03/2024,Cd. de México,"CUAUHTEMOC, CD. MÉX.",1,0,1,0,0,0,
15/03/2024,Cd. de México,"GUSTAVO A. MADERO, CD. MÉX.",0,1,1,0,0,0,
18/03/2024,Cd. de México,"CUAUHTEMOC, CD. MÉX.",1,0,1,0,0,26,
18/03/2024,Cd. de México,"IZTAPALAPA, CD. MÉX.",1,0,1,0,0,149,
18/03/2024,Cd. de México,"GUSTAVO A. MADERO, CD. MÉX.",0,0,0,0,0,242,
18/03/2024,Cd. de México,"TLALPAN, CD. MÉX.",0,0,0,0,0,26,
19/03/2024,Cd. de México,"IZTAPALAPA, CD. MÉX.",0,0,0,0,0,50,
20/03/2024,Jalisco,"PUERTO VALLARTA, JAL.",1,1,2,0,0,0,
25/03/2024,Cd. de México,"GUSTAVO A. MADERO, CD. MÉX.",9,3,12,0,0,436,
25/03/2024,Zacatecas,"FRESNILLO, ZAC.",0,0,0,15,0,182,
26/03/2024,Cd. de México,"GUSTAVO A. MADERO, CD. MÉX.",0,2,2,0,0,0,
26/03/2024,Cd. de México,"TLALPAN, CD. MÉX.",1,0,1,0,0,0,
26/03/2024,Zacatecas,"FRESNILLO, ZAC.",0,0,0,9,0,393,
27/03/2024,Cd. de México,"CUAUHTEMOC, CD. MÉX.",1,0,1,0,0,74,
27/03/2024,Cd. de México,"GUSTAVO A. MADERO, CD. MÉX.",1,0,1,0,0,0,
27/03/2024,Zacatecas,"FRESNILLO, ZAC.",0,0,0,18,0,459,
02/04/2024,Cd. de México,"GUSTAVO A. MADERO, CD. MÉX.",0,0,0,0,1,0,
05/04/2024,Cd. de México,"GUSTAVO A. MADERO, CD. MÉX.",2,0,2,0,0,200,
09/04/2024,Cd. de México,"CUAUHTEMOC, CD. MÉX.",2,0,2,0,0,0,
09/04/2024,Cd. de México,"GUSTAVO A. MADERO, CD. MÉX.",2,0,2,0,1,5,
09/04/2024,Cd. de México,"TLAHUAC, CD. MÉX.",0,0,0,0,0,4,
10/04/2024,Cd. de México,"TLAHUAC, CD. MÉX.",0,0,0,0,0,335,
12/04/2024,Cd. de México,"GUSTAVO A. MADERO, CD. MÉX.",2,0,2,0,0,6,
15/04/2024,Cd. de México,"GUSTAVO A. MADERO, CD. MÉX.",1,0,1,0,0,0,
15/04/2024,Cd. de México,"TLAHUAC, CD. MÉX.",1,0,1,0,0,11,
16/04/2024,Cd. de México,"CUAUHTEMOC, CD. MÉX.",2,1,3,0,0,0,
17/04/2024,Cd. de México,"CUAUHTEMOC, CD. MÉX.",0,0,0,0,0,557,
18/04/2024,Cd. de México,"TLAHUAC, CD. MÉX.",1,1,2,0,0,0,
18/04/2024,Cd. de México,"CUAUHTEMOC, CD. MÉX.",1,0,1,0,0,0,
19/04/2024,Cd. de México,"TLAHUAC, CD. MÉX.",0,0,0,0,0,5,
22/04/2024,Cd. de México,"LA MAGDALENA CONTRERAS, CD. MÉX.",1,0,1,0,0,57,
22/04/2024,Cd. de México,"CUAUHTEMOC, CD. MÉX.",0,0,0,0,0,67,
23/04/2024,Cd. de México,"CUAUHTEMOC, CD. MÉX.",2,0,2,0,0,0,
23/04/2024,Cd. de México,"IZTACALCO, CD. MÉX.",0,0,0,0,0,9,
25/04/2024,Cd. de México,"CUAUHTEMOC, CD. MÉX.",3,0,3,0,0,8,
25/04/2024,Cd. de México,"LA MAGDALENA CONTRERAS, CD. MÉX.",1,0,1,0,0,0,
26/04/2024,Cd. de México,"CUAUHTEMOC, CD. MÉX.",1,0,1,0,0,161,
29/04/2024,Cd. de México,"LA MAGDALENA CONTRERAS, CD. MÉX.",3,0,3,0,0,0,
29/04/2024,Cd. de México,"CUAUHTEMOC, CD. MÉX.",1,1,2,0,0,6,
30/04/2024,Cd. de México,"COYOACAN, CD. MÉX.",0,1,1,0,0,0,
30/04/2024,Cd. de México,"CUAUHTEMOC, CD. MÉX.",0,0,0,0,0,6,
06/05/2024,Cd. de México,"COYOACAN, CD. MÉX.",2,1,3,0,0,19,
06/05/2024,Cd. de México,"IZTAPALAPA, CD. MÉX.",2,0,2,0,0,217,
07/05/2024,Cd. de México,"IZTAPALAPA, CD. MÉX.",1,0,1,0,0,0,
08/05/2024,Cd. de México,"CUAUHTEMOC, CD. MÉX.",2,0,2,0,0,217,
08/05/2024,Zacatecas,"FRESNILLO, ZAC.",0,0,0,5,0,96,
09/05/2024,Cd. de México,"CUAUHTEMOC, CD. MÉX.",1,0,1,0,0,0,
09/05/2024,Zacatecas,"FRESNILLO, ZAC.",0,0,0,2,0,93,
10/05/2024,Cd. de México,"COYOACAN, CD. MÉX.",1,2,3,0,0,23,
11/05/2024,Zacatecas,"FRESNILLO, ZAC.",0,0,0,5,0,9,
12/05/2024,Zacatecas,"FRESNILLO, ZAC.",0,0,0,1,0,0,
13/05/2024,Zacatecas,"FRESNILLO, ZAC.",1,0,1,4,0,45,
13/05/2024,Cd. de México,"CUAUHTEMOC, CD. MÉX.",0,0,0,0,0,30,
14/05/2024,Zacatecas,"FRESNILLO, ZAC.",0,0,0,3,0,47,
15/05/2024,Cd. de México,"CUAUHTEMOC, CD. MÉX.",1,0,1,0,0,49,
16/05/2024,Cd. de México,"MILPA ALTA, CD. MÉX.",1,0,1,0,0,0,
17/05/2024,Cd. de México,"CUAUHTEMOC, CD. MÉX.",2,0,2,0,0,494,
20/05/2024,Cd. de México,"VENUSTIANO CARRANZA, CD. MÉX.",0,1,1,0,0,0,
21/05/2024,Cd. de México,"CUAUHTEMOC, CD. MÉX.",3,0,3,0,0,321,
22/05/2024,Cd. de México,"CUAUHTEMOC, CD. MÉX.",1,1,2,0,0,183,
22/05/2024,Cd. de México,"XOCHIMILCO, CD. MÉX.",0,0,0,0,0,60,
23/05/2024,Cd. de México,"CUAUHTEMOC, CD. MÉX.",1,0,1,0,0,0,
23/05/2024,Cd. de México,"VENUSTIANO CARRANZA, CD. MÉX.",0,0,0,0,0,32,
24/05/2024,Cd. de México,"XOCHIMILCO, CD. MÉX.",3,2,5,0,0,269,
24/05/2024,Cd. de México,"CUAUHTEMOC, CD. MÉX.",4,0,4,0,0,516,
24/05/2024,Cd. de México,"VENUSTIANO CARRANZA, CD. MÉX.",2,0,2,0,0,30,
24/05/2024,Zacatecas,"FRESNILLO, ZAC.",0,0,0,8,0,216,
25/05/2024,Zacatecas,"FRESNILLO, ZAC.",0,0,0,6,0,340,
27/05/2024,Cd. de México,"CUAUHTEMOC, CD. MÉX.",1,0,1,0,0,0,
27/05/2024,Zacatecas,"FRESNILLO, ZAC.",0,0,0,7,0,300,
28/05/2024,Cd. de México,"CUAUHTEMOC, CD. MÉX.",1,2,3,0,0,"3,450",
28/05/2024,Zacatecas,"FRESNILLO, ZAC.",0,0,0,8,0,280,
29/05/2024,Cd. de México,"CUAUHTEMOC, CD. MÉX.",1,3,4,0,0,113,
29/05/2024,Zacatecas,"FRESNILLO, ZAC.",0,0,0,8,0,281,
30/05/2024,Cd. de México,"VENUSTIANO CARRANZA, CD. MÉX.",0,1,1,0,0,0,
03/06/2024,Cd. de México,"CUAUHTEMOC, CD. MÉX.",1,0,1,0,0,0,
04/06/2024,Cd. de México,"CUAUHTEMOC, CD. MÉX.",3,0,3,0,0,259,
04/06/2024,Cd. de México,"ALVARO OBREGON, CD. MÉX.",1,1,2,0,0,0,
05/06/2024,Cd. de México,"CUAUHTEMOC, CD. MÉX.",1,0,1,0,0,0,
05/06/2024,Cd. de México,"ALVARO OBREGON, CD. MÉX.",1,0,1,0,0,0,
10/06/2024,Michoacán,"APATZINGAN, MICH.",10,15,25,99,0,121,
10/06/2024,Cd. de México,"CUAUHTEMOC, CD. MÉX.",2,0,2,0,0,71,
10/06/2024,Cd. de México,"MIGUEL HIDALGO, CD. MÉX.",0,0,0,0,0,155,
11/06/2024,Michoacán,"APATZINGAN, MICH.",5,3,8,16,0,"1,994",
11/06/2024,Cd. de México,"MIGUEL HIDALGO, CD. MÉX.",2,0,2,0,0,5,
11/06/2024,Veracruz,"BOCA DEL RIO, VER.",2,0,2,32,0,524,
11/06/2024,Cd. de México,"AZCAPOTZALCO, CD. MÉX.",0,1,1,0,0,20,
12/06/2024,Michoacán,"APATZINGAN, MICH.",1,4,5,7,0,0,
12/06/2024,Veracruz,"VERACRUZ, VER.",1,1,2,91,0,"1,678",
13/06/2024,Veracruz,"VERACRUZ, VER.",5,1,6,31,0,367,
13/06/2024,Cd. de México,"AZCAPOTZALCO, CD. MÉX.",3,1,4,0,0,98,
13/06/2024,Cd. de México,"CUAUHTEMOC, CD. MÉX.",3,0,3,0,0,40,
14/06/2024,Michoacán,"APATZINGAN, MICH.",7,5,12,45,0,0,
14/06/2024,Veracruz,"VERACRUZ, VER.",8,2,10,109,0,"4,021",
14/06/2024,Cd. de México,"CUAUHTEMOC, CD. MÉX.",2,1,3,0,0,0,
14/06/2024,Oaxaca,"OAXACA DE JUAREZ, OAX.",3,0,3,3,4,245,
15/06/2024,Veracruz,"VERACRUZ, VER.",6,2,8,22,0,"3,030",
15/06/2024,Michoacán,"BUENAVISTA, MICH.",4,0,4,25,0,0,
16/06/2024,Michoacán,"BUENAVISTA, MICH.",3,1,4,22,0,0,
17/06/2024,Sinaloa,"SALVADOR ALVARADO, SIN.",5,0,5,0,0,25,
17/06/2024,Sinaloa,"CULIACAN, SIN.",4,1,5,0,0,114,
17/06/2024,Michoacán,"BUENAVISTA, MICH.",5,0,5,30,0,500,
17/06/2024,Sinaloa,"BADIRAGUATO, SIN.",3,0,3,0,0,0,
17/06/2024,Cd. de México,"CUAUHTEMOC, CD. MÉX.",2,0,2,0,0,97,
17/06/2024,Cd. de México,"AZCAPOTZALCO, CD. MÉX.",1,0,1,0,0,0,
17/06/2024,Sinaloa,"MOCORITO, SIN.",1,0,1,0,0,336,
17/06/2024,Sinaloa,"COSALA, SIN.",0,1,1,0,0,0,
18/06/2024,Sinaloa,"NAVOLATO, SIN.",9,0,9,0,0,349,
18/06/2024,Sinaloa,"SALVADOR ALVARADO, SIN.",5,0,5,0,0,141,
18/06/2024,Sinaloa,"COSALA, SIN.",3,2,5,0,0,349,
18/06/2024,Cd. de México,"BENITO JUAREZ, CD. MÉX.",3,1,4,0,0,157,
18/06/2024,Sinaloa,"CULIACAN, SIN.",2,2,4,0,2,2,
18/06/2024,Cd. de México,"BENITO JUAREZ, CD. MÉX.",3,1,4,0,0,157,
18/06/2024,Sinaloa,"MOCORITO, SIN.",2,0,2,0,0,18,
18/06/2024,Michoacán,"BUENAVISTA, MICH.",2,0,2,4,2,500,
18/06/2024,Sinaloa,"BADIRAGUATO, SIN.",1,0,1,0,1,0,
18/06/2024,Michoacán,"MORELIA, MICH.",1,0,1,2,0,183,
19/06/2024,Baja California,"TIJUANA, B.C.",3,4,7,20,0,210,
19/06/2024,Sinaloa,"SALVADOR ALVARADO, SIN.",4,2,6,0,0,0,
19/06/2024,Michoacán,"TURICATO, MICH.",2,4,6,15,0,80,
19/06/2024,Sinaloa,"MOCORITO, SIN.",4,1,5,0,0,334,
19/06/2024,Sinaloa,"BADIRAGUATO, SIN.",0,5,5,0,0,0,
19/06/2024,Michoacán,"JACONA, MICH.",2,1,3,20,0,16,
19/06/2024,Sinaloa,"NAVOLATO, SIN.",1,1,2,0,0,0,
19/06/2024,Sinaloa,"COSALA, SIN.",2,0,2,0,2,0,
19/06/2024,Sinaloa,"CULIACAN, SIN.",1,0,1,0,1,364,
19/06/2024,Cd. de México,"CUAUHTEMOC, CD. MÉX.",1,0,1,0,0,0,
19/06/2024,Cd. de México,"ALVARO OBREGON, CD. MÉX.",1,0,1,0,0,30,
19/06/2024,Cd. de México,"BENITO JUAREZ, CD. MÉX.",0,0,0,0,0,22,
20/06/2024,Sinaloa,"SALVADOR ALVARADO, SIN.",17,3,20,0,0,311,
20/06/2024,Michoacán,"TURICATO, MICH.",1,5,6,7,0,100,
20/06/2024,Sinaloa,"CULIACAN, SIN.",5,0,5,0,0,"1,890",
20/06/2024,Sinaloa,"MOCORITO, SIN.",1,3,4,0,0,0,
20/06/2024,Sinaloa,"BADIRAGUATO, SIN.",2,2,4,0,0,139,
20/06/2024,Baja California,"TIJUANA, B.C.",2,2,4,21,0,300,
20/06/2024,Cd. de México,"CUAUHTEMOC, CD. MÉX.",2,1,3,0,0,0,
20/06/2024,Cd. de México,"BENITO JUAREZ, CD. MÉX.",1,0,1,0,0,0,
20/06/2024,Cd. de México,"ALVARO OBREGON, CD. MÉX.",1,0,1,0,0,0,
20/06/2024,Sinaloa,"COSALA, SIN.",1,0,1,0,0,0,
20/06/2024,Sinaloa,"NAVOLATO, SIN.",0,0,0,0,1,0,
20/06/2024,Michoacán,"JACONA, MICH.",0,0,0,1,0,0,
21/06/2024,Sinaloa,"SALVADOR ALVARADO, SIN.",8,0,8,0,0,0,
21/06/2024,Sinaloa,"MOCORITO, SIN.",5,0,5,0,0,0,
21/06/2024,Michoacán,"TURICATO, MICH.",3,2,5,10,0,147,
21/06/2024,Baja California,"TIJUANA, B.C.",2,2,4,30,0,150,
21/06/2024,Sinaloa,"BADIRAGUATO, SIN.",2,1,3,0,3,300,
21/06/2024,Sinaloa,"CULIACAN, SIN.",3,0,3,0,3,0,
21/06/2024,Cd. de México,"CUAUHTEMOC, CD. MÉX.",1,0,1,0,0,0,
21/06/2024,Cd. de México,"BENITO JUAREZ, CD. MÉX.",1,0,1,0,0,0,
21/06/2024,Cd. de México,"ALVARO OBREGON, CD. MÉX.",1,0,1,0,0,0,
21/06/2024,Sinaloa,"COSALA, SIN.",1,0,1,0,0,0,
21/06/2024,Sinaloa,"MAZATLAN, SIN.",1,0,1,61,0,52,
21/06/2024,Michoacán,"JACONA, MICH.",0,0,0,29,0,600,
22/06/2024,Baja California,"TIJUANA, B.C.",2,3,5,20,0,161,
22/06/2024,Sinaloa,"MAZATLAN, SIN.",2,2,4,10,0,6,
23/06/2024,Sinaloa,"MAZATLAN, SIN.",1,0,1,25,0,0,
24/06/2024,Michoacán,"TACAMBARO, MICH.",4,19,23,17,0,272,
24/06/2024,Sinaloa,"CULIACAN, SIN.",12,6,18,0,0,308,
24/06/2024,Sinaloa,"SALVADOR ALVARADO, SIN.",7,1,8,0,3,284,
24/06/2024,Sinaloa,"BADIRAGUATO, SIN.",3,3,6,0,0,200,
24/06/2024,Sinaloa,"MAZATLAN, SIN.",0,5,5,3,0,4,
24/06/2024,Sinaloa,"NAVOLATO, SIN.",4,0,4,0,0,0,
24/06/2024,Sinaloa,"COSALA, SIN.",1,3,4,0,0,0,
24/06/2024,Sinaloa,"MOCORITO, SIN.",3,0,3,0,8,60,
24/06/2024,Cd. de México,"CUAUHTEMOC, CD. MÉX.",1,0,1,0,0,112,
24/06/2024,Cd. de México,"ALVARO OBREGON, CD. MÉX.",1,0,1,0,0,5,
25/06/2024,Sinaloa,"SALVADOR ALVARADO, SIN.",23,1,24,0,0,897,
25/06/2024,Zacatecas,"ZACATECAS, ZAC.",16,4,20,49,1,808,
25/06/2024,Michoacán,"TACAMBARO, MICH.",5,15,20,6,0,450,
25/06/2024,Sinaloa,"CULIACAN, SIN.",6,1,7,0,0,0,
25/06/2024,Sinaloa,"MOCORITO, SIN.",4,1,5,0,0,200,
25/06/2024,Sinaloa,"BADIRAGUATO, SIN.",2,3,5,0,0,25,
25/06/2024,Sinaloa,"NAVOLATO, SIN.",2,0,2,0,0,0,
25/06/2024,Cd. de México,"CUAUHTEMOC, CD. MÉX.",1,0,1,0,0,0,
25/06/2024,Cd. de México,"AZCAPOTZALCO, CD. MÉX.",1,0,1,0,0,6,
25/06/2024,Sinaloa,"COSALA, SIN.",1,0,1,0,0,0,
26/06/2024,Sinaloa,"SALVADOR ALVARADO, SIN.",12,5,17,0,2,443,
26/06/2024,Sinaloa,"CULIACAN, SIN.",8,0,8,0,0,350,
26/06/2024,Cd. de México,"CUAUHTEMOC, CD. MÉX.",4,0,4,0,0,7,
26/06/2024,Sinaloa,"BADIRAGUATO, SIN.",2,2,4,0,0,11,
26/06/2024,Zacatecas,"FRESNILLO, ZAC.",2,1,3,9,0,479,
26/06/2024,Sinaloa,"MOCORITO, SIN.",2,1,3,0,5,785,
26/06/2024,Cd. de México,"AZCAPOTZALCO, CD. MÉX.",2,0,2,0,0,153,
26/06/2024,Sinaloa,"NAVOLATO, SIN.",2,0,2,0,0,0,
26/06/2024,Cd. de México,"BENITO JUAREZ, CD. MÉX.",1,0,1,0,0,"1,456",
26/06/2024,Cd. de México,"GUSTAVO A. MADERO, CD. MÉX.",1,0,1,0,0,0,
26/06/2024,Sinaloa,"COSALA, SIN.",1,0,1,0,0,0,
27/06/2024,Sinaloa,"CULIACAN, SIN.",8,0,8,0,0,324,
27/06/2024,Sinaloa,"MOCORITO, SIN.",4,1,5,0,0,"2,075",
27/06/2024,Sinaloa,"NAVOLATO, SIN.",4,0,4,0,0,29,
27/06/2024,Sinaloa,"SALVADOR ALVARADO, SIN.",3,0,3,0,0,653,
27/06/2024,Zacatecas,"ZACATECAS, ZAC.",0,2,2,6,0,"1,497",
27/06/2024,Sinaloa,"BADIRAGUATO, SIN.",0,1,1,0,0,100,
28/06/2024,Sinaloa,"SALVADOR ALVARADO, SIN.",15,0,15,0,6,"2,438",
28/06/2024,Sinaloa,"CULIACAN, SIN.",6,1,7,0,1,"1,385",
28/06/2024,Sinaloa,"COSALA, SIN.",2,2,4,0,0,0,
28/06/2024,Sinaloa,"BADIRAGUATO, SIN.",1,2,3,0,0,0,
28/06/2024,Sinaloa,"MOCORITO, SIN.",0,2,2,0,0,3012,
28/06/2024,Cd. de México,"BENITO JUAREZ, CD. MÉX.",1,0,1,0,0,26,
28/06/2024,Cd. de México,"GUSTAVO A. MADERO, CD. MÉX.",1,0,1,0,0,0,
28/06/2024,Cd. de México,"IZTACALCO, CD. MÉX.",1,0,1,0,0,1,
28/06/2024,Zacatecas,"ZACATECAS, ZAC.",0,0,0,3,0,9,
